league,season,team,player,nation,pos,age,born,90s,Tackles Tkl,Tackles TklW,Tackles Def 3rd,Tackles Mid 3rd,Tackles Att 3rd,Challenges Tkl,Challenges Att,Challenges Tkl%,Challenges Lost,Blocks Blocks,Blocks Sh,Blocks Pass,Int,Tkl+Int,Clr,Err,stat_type
ESP-La Liga,2022,Almería,Alejandro Pozo Pozo,ESP,DF,23,1999,20.9,37,19,17,17,3,27,53,50.9,26,30,5,25,26,63,45,1,defense
ESP-La Liga,2022,Almería,Arnau Puigmal,ESP,"MF,FW",21,2001,8.5,22,14,10,7,5,12,17,70.6,5,7,0,7,11,33,6,0,defense
ESP-La Liga,2022,Almería,Chumi,ESP,DF,23,1999,16.5,29,16,18,9,2,14,23,60.9,9,20,7,13,15,44,53,0,defense
ESP-La Liga,2022,Almería,Curro,ESP,MF,26,1996,0.5,2,0,1,1,0,1,2,50.0,1,0,0,0,0,2,0,0,defense
ESP-La Liga,2022,Almería,César de la Hoz,ESP,MF,30,1992,18.6,37,20,17,18,2,19,37,51.4,18,26,6,20,13,50,37,0,defense
ESP-La Liga,2022,Almería,Diego Mariño,ESP,GK,32,1990,0.5,0,0,0,0,0,0,0,,0,0,0,0,0,0,0,0,defense
ESP-La Liga,2022,Almería,Dyego Sousa,POR,FW,32,1989,5.9,10,6,5,4,1,4,5,80.0,1,4,2,2,1,11,14,0,defense
ESP-La Liga,2022,Almería,El Bilal Touré,MLI,FW,20,2001,14.0,4,3,2,1,1,0,3,0.0,3,6,1,5,1,5,23,0,defense
ESP-La Liga,2022,Almería,Fernando,ESP,GK,32,1990,36.5,0,0,0,0,0,0,2,0.0,2,2,0,2,1,1,20,3,defense
ESP-La Liga,2022,Almería,Fernando Pacheco,ESP,GK,30,1992,1.0,0,0,0,0,0,0,0,,0,0,0,0,0,0,1,0,defense
ESP-La Liga,2022,Almería,Francisco Portillo,ESP,"MF,FW",32,1990,8.0,13,6,4,5,4,3,16,18.8,13,7,1,6,7,20,8,0,defense
ESP-La Liga,2022,Almería,Gonzalo Melero,ESP,MF,28,1994,20.6,32,16,9,18,5,11,39,28.2,28,23,2,21,7,39,19,1,defense
ESP-La Liga,2022,Almería,Houboulang Mendes,GNB,DF,24,1998,9.8,19,11,16,3,0,11,27,40.7,16,12,2,10,7,26,23,1,defense
ESP-La Liga,2022,Almería,José Carlos Lazo,ESP,"MF,FW",26,1996,0.2,0,0,0,0,0,0,0,,0,0,0,0,0,0,0,0,defense
ESP-La Liga,2022,Almería,Kaiky,BRA,DF,18,2004,6.5,5,5,5,0,0,3,7,42.9,4,18,10,8,11,16,28,0,defense
ESP-La Liga,2022,Almería,Largie Ramazani,BEL,"FW,MF",21,2001,15.6,15,9,6,3,6,8,27,29.6,19,11,0,11,15,30,10,0,defense
ESP-La Liga,2022,Almería,Lucas Robertone,ARG,MF,25,1997,31.6,50,28,20,21,9,28,64,43.8,36,45,7,38,46,96,46,1,defense
ESP-La Liga,2022,Almería,Luis Javier Suárez,COL,FW,24,1997,16.6,17,11,5,6,6,6,26,23.1,20,13,3,10,3,20,10,0,defense
ESP-La Liga,2022,Almería,Lázaro,BRA,"FW,MF",20,2002,8.0,4,3,3,0,1,3,15,20.0,12,16,1,15,2,6,1,0,defense
ESP-La Liga,2022,Almería,Léo Baptistão,BRA,"FW,MF",29,1992,19.2,32,20,13,16,3,13,33,39.4,20,17,2,15,19,51,12,0,defense
ESP-La Liga,2022,Almería,Marko Milovanović,SRB,FW,18,2003,0.2,0,0,0,0,0,0,0,,0,0,0,0,0,0,0,0,defense
ESP-La Liga,2022,Almería,Rodrigo Ely,BRA,DF,28,1993,35.1,30,21,26,4,0,18,25,72.0,7,46,33,13,31,61,203,1,defense
ESP-La Liga,2022,Almería,Samu Costa,POR,MF,21,2000,22.1,61,31,35,20,6,29,61,47.5,32,29,7,22,37,98,64,4,defense
ESP-La Liga,2022,Almería,Sergio Akieme,ESP,DF,24,1997,25.5,27,16,19,6,2,12,22,54.5,10,22,6,16,14,41,41,0,defense
ESP-La Liga,2022,Almería,Srđan Babić,SRB,DF,26,1996,33.3,28,18,20,8,0,15,32,46.9,17,34,22,12,29,57,124,1,defense
ESP-La Liga,2022,Almería,Umar Sadiq,NGA,FW,25,1997,2.7,0,0,0,0,0,0,1,0.0,1,2,0,2,0,0,3,0,defense
ESP-La Liga,2022,Almería,Álex Centelles,ESP,DF,24,1997,12.5,22,14,16,3,3,16,22,72.7,6,13,2,11,11,33,40,0,defense
ESP-La Liga,2022,Almería,Íñigo Eguaras,ESP,MF,30,1992,10.7,11,8,4,6,1,5,18,27.8,13,9,3,6,6,17,15,0,defense
ESP-La Liga,2022,Athletic Club,Adu Ares,ESP,"FW,MF",20,2001,0.9,4,2,2,1,1,4,4,100.0,0,1,0,1,2,6,1,0,defense
ESP-La Liga,2022,Athletic Club,Aitor Paredes,ESP,DF,22,2000,9.5,7,6,4,2,1,6,11,54.5,5,11,7,4,14,21,26,0,defense
ESP-La Liga,2022,Athletic Club,Ander Capa,ESP,DF,30,1992,1.2,1,1,1,0,0,1,5,20.0,4,5,0,5,0,1,2,0,defense
ESP-La Liga,2022,Athletic Club,Ander Herrera,ESP,MF,32,1989,7.7,18,10,8,7,3,6,18,33.3,12,12,3,9,11,29,12,0,defense
ESP-La Liga,2022,Athletic Club,Asier Villalibre,ESP,FW,24,1997,1.1,0,0,0,0,0,0,0,,0,0,0,0,0,0,1,0,defense
ESP-La Liga,2022,Athletic Club,Dani García,ESP,MF,32,1990,16.5,46,27,17,25,4,29,47,61.7,18,21,6,15,19,65,21,1,defense
ESP-La Liga,2022,Athletic Club,Daniel Vivian,ESP,DF,23,1999,26.4,57,32,36,16,5,36,45,80.0,9,27,14,13,24,81,90,3,defense
ESP-La Liga,2022,Athletic Club,Gorka Guruzeta,ESP,FW,25,1996,15.8,24,20,6,12,6,11,24,45.8,13,23,2,21,4,28,8,0,defense
ESP-La Liga,2022,Athletic Club,Iker Muniain,ESP,"MF,FW",29,1992,18.8,21,16,7,11,3,6,17,35.3,11,10,1,9,4,25,2,0,defense
ESP-La Liga,2022,Athletic Club,Iñaki Williams,GHA,FW,28,1994,31.5,22,16,5,14,3,9,24,37.5,15,18,3,15,7,29,34,0,defense
ESP-La Liga,2022,Athletic Club,Iñigo Lekue,ESP,DF,29,1993,14.7,24,17,20,4,0,12,19,63.2,7,16,2,14,13,37,31,1,defense
ESP-La Liga,2022,Athletic Club,Iñigo Martínez,ESP,DF,31,1991,14.9,18,8,11,7,0,6,9,66.7,3,17,11,6,18,36,55,0,defense
ESP-La Liga,2022,Athletic Club,Jon Morcillo,ESP,"FW,MF",23,1998,0.8,1,0,1,0,0,0,1,0.0,1,0,0,0,1,2,0,0,defense
ESP-La Liga,2022,Athletic Club,Julen Agirrezabala,ESP,GK,21,2000,7.5,0,0,0,0,0,0,0,,0,0,0,0,0,0,2,0,defense
ESP-La Liga,2022,Athletic Club,Mikel Balenziaga,ESP,DF,34,1988,1.3,4,4,1,2,1,4,4,100.0,0,0,0,0,1,5,2,0,defense
ESP-La Liga,2022,Athletic Club,Mikel Vesga,ESP,MF,29,1993,28.6,57,35,21,31,5,25,68,36.8,43,39,8,31,36,93,39,3,defense
ESP-La Liga,2022,Athletic Club,Nico Williams,ESP,FW,20,2002,29.5,31,16,10,15,6,19,41,46.3,22,40,2,38,8,39,14,1,defense
ESP-La Liga,2022,Athletic Club,Oier Zarraga,ESP,MF,23,1999,9.5,14,9,5,7,2,8,20,40.0,12,7,0,7,10,24,5,0,defense
ESP-La Liga,2022,Athletic Club,Oihan Sancet,ESP,MF,22,2000,28.1,27,16,2,19,6,11,37,29.7,26,10,0,10,4,31,9,1,defense
ESP-La Liga,2022,Athletic Club,Raúl García,ESP,"FW,MF",36,1986,10.7,12,8,3,4,5,5,15,33.3,10,13,1,12,6,18,9,0,defense
ESP-La Liga,2022,Athletic Club,Unai Simón,ESP,GK,25,1997,30.5,2,0,2,0,0,1,1,100.0,0,1,0,1,0,2,9,3,defense
ESP-La Liga,2022,Athletic Club,Unai Vencedor Paris,ESP,MF,21,2000,2.1,3,1,0,3,0,1,6,16.7,5,5,0,5,1,4,1,0,defense
ESP-La Liga,2022,Athletic Club,Yeray Álvarez,ESP,DF,27,1995,25.9,34,23,26,7,1,24,31,77.4,7,23,13,10,48,82,101,0,defense
ESP-La Liga,2022,Athletic Club,Yuri Berchiche,ESP,DF,32,1990,26.7,56,32,28,20,8,35,59,59.3,24,37,12,25,40,96,59,1,defense
ESP-La Liga,2022,Athletic Club,Álex Berenguer,ESP,FW,27,1995,25.5,58,37,17,25,16,23,60,38.3,37,37,4,33,10,68,6,0,defense
ESP-La Liga,2022,Athletic Club,Óscar de Marcos,ESP,DF,33,1989,31.3,67,33,34,22,11,40,76,52.6,36,42,6,36,29,96,59,0,defense
ESP-La Liga,2022,Atlético Madrid,Antoine Griezmann,FRA,"FW,MF",31,1991,31.8,49,34,15,23,11,20,66,30.3,46,34,3,31,24,73,31,0,defense
ESP-La Liga,2022,Atlético Madrid,Antonio Gomis,ESP,GK,19,2003,0.1,0,0,0,0,0,0,0,,0,0,0,0,0,0,0,0,defense
ESP-La Liga,2022,Atlético Madrid,Axel Witsel,BEL,"DF,MF",33,1989,25.1,36,22,22,11,3,17,31,54.8,14,20,11,9,23,59,76,0,defense
ESP-La Liga,2022,Atlético Madrid,Carlos Martín,ESP,"FW,MF",20,2002,0.3,2,2,0,2,0,2,3,66.7,1,0,0,0,1,3,0,0,defense
ESP-La Liga,2022,Atlético Madrid,Felipe,BRA,DF,33,1989,2.2,3,2,1,2,0,2,4,50.0,2,2,2,0,0,3,7,0,defense
ESP-La Liga,2022,Atlético Madrid,Geoffrey Kondogbia,CTA,MF,29,1993,11.2,40,23,19,20,1,17,25,68.0,8,9,1,8,26,66,12,1,defense
ESP-La Liga,2022,Atlético Madrid,Ivo Grbić,CRO,GK,26,1996,10.2,0,0,0,0,0,0,0,,0,0,0,0,0,0,9,1,defense
ESP-La Liga,2022,Atlético Madrid,Jan Oblak,SVN,GK,29,1993,27.7,0,0,0,0,0,0,0,,0,0,0,0,1,1,8,0,defense
ESP-La Liga,2022,Atlético Madrid,José María Giménez,URU,DF,27,1995,26.9,43,25,28,14,1,24,35,68.6,11,37,17,20,24,67,138,1,defense
ESP-La Liga,2022,Atlético Madrid,João Félix,POR,"FW,MF",22,1999,7.2,10,7,2,3,5,1,6,16.7,5,1,0,1,3,13,2,0,defense
ESP-La Liga,2022,Atlético Madrid,Koke,ESP,MF,30,1992,28.3,55,38,23,25,7,28,72,38.9,44,35,13,22,20,75,19,0,defense
ESP-La Liga,2022,Atlético Madrid,Marcos Llorente,ESP,"MF,DF",27,1995,18.9,32,15,16,10,6,17,30,56.7,13,26,2,24,17,49,19,0,defense
ESP-La Liga,2022,Atlético Madrid,Mario Hermoso,ESP,DF,27,1995,23.4,22,15,14,6,2,9,30,30.0,21,19,9,10,19,41,85,1,defense
ESP-La Liga,2022,Atlético Madrid,Matheus Cunha,BRA,"FW,MF",23,1999,4.2,4,1,1,3,0,0,3,0.0,3,4,1,3,2,6,3,0,defense
ESP-La Liga,2022,Atlético Madrid,Matt Doherty,IRL,DF,30,1992,0.2,0,0,0,0,0,0,0,,0,2,0,2,0,0,0,0,defense
ESP-La Liga,2022,Atlético Madrid,Memphis,NED,FW,28,1994,3.0,1,0,0,0,1,0,1,0.0,1,0,0,0,0,1,0,0,defense
ESP-La Liga,2022,Atlético Madrid,Nahuel Molina,ARG,DF,24,1998,31.9,69,43,38,18,13,39,91,42.9,52,38,7,31,18,87,63,1,defense
ESP-La Liga,2022,Atlético Madrid,Pablo Barrios,ESP,MF,19,2003,8.0,19,10,3,10,6,8,15,53.3,7,12,2,10,9,28,6,1,defense
ESP-La Liga,2022,Atlético Madrid,Reinildo Mandava,MOZ,DF,28,1994,20.6,66,43,46,19,1,38,49,77.6,11,27,12,15,30,96,59,0,defense
ESP-La Liga,2022,Atlético Madrid,Rodrigo De Paul,ARG,MF,28,1994,21.4,35,21,11,18,6,18,35,51.4,17,20,3,17,8,43,7,0,defense
ESP-La Liga,2022,Atlético Madrid,Saúl Ñíguez,ESP,"MF,DF",27,1994,12.2,42,27,18,18,6,22,37,59.5,15,27,5,22,15,57,29,0,defense
ESP-La Liga,2022,Atlético Madrid,Sergio Reguilón,ESP,DF,25,1996,3.4,7,5,5,2,0,5,7,71.4,2,3,0,3,2,9,4,0,defense
ESP-La Liga,2022,Atlético Madrid,Stefan Savić,MNE,DF,31,1991,21.6,39,26,29,7,3,26,39,66.7,13,17,8,9,33,72,67,2,defense
ESP-La Liga,2022,Atlético Madrid,Thomas Lemar,FRA,MF,26,1995,13.9,30,18,10,13,7,10,28,35.7,18,12,3,9,7,37,12,0,defense
ESP-La Liga,2022,Atlético Madrid,Yannick Carrasco,BEL,"DF,MF",28,1993,25.7,35,14,21,10,4,23,54,42.6,31,23,1,22,12,47,19,0,defense
ESP-La Liga,2022,Atlético Madrid,Álvaro Morata,ESP,FW,29,1992,21.1,16,11,4,8,4,3,8,37.5,5,11,3,8,0,16,23,0,defense
ESP-La Liga,2022,Atlético Madrid,Ángel Correa,ARG,"FW,MF",27,1995,16.2,12,6,6,3,3,5,16,31.3,11,17,0,17,10,22,6,1,defense
ESP-La Liga,2022,Barcelona,Aleix Garrido,ESP,FW,18,2004,0.1,2,1,1,0,1,1,1,100.0,0,1,0,1,0,2,0,0,defense
ESP-La Liga,2022,Barcelona,Alejandro Balde,ESP,DF,18,2003,27.5,42,30,22,16,4,24,41,58.5,17,25,3,22,12,54,17,1,defense
ESP-La Liga,2022,Barcelona,Andreas Christensen,DEN,DF,26,1996,19.6,20,15,9,11,0,10,16,62.5,6,14,12,2,21,41,47,0,defense
ESP-La Liga,2022,Barcelona,Ansu Fati,ESP,FW,19,2002,15.5,16,9,8,4,4,5,18,27.8,13,19,0,19,5,21,6,0,defense
ESP-La Liga,2022,Barcelona,Chadi Riad,MAR,MF,19,2003,0.0,0,0,0,0,0,0,0,,0,0,0,0,0,0,0,0,defense
ESP-La Liga,2022,Barcelona,Eric García,ESP,"DF,MF",21,2001,15.7,24,16,16,5,3,9,20,45.0,11,23,10,13,19,43,36,1,defense
ESP-La Liga,2022,Barcelona,Ferrán Torres,ESP,"FW,MF",22,2000,15.5,13,7,4,5,4,5,20,25.0,15,11,2,9,3,16,5,0,defense
ESP-La Liga,2022,Barcelona,Franck Kessié,CIV,MF,25,1996,11.0,15,9,6,6,3,8,18,44.4,10,10,2,8,12,27,11,2,defense
ESP-La Liga,2022,Barcelona,Frenkie de Jong,NED,MF,25,1997,28.2,46,26,16,21,9,17,41,41.5,24,11,1,10,35,81,22,1,defense
ESP-La Liga,2022,Barcelona,Gavi,ESP,"MF,FW",17,2004,28.1,47,31,7,30,10,21,55,38.2,34,32,5,27,18,65,22,0,defense
ESP-La Liga,2022,Barcelona,Gerard Piqué,ESP,DF,35,1987,4.3,5,4,1,4,0,4,4,100.0,0,2,1,1,2,7,19,0,defense
ESP-La Liga,2022,Barcelona,Héctor Bellerín,ESP,DF,27,1995,1.6,2,0,0,2,0,2,3,66.7,1,2,0,2,3,5,2,0,defense
ESP-La Liga,2022,Barcelona,Iñaki Peña,ESP,GK,23,1999,0.8,0,0,0,0,0,0,0,,0,0,0,0,0,0,0,1,defense
ESP-La Liga,2022,Barcelona,Jordi Alba,ESP,DF,33,1989,15.8,25,18,13,11,1,12,28,42.9,16,12,5,7,11,36,23,0,defense
ESP-La Liga,2022,Barcelona,Jules Koundé,FRA,DF,23,1998,27.0,37,23,18,13,6,21,31,67.7,10,24,9,15,19,56,61,3,defense
ESP-La Liga,2022,Barcelona,Lamine Yamal,ESP,FW,15,2007,0.1,0,0,0,0,0,0,0,,0,0,0,0,0,0,0,0,defense
ESP-La Liga,2022,Barcelona,Marc-André ter Stegen,GER,GK,30,1992,37.2,0,0,0,0,0,0,0,,0,0,0,0,1,1,7,3,defense
ESP-La Liga,2022,Barcelona,Marcos Alonso,ESP,DF,31,1990,13.0,15,10,10,5,0,9,12,75.0,3,14,10,4,11,26,32,0,defense
ESP-La Liga,2022,Barcelona,Memphis,NED,FW,28,1994,1.3,1,1,1,0,0,0,1,0.0,1,0,0,0,0,1,0,0,defense
ESP-La Liga,2022,Barcelona,Ousmane Dembélé,FRA,FW,25,1997,15.7,19,12,4,8,7,4,15,26.7,11,10,1,9,0,19,2,0,defense
ESP-La Liga,2022,Barcelona,Pablo Torre,ESP,"FW,MF",19,2003,1.6,2,1,0,1,1,2,4,50.0,2,1,0,1,2,4,1,0,defense
ESP-La Liga,2022,Barcelona,Pedri,ESP,MF,19,2002,22.0,39,22,15,17,7,13,45,28.9,32,27,0,27,13,52,8,1,defense
ESP-La Liga,2022,Barcelona,Pierre-Emerick Aubameyang,GAB,FW,33,1989,0.1,0,0,0,0,0,0,0,,0,0,0,0,0,0,0,0,defense
ESP-La Liga,2022,Barcelona,Raphinha,BRA,FW,25,1996,23.0,29,19,10,7,12,11,31,35.5,20,33,1,32,14,43,11,1,defense
ESP-La Liga,2022,Barcelona,Robert Lewandowski,POL,FW,33,1988,31.6,17,11,2,5,10,7,14,50.0,7,20,0,20,2,19,14,0,defense
ESP-La Liga,2022,Barcelona,Ronald Araújo,URU,DF,23,1999,20.0,26,18,12,13,1,6,9,66.7,3,15,7,8,12,38,41,1,defense
ESP-La Liga,2022,Barcelona,Sergi Roberto,ESP,"DF,MF",30,1992,14.5,22,15,12,6,4,7,18,38.9,11,15,7,8,11,33,16,0,defense
ESP-La Liga,2022,Barcelona,Sergio Busquets,ESP,MF,34,1988,26.0,58,26,24,26,8,29,51,56.9,22,32,6,26,27,85,36,2,defense
ESP-La Liga,2022,Barcelona,Ángel Alarcón,ESP,"FW,MF",18,2004,0.3,0,0,0,0,0,0,2,0.0,2,0,0,0,0,0,0,0,defense
ESP-La Liga,2022,Betis,Abner,BRA,DF,22,2000,6.7,12,9,9,2,1,7,16,43.8,9,8,2,6,8,20,24,0,defense
ESP-La Liga,2022,Betis,Aitor Ruibal,ESP,"DF,FW",26,1996,16.2,47,29,35,9,3,31,58,53.4,27,17,2,15,24,71,41,0,defense
ESP-La Liga,2022,Betis,Andrés Guardado,MEX,MF,35,1986,15.3,41,25,17,20,4,18,43,41.9,25,14,5,9,23,64,29,0,defense
ESP-La Liga,2022,Betis,Ayoze Pérez,ESP,"FW,MF",29,1993,15.4,31,15,9,16,6,10,40,25.0,30,22,0,22,13,44,5,0,defense
ESP-La Liga,2022,Betis,Borja Iglesias,ESP,FW,29,1993,26.3,8,4,3,3,2,2,13,15.4,11,9,1,8,1,9,17,0,defense
ESP-La Liga,2022,Betis,Claudio Bravo,CHI,GK,39,1983,12.0,0,0,0,0,0,0,0,,0,0,0,0,2,2,1,1,defense
ESP-La Liga,2022,Betis,Felix Garreta,ESP,DF,18,2004,1.0,1,0,0,1,0,0,0,,0,1,1,0,1,2,4,0,defense
ESP-La Liga,2022,Betis,Fran Delgado,ESP,DF,21,2001,0.1,0,0,0,0,0,0,0,,0,0,0,0,0,0,0,0,defense
ESP-La Liga,2022,Betis,Germán Pezzella,ARG,DF,31,1991,27.9,41,28,32,9,0,26,38,68.4,12,32,15,17,50,91,129,1,defense
ESP-La Liga,2022,Betis,Guido Rodríguez,ARG,MF,28,1994,31.9,115,75,59,50,6,54,101,53.5,47,58,14,44,42,157,76,1,defense
ESP-La Liga,2022,Betis,Joaquín,ESP,"MF,FW",41,1981,5.5,3,3,2,1,0,1,3,33.3,2,7,2,5,4,7,5,0,defense
ESP-La Liga,2022,Betis,Juan Cruz,ESP,FW,22,2000,2.0,1,0,0,1,0,1,3,33.3,2,1,0,1,0,1,0,0,defense
ESP-La Liga,2022,Betis,Juan Miranda,ESP,DF,22,2000,16.4,23,16,16,6,1,14,29,48.3,15,20,7,13,20,43,63,0,defense
ESP-La Liga,2022,Betis,Juanmi,ESP,FW,29,1993,10.3,14,10,4,7,3,7,31,22.6,24,10,0,10,4,18,4,0,defense
ESP-La Liga,2022,Betis,Loren Morón,ESP,FW,28,1993,0.2,2,2,0,1,1,0,0,,0,0,0,0,0,2,1,0,defense
ESP-La Liga,2022,Betis,Luiz Felipe,ITA,DF,25,1997,19.6,34,23,23,11,0,18,34,52.9,16,43,24,19,28,62,106,0,defense
ESP-La Liga,2022,Betis,Luiz Henrique,BRA,FW,21,2001,20.1,48,34,27,15,6,20,44,45.5,24,22,0,22,14,62,17,0,defense
ESP-La Liga,2022,Betis,Martín Montoya,ESP,DF,31,1991,5.0,13,8,9,4,0,10,12,83.3,2,6,1,5,9,22,14,1,defense
ESP-La Liga,2022,Betis,Nabil Fekir,FRA,MF,29,1993,10.7,11,5,3,3,5,2,9,22.2,7,6,2,4,1,12,0,0,defense
ESP-La Liga,2022,Betis,Paul Akouokou,CIV,"MF,DF",24,1997,5.0,16,9,13,3,0,13,20,65.0,7,2,2,0,12,28,17,1,defense
ESP-La Liga,2022,Betis,Roberto González,ESP,"FW,MF",21,2001,0.6,0,0,0,0,0,0,1,0.0,1,0,0,0,1,1,0,0,defense
ESP-La Liga,2022,Betis,Rodri,ESP,"FW,MF",22,2000,17.8,16,11,5,9,2,8,17,47.1,9,10,0,10,13,29,2,0,defense
ESP-La Liga,2022,Betis,Rui Silva,POR,GK,28,1994,26.0,4,1,4,0,0,4,4,100.0,0,0,0,0,0,4,12,1,defense
ESP-La Liga,2022,Betis,Sergio Canales,ESP,"FW,MF",31,1991,26.7,25,14,10,8,7,14,33,42.4,19,18,0,18,14,39,8,0,defense
ESP-La Liga,2022,Betis,Víctor Ruiz,ESP,DF,33,1989,6.2,5,3,3,2,0,3,3,100.0,0,10,7,3,6,11,34,0,defense
ESP-La Liga,2022,Betis,William Carvalho,POR,MF,30,1992,27.1,43,27,18,23,2,17,44,38.6,27,27,6,21,16,59,22,0,defense
ESP-La Liga,2022,Betis,Willian José,BRA,FW,30,1991,8.1,9,6,6,3,0,4,9,44.4,5,4,0,4,1,10,15,0,defense
ESP-La Liga,2022,Betis,Youssouf Sabaly,SEN,DF,29,1993,18.7,45,23,29,14,2,22,33,66.7,11,35,8,27,19,64,52,1,defense
ESP-La Liga,2022,Betis,Álex Moreno,ESP,DF,29,1993,15.0,29,22,19,10,0,18,36,50.0,18,17,4,13,17,46,39,0,defense
ESP-La Liga,2022,Betis,Édgar González,ESP,DF,25,1997,19.7,28,19,18,7,3,14,27,51.9,13,12,9,3,21,49,120,0,defense
ESP-La Liga,2022,Celta Vigo,Agustín Marchesín,ARG,GK,34,1988,19.0,0,0,0,0,0,0,1,0.0,1,0,0,0,0,0,7,0,defense
ESP-La Liga,2022,Celta Vigo,Augusto Solari,ARG,MF,30,1992,2.9,10,6,6,3,1,3,11,27.3,8,5,0,5,4,14,3,0,defense
ESP-La Liga,2022,Celta Vigo,Carles Pérez,ESP,"MF,FW",24,1998,23.8,39,23,12,17,10,22,66,33.3,44,29,3,26,6,45,9,0,defense
ESP-La Liga,2022,Celta Vigo,Carlos Dominguez,ESP,DF,21,2001,1.2,1,1,0,1,0,1,2,50.0,1,1,1,0,0,1,7,0,defense
ESP-La Liga,2022,Celta Vigo,Fernando Medrano,ESP,DF,22,2000,0.1,2,1,2,0,0,1,1,100.0,0,0,0,0,1,3,1,0,defense
ESP-La Liga,2022,Celta Vigo,Fran Beltrán,ESP,MF,23,1999,31.7,34,22,15,14,5,14,55,25.5,41,29,5,24,53,87,35,2,defense
ESP-La Liga,2022,Celta Vigo,Franco Cervi,ARG,"MF,DF",28,1994,21.0,76,46,29,36,11,33,66,50.0,33,33,1,32,36,112,16,0,defense
ESP-La Liga,2022,Celta Vigo,Gabriel Veiga,ESP,MF,20,2002,25.5,43,19,14,25,4,16,52,30.8,36,30,3,27,21,64,6,0,defense
ESP-La Liga,2022,Celta Vigo,Gonçalo Paciência,POR,"FW,MF",27,1994,7.4,8,5,0,5,3,2,7,28.6,5,9,1,8,0,8,4,0,defense
ESP-La Liga,2022,Celta Vigo,Haris Seferović,SUI,FW,30,1992,9.9,6,3,1,4,1,3,8,37.5,5,7,1,6,1,7,6,1,defense
ESP-La Liga,2022,Celta Vigo,Hugo Mallo,ESP,DF,31,1991,24.0,53,29,34,14,5,28,42,66.7,14,28,7,21,24,77,73,0,defense
ESP-La Liga,2022,Celta Vigo,Hugo Sotelo,ESP,MF,18,2003,0.2,0,0,0,0,0,0,0,,0,0,0,0,0,0,0,0,defense
ESP-La Liga,2022,Celta Vigo,Iago Aspas,ESP,FW,34,1987,31.9,8,4,0,4,4,3,22,13.6,19,10,1,9,7,15,23,0,defense
ESP-La Liga,2022,Celta Vigo,Iván Villar,ESP,GK,25,1997,19.0,0,0,0,0,0,0,1,0.0,1,0,0,0,0,0,7,0,defense
ESP-La Liga,2022,Celta Vigo,Javi Galán,ESP,DF,27,1994,35.1,104,72,60,40,4,48,98,49.0,50,54,5,49,41,145,63,1,defense
ESP-La Liga,2022,Celta Vigo,Joseph Aidoo,GHA,DF,26,1995,34.7,51,36,33,17,1,16,28,57.1,12,26,14,12,31,82,150,0,defense
ESP-La Liga,2022,Celta Vigo,Jørgen Strand Larsen,NOR,FW,22,2000,18.9,15,7,3,5,7,7,30,23.3,23,14,5,9,3,18,24,0,defense
ESP-La Liga,2022,Celta Vigo,Kevin Vázquez,ESP,"DF,MF",29,1993,4.9,13,8,5,7,1,8,12,66.7,4,4,1,3,2,15,8,0,defense
ESP-La Liga,2022,Celta Vigo,Luca de la Torre,USA,MF,24,1998,16.5,28,19,11,14,3,12,32,37.5,20,22,1,21,9,37,6,0,defense
ESP-La Liga,2022,Celta Vigo,Miguel Rodríguez,ESP,"MF,FW",19,2003,2.8,7,5,4,3,0,4,11,36.4,7,6,0,6,1,8,3,0,defense
ESP-La Liga,2022,Celta Vigo,Pablo Durán,ESP,"MF,DF",21,2001,0.4,0,0,0,0,0,0,0,,0,2,1,1,1,1,2,0,defense
ESP-La Liga,2022,Celta Vigo,Renato Tapia,PER,"MF,DF",27,1995,16.1,47,25,21,21,5,18,37,48.6,19,29,11,18,19,66,37,0,defense
ESP-La Liga,2022,Celta Vigo,Unai Núñez,ESP,DF,25,1997,35.0,47,35,29,15,3,18,34,52.9,16,27,17,10,72,119,135,1,defense
ESP-La Liga,2022,Celta Vigo,Williot Swedberg,SWE,MF,18,2004,0.6,3,1,1,0,2,0,0,,0,2,0,2,0,3,1,0,defense
ESP-La Liga,2022,Celta Vigo,Óscar Mingueza,ESP,DF,23,1999,14.3,37,21,27,9,1,25,32,78.1,7,10,4,6,12,49,25,0,defense
ESP-La Liga,2022,Celta Vigo,Óscar Rodríguez Arnaiz,ESP,MF,24,1998,19.7,32,25,12,15,5,13,28,46.4,15,16,2,14,24,56,15,0,defense
ESP-La Liga,2022,Cádiz,Alberto Perea,ESP,MF,31,1990,0.5,2,0,2,0,0,0,0,,0,2,0,2,0,2,0,0,defense
ESP-La Liga,2022,Cádiz,Alfonso Espino,URU,DF,30,1992,34.7,87,56,55,20,12,48,96,50.0,48,52,11,41,48,135,99,3,defense
ESP-La Liga,2022,Cádiz,Anthony Lozano,HON,FW,29,1993,16.0,6,4,1,4,1,1,7,14.3,6,12,1,11,3,9,17,0,defense
ESP-La Liga,2022,Cádiz,Antonio Blanco,ESP,MF,22,2000,1.8,6,4,5,1,0,4,6,66.7,2,5,0,5,1,7,3,0,defense
ESP-La Liga,2022,Cádiz,Awer Mabil,AUS,"MF,FW",26,1995,1.8,2,0,0,1,1,1,3,33.3,2,1,1,0,0,2,1,0,defense
ESP-La Liga,2022,Cádiz,Brian Ocampo,URU,"MF,FW",23,1999,12.4,18,15,12,5,1,8,21,38.1,13,13,0,13,3,21,3,0,defense
ESP-La Liga,2022,Cádiz,Cala,ESP,DF,32,1989,1.5,2,1,1,1,0,1,2,50.0,1,2,1,1,1,3,12,0,defense
ESP-La Liga,2022,Cádiz,Carlos García,ESP,DF,22,2000,0.3,0,0,0,0,0,0,0,,0,0,0,0,0,0,2,0,defense
ESP-La Liga,2022,Cádiz,Chris Ramos,ESP,FW,25,1997,7.9,12,9,2,7,3,4,11,36.4,7,8,3,5,1,13,19,0,defense
ESP-La Liga,2022,Cádiz,David Gil,ESP,GK,28,1994,4.0,0,0,0,0,0,0,0,,0,0,0,0,0,0,3,0,defense
ESP-La Liga,2022,Cádiz,Fali,ESP,"DF,MF",28,1993,19.0,27,19,19,8,0,18,29,62.1,11,24,15,9,13,40,70,1,defense
ESP-La Liga,2022,Cádiz,Fede San Emeterio,ESP,MF,25,1997,20.5,41,22,23,16,2,22,46,47.8,24,34,14,20,17,58,28,0,defense
ESP-La Liga,2022,Cádiz,Francisco Mwepu,ZAM,FW,22,2000,0.2,1,0,0,1,0,0,0,,0,0,0,0,0,1,0,0,defense
ESP-La Liga,2022,Cádiz,Gonzalo Escalante,ARG,MF,29,1993,12.5,36,24,15,20,1,15,29,51.7,14,18,4,14,17,53,26,1,defense
ESP-La Liga,2022,Cádiz,Isaac Carcelen,ESP,DF,29,1993,24.4,69,51,41,22,6,41,63,65.1,22,35,11,24,19,88,80,1,defense
ESP-La Liga,2022,Cádiz,Iván Alejo,ESP,"MF,FW",27,1995,14.6,32,21,19,9,4,17,37,45.9,20,18,3,15,5,37,12,1,defense
ESP-La Liga,2022,Cádiz,Jeremías Ledesma,ARG,GK,29,1993,34.0,3,2,3,0,0,3,7,42.9,4,1,0,1,2,5,23,3,defense
ESP-La Liga,2022,Cádiz,Jorge Meré,ESP,DF,25,1997,6.7,11,7,9,2,0,5,8,62.5,3,9,6,3,6,17,32,0,defense
ESP-La Liga,2022,Cádiz,Joseba Zaldúa,ESP,DF,30,1992,7.1,15,8,10,4,1,7,10,70.0,3,4,2,2,11,26,22,0,defense
ESP-La Liga,2022,Cádiz,José Antonio,ESP,"MF,DF",18,2004,0.5,2,1,0,0,2,0,0,,0,0,0,0,0,2,0,0,defense
ESP-La Liga,2022,Cádiz,José Mari,ESP,MF,34,1987,4.4,16,7,12,3,1,10,16,62.5,6,3,1,2,5,21,9,0,defense
ESP-La Liga,2022,Cádiz,Lucas Pérez,ESP,FW,33,1988,7.0,3,2,2,1,0,1,3,33.3,2,2,0,2,1,4,3,0,defense
ESP-La Liga,2022,Cádiz,Luis Hernández,ESP,DF,33,1989,35.0,33,21,25,7,1,22,36,61.1,14,31,24,7,31,64,145,0,defense
ESP-La Liga,2022,Cádiz,Mamadou Mbaye,SEN,DF,24,1998,8.4,10,7,7,3,0,6,8,75.0,2,10,8,2,7,17,50,1,defense
ESP-La Liga,2022,Cádiz,Mamady Diarra,MLI,"MF,DF",22,2000,0.7,2,1,2,0,0,1,2,50.0,1,2,0,2,0,2,0,0,defense
ESP-La Liga,2022,Cádiz,Raúl Parra,ESP,DF,22,1999,3.4,4,2,4,0,0,4,9,44.4,5,5,3,2,1,5,9,0,defense
ESP-La Liga,2022,Cádiz,Roger Martí,ESP,FW,31,1991,7.1,6,4,2,3,1,1,8,12.5,7,7,0,7,2,8,7,0,defense
ESP-La Liga,2022,Cádiz,Rubén Alcaraz,ESP,MF,31,1991,22.7,43,31,24,18,1,19,54,35.2,35,23,8,15,19,62,37,0,defense
ESP-La Liga,2022,Cádiz,Rubén Sobrino,ESP,"MF,FW",30,1992,27.4,55,37,29,17,9,23,56,41.1,33,33,3,30,24,79,20,1,defense
ESP-La Liga,2022,Cádiz,Santiago Arzamendia,PAR,"DF,MF",24,1998,5.4,9,8,7,1,1,6,21,28.6,15,11,1,10,2,11,15,1,defense
ESP-La Liga,2022,Cádiz,Sergi Guardiola,ESP,FW,31,1991,12.9,9,7,0,6,3,3,12,25.0,9,5,0,5,3,12,7,0,defense
ESP-La Liga,2022,Cádiz,Theo Bongonda,COD,"MF,FW",26,1995,21.5,28,20,11,14,3,17,40,42.5,23,21,2,19,6,34,14,0,defense
ESP-La Liga,2022,Cádiz,Tomás Alarcón,CHI,MF,23,1999,2.5,3,2,0,2,1,1,2,50.0,1,1,0,1,2,5,2,0,defense
ESP-La Liga,2022,Cádiz,Víctor Chust,ESP,DF,22,2000,10.7,9,6,7,2,0,4,7,57.1,3,8,3,5,10,19,53,0,defense
ESP-La Liga,2022,Cádiz,Youba Diarra,MLI,MF,24,1998,1.1,3,0,2,1,0,1,5,20.0,4,7,1,6,2,5,3,0,defense
ESP-La Liga,2022,Cádiz,Álex Fernández,ESP,"MF,FW",29,1992,17.5,13,7,6,4,3,4,14,28.6,10,14,1,13,8,21,19,0,defense
ESP-La Liga,2022,Cádiz,Álvaro Giménez,ESP,FW,31,1991,0.2,0,0,0,0,0,0,1,0.0,1,0,0,0,0,0,0,0,defense
ESP-La Liga,2022,Cádiz,Álvaro Negredo,ESP,FW,36,1985,8.4,5,4,1,2,2,2,2,100.0,0,4,1,3,0,5,8,0,defense
ESP-La Liga,2022,Elche,Alejandro Alfaro,ESP,MF,20,2002,0.2,0,0,0,0,0,0,0,,0,0,0,0,0,0,0,0,defense
ESP-La Liga,2022,Elche,Axel Werner,ARG,GK,26,1996,2.0,0,0,0,0,0,0,1,0.0,1,0,0,0,0,0,0,0,defense
ESP-La Liga,2022,Elche,Carlos Clerc,ESP,"DF,MF",30,1992,29.3,75,51,55,16,4,31,50,62.0,19,29,7,22,28,103,94,1,defense
ESP-La Liga,2022,Elche,Carmona,ESP,"MF,DF",20,2002,6.5,16,9,7,6,3,6,16,37.5,10,14,2,12,8,24,9,0,defense
ESP-La Liga,2022,Elche,Diego González,ESP,DF,27,1995,10.6,12,7,9,3,0,7,11,63.6,4,14,12,2,7,19,50,1,defense
ESP-La Liga,2022,Elche,Domingos Quina,POR,MF,22,1999,3.1,3,2,2,1,0,1,3,33.3,2,5,0,5,3,6,1,0,defense
ESP-La Liga,2022,Elche,Enzo Roco,CHI,DF,29,1992,18.4,33,13,23,10,0,15,24,62.5,9,22,15,7,17,50,63,1,defense
ESP-La Liga,2022,Elche,Ezequiel Ponce,ARG,"FW,MF",25,1997,12.5,9,7,0,6,3,0,7,0.0,7,6,1,5,1,10,13,0,defense
ESP-La Liga,2022,Elche,Federico Fernández,ARG,DF,33,1989,1.0,1,1,1,0,0,1,1,100.0,0,0,0,0,2,3,12,0,defense
ESP-La Liga,2022,Elche,Fidel,ESP,"MF,FW",32,1989,19.0,15,10,8,5,2,4,38,10.5,34,9,0,9,5,20,8,0,defense
ESP-La Liga,2022,Elche,Gerard Gumbau,ESP,MF,27,1994,30.4,44,25,17,23,4,18,51,35.3,33,32,8,24,28,72,40,0,defense
ESP-La Liga,2022,Elche,Gonzalo Verdú,ESP,DF,33,1988,7.8,10,5,8,2,0,4,8,50.0,4,8,6,2,10,20,33,0,defense
ESP-La Liga,2022,Elche,Helibelton Palacios,COL,DF,29,1993,21.3,38,20,21,15,2,19,26,73.1,7,26,12,14,20,58,55,0,defense
ESP-La Liga,2022,Elche,Javier Pastore,ARG,MF,33,1989,0.1,0,0,0,0,0,0,0,,0,0,0,0,0,0,0,0,defense
ESP-La Liga,2022,Elche,Johan Mojica,COL,"DF,MF",29,1992,3.0,6,3,5,1,0,2,3,66.7,1,3,2,1,4,10,5,0,defense
ESP-La Liga,2022,Elche,John Donald,ESP,"MF,DF",21,2000,12.1,20,11,9,9,2,7,14,50.0,7,14,7,7,14,34,23,1,defense
ESP-La Liga,2022,Elche,Josan,ESP,"DF,MF",32,1989,12.0,25,20,20,5,0,14,27,51.9,13,8,0,8,7,32,15,1,defense
ESP-La Liga,2022,Elche,Lautaro Blanco,ARG,"DF,MF",23,1999,9.7,16,9,10,4,2,9,26,34.6,17,8,1,7,2,18,10,1,defense
ESP-La Liga,2022,Elche,Lisandro Magallán,ARG,DF,28,1993,10.0,19,11,11,5,3,10,12,83.3,2,14,5,9,13,32,30,1,defense
ESP-La Liga,2022,Elche,Lucas Boyé,ARG,FW,26,1996,27.4,36,16,12,16,8,17,35,48.6,18,33,5,28,15,51,46,0,defense
ESP-La Liga,2022,Elche,Nicolás Ezequiel Fernández,ARG,"MF,DF",22,2000,5.7,23,12,10,7,6,9,17,52.9,8,7,0,7,5,28,2,1,defense
ESP-La Liga,2022,Elche,Omar Mascarell,EQG,"MF,DF",29,1993,27.2,53,26,32,19,2,31,64,48.4,33,51,19,32,45,98,54,1,defense
ESP-La Liga,2022,Elche,Pape Cheikh Diop,SEN,MF,24,1997,0.4,0,0,0,0,0,0,1,0.0,1,0,0,0,0,0,0,0,defense
ESP-La Liga,2022,Elche,Pedro Bigas,ESP,DF,31,1990,22.4,37,20,30,7,0,18,29,62.1,11,25,14,11,33,70,95,0,defense
ESP-La Liga,2022,Elche,Pere Milla,ESP,"FW,MF",29,1992,20.5,31,20,18,8,5,14,41,34.1,27,18,3,15,9,40,19,1,defense
ESP-La Liga,2022,Elche,Pol Lirola,ESP,DF,24,1997,7.0,13,6,9,3,1,8,13,61.5,5,3,2,1,7,20,16,0,defense
ESP-La Liga,2022,Elche,Randy Nteka,ANG,"FW,MF",24,1997,8.1,15,10,7,6,2,2,11,18.2,9,15,3,12,4,19,9,0,defense
ESP-La Liga,2022,Elche,Raúl Guti,ESP,MF,25,1996,12.4,18,12,8,9,1,8,18,44.4,10,10,3,7,8,26,6,0,defense
ESP-La Liga,2022,Elche,Roger Martí,ESP,FW,31,1991,7.3,5,2,3,2,0,1,5,20.0,4,4,0,4,1,6,7,0,defense
ESP-La Liga,2022,Elche,Tete Morente,ESP,"MF,DF",25,1996,23.0,33,21,18,13,2,15,36,41.7,21,23,3,20,25,58,28,0,defense
ESP-La Liga,2022,Elche,Álex Collado,ESP,MF,23,1999,8.0,26,14,13,11,2,8,13,61.5,5,12,1,11,2,28,4,0,defense
ESP-La Liga,2022,Elche,Édgar Badía,ESP,GK,30,1992,36.0,1,0,1,0,0,1,2,50.0,1,0,0,0,0,1,19,3,defense
ESP-La Liga,2022,Espanyol,Adri Embarba,ESP,FW,30,1992,0.4,1,0,0,1,0,1,1,100.0,0,1,0,1,0,1,0,0,defense
ESP-La Liga,2022,Espanyol,Adrià Pedrosa,ESP,"DF,MF",24,1998,2.5,5,1,5,0,0,4,7,57.1,3,1,1,0,5,10,3,0,defense
ESP-La Liga,2022,Espanyol,Aleix Vidal,ESP,"MF,FW",32,1989,11.4,11,5,6,3,2,4,22,18.2,18,21,2,19,15,26,14,0,defense
ESP-La Liga,2022,Espanyol,Benjamin Lecomte,FRA,GK,31,1991,10.0,0,0,0,0,0,0,0,,0,0,0,0,0,0,3,2,defense
ESP-La Liga,2022,Espanyol,Brian Oliván,ESP,DF,28,1994,26.7,47,27,30,12,5,17,26,65.4,9,26,6,20,22,69,67,0,defense
ESP-La Liga,2022,Espanyol,César Montes,MEX,DF,25,1997,17.7,17,9,10,7,0,10,18,55.6,8,19,12,7,14,31,101,0,defense
ESP-La Liga,2022,Espanyol,Dani Gómez,ESP,"MF,FW",24,1998,1.0,2,1,1,1,0,1,2,50.0,1,0,0,0,1,3,0,0,defense
ESP-La Liga,2022,Espanyol,Denis Suárez,ESP,"MF,FW",28,1994,10.5,26,20,12,12,2,13,45,28.9,32,11,1,10,5,31,4,0,defense
ESP-La Liga,2022,Espanyol,Edu Expósito,ESP,MF,25,1996,12.9,34,20,16,15,3,13,23,56.5,10,7,0,7,12,46,20,0,defense
ESP-La Liga,2022,Espanyol,Fernando Calero,ESP,"DF,MF",26,1995,17.9,46,29,27,15,4,21,34,61.8,13,31,13,18,13,59,52,0,defense
ESP-La Liga,2022,Espanyol,Fernando Pacheco,ESP,GK,30,1992,16.0,0,0,0,0,0,0,1,0.0,1,0,0,0,1,1,11,0,defense
ESP-La Liga,2022,Espanyol,Javi Puado,ESP,"FW,MF",24,1998,26.0,20,11,12,5,3,12,28,42.9,16,12,2,10,10,30,14,0,defense
ESP-La Liga,2022,Espanyol,Joan García,ESP,GK,21,2001,1.0,0,0,0,0,0,0,0,,0,0,0,0,0,0,0,0,defense
ESP-La Liga,2022,Espanyol,Joselu,ESP,FW,32,1990,33.2,13,11,3,4,6,4,17,23.5,13,25,4,21,8,21,43,0,defense
ESP-La Liga,2022,Espanyol,José Carlos Lazo,ESP,"MF,FW",26,1996,1.8,5,3,2,2,1,3,3,100.0,0,2,0,2,3,8,5,0,defense
ESP-La Liga,2022,Espanyol,José Gragera,ESP,"MF,DF",21,2000,5.1,19,9,11,6,2,6,11,54.5,5,10,4,6,7,26,18,0,defense
ESP-La Liga,2022,Espanyol,Keidi Bare,ALB,MF,24,1997,5.6,15,8,7,5,3,7,13,53.8,6,8,2,6,11,26,8,0,defense
ESP-La Liga,2022,Espanyol,Leandro Cabrera,URU,DF,31,1991,29.7,46,24,34,12,0,28,43,65.1,15,37,23,14,43,89,114,2,defense
ESP-La Liga,2022,Espanyol,Luca Koleosho,ITA,"FW,DF",17,2004,0.7,2,2,0,0,2,1,2,50.0,1,1,0,1,0,2,0,0,defense
ESP-La Liga,2022,Espanyol,Martin Braithwaite,DEN,"FW,MF",31,1991,27.3,12,2,2,4,6,5,14,35.7,9,10,0,10,5,17,11,0,defense
ESP-La Liga,2022,Espanyol,Nabil Touaizi,MAR,MF,21,2001,0.0,0,0,0,0,0,0,0,,0,0,0,0,0,0,0,0,defense
ESP-La Liga,2022,Espanyol,Nico Ribaudo,ESP,"MF,FW",21,2001,13.9,18,13,5,9,4,11,30,36.7,19,19,1,18,5,23,1,0,defense
ESP-La Liga,2022,Espanyol,Omar El Hilali,MAR,"DF,MF",18,2003,1.0,3,2,3,0,0,1,2,50.0,1,1,0,1,1,4,6,0,defense
ESP-La Liga,2022,Espanyol,Pol Lozano,ESP,MF,22,1999,0.2,0,0,0,0,0,0,0,,0,1,0,1,0,0,1,0,defense
ESP-La Liga,2022,Espanyol,Roger Martínez,ESP,DF,18,2004,0.1,0,0,0,0,0,0,0,,0,0,0,0,0,0,0,0,defense
ESP-La Liga,2022,Espanyol,Ronaël Pierre-Gabriel,FRA,DF,24,1998,2.6,17,9,12,4,1,5,11,45.5,6,5,2,3,9,26,11,0,defense
ESP-La Liga,2022,Espanyol,Rubén,ESP,"DF,MF",21,2001,9.9,30,15,18,9,3,20,29,69.0,9,14,4,10,18,48,18,0,defense
ESP-La Liga,2022,Espanyol,Sergi Darder,ESP,MF,28,1993,36.9,69,38,12,43,14,29,73,39.7,44,34,2,32,24,93,23,0,defense
ESP-La Liga,2022,Espanyol,Sergi Gómez,ESP,DF,30,1992,26.0,29,16,20,9,0,18,22,81.8,4,33,19,14,27,56,125,1,defense
ESP-La Liga,2022,Espanyol,Simo,ESP,DF,17,2005,1.6,3,1,3,0,0,2,3,66.7,1,5,4,1,0,3,3,0,defense
ESP-La Liga,2022,Espanyol,Vinicius Souza,BRA,MF,23,1999,27.0,99,66,41,45,13,33,59,55.9,26,31,14,17,48,147,50,1,defense
ESP-La Liga,2022,Espanyol,Álvaro Fernández,ESP,GK,24,1998,11.0,0,0,0,0,0,0,0,,0,0,0,0,0,0,7,2,defense
ESP-La Liga,2022,Espanyol,Óscar Gil,ESP,DF,25,1997,28.4,63,37,38,16,9,32,61,52.5,29,51,18,33,31,94,55,1,defense
ESP-La Liga,2022,Getafe,Alejandro Revuelta Montero,ESP,DF,22,2000,0.0,0,0,0,0,0,0,0,,0,0,0,0,0,0,1,0,defense
ESP-La Liga,2022,Getafe,Borja Mayoral,ESP,FW,25,1997,30.7,9,4,7,2,0,5,31,16.1,26,18,0,18,3,12,10,0,defense
ESP-La Liga,2022,Getafe,Carles Aleñá,ESP,"MF,FW",24,1998,23.5,18,10,7,5,6,5,34,14.7,29,19,1,18,4,22,18,0,defense
ESP-La Liga,2022,Getafe,Damián Suárez,URU,"DF,MF",34,1988,21.6,49,33,23,19,7,26,48,54.2,22,40,0,40,15,64,36,0,defense
ESP-La Liga,2022,Getafe,David Soria,ESP,GK,29,1993,38.0,0,0,0,0,0,0,1,0.0,1,0,0,0,1,1,20,4,defense
ESP-La Liga,2022,Getafe,Djené,TOG,DF,30,1991,31.6,41,28,23,17,1,22,38,57.9,16,25,10,15,42,83,81,1,defense
ESP-La Liga,2022,Getafe,Domingos Duarte,POR,DF,27,1995,29.5,26,18,21,5,0,19,26,73.1,7,29,23,6,39,65,145,0,defense
ESP-La Liga,2022,Getafe,Enes Ünal,TUR,FW,25,1997,33.0,26,14,5,19,2,7,25,28.0,18,19,2,17,6,32,35,0,defense
ESP-La Liga,2022,Getafe,Fabrizio Angileri,ARG,DF,28,1994,6.5,12,9,8,3,1,10,17,58.8,7,8,3,5,7,19,10,0,defense
ESP-La Liga,2022,Getafe,Gastón Álvarez,URU,DF,22,2000,16.7,38,30,24,9,5,23,42,54.8,19,15,5,10,15,53,35,0,defense
ESP-La Liga,2022,Getafe,Gonzalo Villar,ESP,MF,24,1998,5.1,10,5,1,6,3,6,14,42.9,8,9,2,7,6,16,5,0,defense
ESP-La Liga,2022,Getafe,Iglesias,ESP,"DF,MF",24,1998,23.8,61,35,40,18,3,33,65,50.8,32,40,5,35,21,82,91,1,defense
ESP-La Liga,2022,Getafe,Jaime Mata,ESP,"FW,MF",33,1988,4.9,13,10,4,5,4,7,22,31.8,15,7,2,5,3,16,6,0,defense
ESP-La Liga,2022,Getafe,Jaime Seoane,ESP,"MF,FW",25,1997,3.6,10,4,3,4,3,2,8,25.0,6,7,3,4,1,11,2,0,defense
ESP-La Liga,2022,Getafe,Jordan Amavi,FRA,DF,28,1994,2.2,3,2,3,0,0,1,3,33.3,2,3,0,3,4,7,7,0,defense
ESP-La Liga,2022,Getafe,Juanmi Latasa,ESP,FW,21,2001,5.0,5,4,2,0,3,1,1,100.0,0,3,1,2,1,6,8,0,defense
ESP-La Liga,2022,Getafe,Luis Milla,ESP,MF,27,1994,20.6,48,30,21,18,9,19,44,43.2,25,13,1,12,32,80,25,1,defense
ESP-La Liga,2022,Getafe,Mauro Arambarri,URU,MF,26,1995,11.0,14,6,9,4,1,3,17,17.6,14,17,5,12,14,28,19,0,defense
ESP-La Liga,2022,Getafe,Moises Parra Gutierrez,ESP,FW,20,2002,0.1,1,0,0,1,0,0,0,,0,0,0,0,0,1,0,0,defense
ESP-La Liga,2022,Getafe,Munir El Haddadi,MAR,"MF,FW",26,1995,12.8,12,7,3,7,2,2,10,20.0,8,23,2,21,9,21,7,0,defense
ESP-La Liga,2022,Getafe,Nemanja Maksimović,SRB,MF,27,1995,22.8,41,30,17,18,6,19,32,59.4,13,36,14,22,34,75,27,0,defense
ESP-La Liga,2022,Getafe,Omar Alderete,PAR,DF,25,1996,22.7,35,20,21,14,0,28,40,70.0,12,23,16,7,26,61,85,0,defense
ESP-La Liga,2022,Getafe,Portu,ESP,"MF,DF",30,1992,19.7,28,21,14,10,4,18,42,42.9,24,23,3,20,17,45,20,1,defense
ESP-La Liga,2022,Getafe,Stefan Mitrović,SRB,DF,32,1990,18.7,14,6,12,2,0,7,11,63.6,4,12,10,2,17,31,90,2,defense
ESP-La Liga,2022,Getafe,Ángel Algobia,ESP,MF,23,1999,12.6,27,13,14,13,0,22,48,45.8,26,15,5,10,3,30,11,0,defense
ESP-La Liga,2022,Girona,Aleix García,ESP,MF,25,1997,26.0,37,20,9,18,10,15,33,45.5,18,24,8,16,31,68,35,1,defense
ESP-La Liga,2022,Girona,Alexander Callens,PER,DF,30,1992,1.3,3,3,2,1,0,3,4,75.0,1,3,1,2,1,4,9,0,defense
ESP-La Liga,2022,Girona,Arnau Martinez,ESP,DF,19,2003,30.4,69,45,41,19,9,38,85,44.7,47,44,10,34,25,94,54,2,defense
ESP-La Liga,2022,Girona,Bernardo Espinosa,COL,DF,33,1989,13.6,6,2,2,4,0,3,9,33.3,6,17,10,7,12,18,70,2,defense
ESP-La Liga,2022,Girona,Borja García,ESP,"MF,FW",31,1990,7.5,10,4,7,2,1,2,9,22.2,7,3,1,2,5,15,6,1,defense
ESP-La Liga,2022,Girona,Cristhian Stuani,URU,FW,35,1986,12.1,13,6,2,7,4,5,14,35.7,9,10,0,10,2,15,5,0,defense
ESP-La Liga,2022,Girona,David López,ESP,DF,32,1989,18.4,31,18,17,13,1,19,27,70.4,8,29,19,10,14,45,64,1,defense
ESP-La Liga,2022,Girona,Iván Martín,ESP,MF,23,1999,17.6,9,7,4,4,1,8,23,34.8,15,12,0,12,9,18,12,0,defense
ESP-La Liga,2022,Girona,Javi Hernández,ESP,DF,24,1998,12.4,21,12,12,7,2,13,21,61.9,8,10,5,5,7,28,38,0,defense
ESP-La Liga,2022,Girona,Joel Roca,ESP,"MF,FW",17,2005,0.9,2,2,2,0,0,2,5,40.0,3,1,1,0,0,2,1,0,defense
ESP-La Liga,2022,Girona,Juan Carlos,ESP,GK,34,1988,10.0,0,0,0,0,0,0,0,,0,0,0,0,1,1,7,1,defense
ESP-La Liga,2022,Girona,Juanpe,ESP,DF,31,1991,15.8,19,11,10,9,0,11,17,64.7,6,12,9,3,10,29,60,1,defense
ESP-La Liga,2022,Girona,Manu Vallejo,ESP,"FW,MF",25,1997,2.3,4,1,1,2,1,1,6,16.7,5,2,0,2,1,5,3,0,defense
ESP-La Liga,2022,Girona,Miguel Gutiérrez,ESP,DF,21,2001,26.6,41,23,23,13,5,23,37,62.2,14,23,5,18,18,59,42,1,defense
ESP-La Liga,2022,Girona,Oriol Romeu,ESP,MF,30,1991,32.8,70,38,36,26,8,26,51,51.0,25,48,10,38,37,107,54,0,defense
ESP-La Liga,2022,Girona,Oscar Ureña,DOM,MF,19,2003,1.1,4,2,2,2,0,2,3,66.7,1,2,0,2,1,5,0,0,defense
ESP-La Liga,2022,Girona,Paulo Gazzaniga,ARG,GK,30,1992,28.0,0,0,0,0,0,0,1,0.0,1,0,0,0,1,1,9,5,defense
ESP-La Liga,2022,Girona,Ramón Terrats,ESP,MF,21,2000,2.4,4,2,1,3,0,2,6,33.3,4,6,2,4,3,7,3,1,defense
ESP-La Liga,2022,Girona,Reinier,BRA,"MF,FW",20,2002,7.2,12,10,7,3,2,2,8,25.0,6,6,0,6,5,17,4,0,defense
ESP-La Liga,2022,Girona,Ricard Artero,ESP,"MF,FW",19,2003,1.5,3,3,2,1,0,1,1,100.0,0,2,0,2,1,4,3,0,defense
ESP-La Liga,2022,Girona,Rodrigo Riquelme,ESP,"MF,FW",22,2000,24.2,20,8,8,8,4,9,35,25.7,26,16,0,16,11,31,5,0,defense
ESP-La Liga,2022,Girona,Samuel Sáiz,ESP,MF,31,1991,2.7,2,2,0,2,0,1,2,50.0,1,3,0,3,0,2,1,1,defense
ESP-La Liga,2022,Girona,Santiago Bueno,URU,DF,23,1998,33.4,63,38,43,19,1,24,36,66.7,12,34,22,12,31,94,105,2,defense
ESP-La Liga,2022,Girona,Toni Villa,ESP,"MF,FW",27,1995,9.9,25,18,9,11,5,10,23,43.5,13,8,0,8,8,33,3,0,defense
ESP-La Liga,2022,Girona,Valentín Castellanos,ARG,FW,23,1998,28.9,12,5,2,7,3,0,18,0.0,18,22,2,20,6,18,26,0,defense
ESP-La Liga,2022,Girona,Valery Fernández,ESP,"MF,DF",22,1999,10.7,12,6,4,6,2,5,9,55.6,4,8,1,7,10,22,9,1,defense
ESP-La Liga,2022,Girona,Viktor Tsyhankov,UKR,MF,24,1997,16.5,8,8,5,1,2,1,14,7.1,13,13,2,11,7,15,12,0,defense
ESP-La Liga,2022,Girona,Yan Couto,BRA,"DF,MF",20,2002,12.9,25,18,11,11,3,12,20,60.0,8,7,2,5,5,30,10,0,defense
ESP-La Liga,2022,Girona,Yangel Herrera,VEN,"MF,FW",24,1998,10.7,26,9,9,14,3,6,15,40.0,9,14,1,13,4,30,12,0,defense
ESP-La Liga,2022,Mallorca,Abdón Prats,ESP,"FW,MF",29,1992,4.6,1,0,1,0,0,0,0,,0,5,0,5,0,1,2,0,defense
ESP-La Liga,2022,Mallorca,Amath,SEN,"MF,FW",26,1996,13.6,29,19,14,8,7,14,22,63.6,8,13,1,12,5,34,5,0,defense
ESP-La Liga,2022,Mallorca,Antonio Raillo,ESP,DF,30,1991,30.7,34,21,23,11,0,10,15,66.7,5,38,29,9,31,65,158,1,defense
ESP-La Liga,2022,Mallorca,Antonio Sánchez,ESP,"MF,DF",25,1997,12.0,19,8,13,4,2,10,34,29.4,24,18,0,18,22,41,14,1,defense
ESP-La Liga,2022,Mallorca,Braian Cufré,ARG,DF,25,1996,2.4,5,2,2,1,2,2,5,40.0,3,2,1,1,2,7,1,0,defense
ESP-La Liga,2022,Mallorca,Clément Grenier,FRA,MF,31,1991,8.0,20,8,6,12,2,10,20,50.0,10,9,1,8,6,26,7,0,defense
ESP-La Liga,2022,Mallorca,Copete,ESP,DF,22,1999,24.5,53,28,35,16,2,26,36,72.2,10,38,17,21,44,97,111,2,defense
ESP-La Liga,2022,Mallorca,Dani Rodríguez,ESP,MF,34,1988,23.3,42,23,18,22,2,21,46,45.7,25,31,8,23,21,63,14,0,defense
ESP-La Liga,2022,Mallorca,Dennis Hadzikadunic,BIH,DF,24,1998,6.8,9,6,4,5,0,4,4,100.0,0,5,4,1,3,12,27,0,defense
ESP-La Liga,2022,Mallorca,Dominik Greif,SVK,GK,25,1997,1.0,0,0,0,0,0,0,0,,0,0,0,0,0,0,0,0,defense
ESP-La Liga,2022,Mallorca,Franco Russo,ARG,DF,27,1994,1.6,2,1,2,0,0,0,1,0.0,1,5,0,5,3,5,5,0,defense
ESP-La Liga,2022,Mallorca,Giovanni González,URU,DF,27,1994,10.3,16,8,11,2,3,9,22,40.9,13,8,2,6,7,23,22,0,defense
ESP-La Liga,2022,Mallorca,Iddrisu Baba,GHA,"MF,DF",26,1996,18.9,31,17,15,16,0,15,32,46.9,17,18,8,10,11,42,39,0,defense
ESP-La Liga,2022,Mallorca,Iñigo Ruiz de Galarreta,ESP,MF,28,1993,27.2,54,38,27,23,4,20,52,38.5,32,26,9,17,30,84,19,0,defense
ESP-La Liga,2022,Mallorca,Jaume Costa,ESP,DF,34,1988,28.9,50,34,26,17,7,29,51,56.9,22,13,5,8,22,72,44,1,defense
ESP-La Liga,2022,Mallorca,Javier Llabrés,ESP,FW,19,2002,0.2,0,0,0,0,0,0,0,,0,0,0,0,0,0,1,0,defense
ESP-La Liga,2022,Mallorca,Josep Antoni Gayá,ESP,"DF,MF",22,2000,1.1,0,0,0,0,0,0,0,,0,4,2,2,1,1,6,0,defense
ESP-La Liga,2022,Mallorca,Lago Junior,CIV,"FW,MF",31,1990,0.6,1,0,0,1,0,1,1,100.0,0,0,0,0,0,1,0,0,defense
ESP-La Liga,2022,Mallorca,Lee Kang-in,KOR,"MF,FW",21,2001,31.4,42,24,10,22,10,18,61,29.5,43,25,2,23,11,53,7,0,defense
ESP-La Liga,2022,Mallorca,Leo Román,ESP,GK,22,2000,1.0,0,0,0,0,0,0,0,,0,0,0,0,0,0,0,0,defense
ESP-La Liga,2022,Mallorca,Ludwig Augustinsson,SWE,DF,28,1994,1.5,2,1,2,0,0,1,3,33.3,2,1,0,1,1,3,3,0,defense
ESP-La Liga,2022,Mallorca,Manu Morlanes,ESP,MF,23,1999,7.8,22,9,12,8,2,13,24,54.2,11,10,5,5,5,27,9,0,defense
ESP-La Liga,2022,Mallorca,Martin Valjent,SVK,DF,26,1995,29.5,35,27,22,12,1,19,28,67.9,9,39,21,18,29,64,137,0,defense
ESP-La Liga,2022,Mallorca,Matija Nastasić,SRB,DF,29,1993,10.1,10,8,7,1,2,3,6,50.0,3,11,4,7,18,28,43,1,defense
ESP-La Liga,2022,Mallorca,Pablo Maffeo,ESP,DF,25,1997,33.1,75,46,54,16,5,45,78,57.7,33,38,11,27,26,101,76,0,defense
ESP-La Liga,2022,Mallorca,Predrag Rajković,SRB,GK,26,1995,36.0,0,0,0,0,0,0,2,0.0,2,0,0,0,0,0,16,1,defense
ESP-La Liga,2022,Mallorca,Rodrigo Battaglia,ARG,MF,31,1991,7.6,12,5,7,5,0,6,14,42.9,8,16,7,9,5,17,18,0,defense
ESP-La Liga,2022,Mallorca,Rubén Quintanilla,ESP,DF,20,2002,0.0,0,0,0,0,0,0,0,,0,1,0,1,0,0,0,0,defense
ESP-La Liga,2022,Mallorca,Tino Kadewere,ZIM,"FW,MF",26,1996,6.0,6,3,3,3,0,4,9,44.4,5,6,2,4,2,8,1,0,defense
ESP-La Liga,2022,Mallorca,Vedat Muriqi,KVX,FW,28,1994,32.6,12,7,4,7,1,3,13,23.1,10,19,7,12,12,24,73,0,defense
ESP-La Liga,2022,Mallorca,Ángel Rodríguez,ESP,"FW,MF",35,1987,4.4,1,1,0,1,0,0,2,0.0,2,3,0,3,1,2,1,0,defense
ESP-La Liga,2022,Osasuna,Abde Ezzalzouli,MAR,"FW,MF",20,2001,16.7,29,19,13,12,4,13,23,56.5,10,20,0,20,4,33,6,0,defense
ESP-La Liga,2022,Osasuna,Aimar Oroz,ESP,"MF,FW",20,2001,22.4,26,14,8,10,8,8,30,26.7,22,24,1,23,24,50,6,0,defense
ESP-La Liga,2022,Osasuna,Aitor Fernández,ESP,GK,31,1991,21.0,1,1,1,0,0,0,1,0.0,1,0,0,0,2,3,17,0,defense
ESP-La Liga,2022,Osasuna,Ante Budimir,CRO,FW,31,1991,20.0,19,9,0,12,7,2,10,20.0,8,10,0,10,5,24,19,0,defense
ESP-La Liga,2022,Osasuna,Aridane Hernández,ESP,DF,33,1989,19.9,21,15,17,4,0,12,25,48.0,13,34,21,13,28,49,96,1,defense
ESP-La Liga,2022,Osasuna,Darko Brašanac,SRB,MF,30,1992,11.6,29,20,12,10,7,12,23,52.2,11,14,2,12,12,41,9,0,defense
ESP-La Liga,2022,Osasuna,David García,ESP,DF,28,1994,29.8,34,20,22,12,0,19,22,86.4,3,28,13,15,45,79,151,0,defense
ESP-La Liga,2022,Osasuna,Diego Moreno,ESP,DF,21,2001,7.1,4,4,2,2,0,3,8,37.5,5,7,4,3,5,9,21,0,defense
ESP-La Liga,2022,Osasuna,Ezequiel Ávila,ARG,"FW,MF",28,1994,19.0,8,5,2,4,2,6,23,26.1,17,12,1,11,8,16,16,0,defense
ESP-La Liga,2022,Osasuna,Iker Benito,ESP,"FW,MF",19,2002,2.0,4,3,0,3,1,2,4,50.0,2,0,0,0,2,6,4,0,defense
ESP-La Liga,2022,Osasuna,Iker Muñoz,ESP,MF,19,2002,2.8,1,0,0,1,0,0,3,0.0,3,2,1,1,3,4,8,0,defense
ESP-La Liga,2022,Osasuna,Jon Moncayola,ESP,"MF,DF",24,1998,27.2,55,39,24,22,9,30,76,39.5,46,37,5,32,17,72,32,2,defense
ESP-La Liga,2022,Osasuna,Jorge Herrando,ESP,DF,21,2001,0.3,0,0,0,0,0,0,0,,0,1,0,1,0,0,3,0,defense
ESP-La Liga,2022,Osasuna,Juan Cruz Armada,ESP,DF,30,1992,22.9,24,14,17,4,3,13,23,56.5,10,21,8,13,13,37,58,0,defense
ESP-La Liga,2022,Osasuna,Kike Barja,ESP,"FW,MF",25,1997,14.6,15,9,6,5,4,8,24,33.3,16,7,0,7,4,19,3,0,defense
ESP-La Liga,2022,Osasuna,Kiké,ESP,FW,32,1989,11.3,6,3,0,4,2,2,5,40.0,3,6,1,5,1,7,13,0,defense
ESP-La Liga,2022,Osasuna,Lucas Torró,ESP,MF,28,1994,27.5,48,32,28,15,5,18,42,42.9,24,24,3,21,42,90,64,1,defense
ESP-La Liga,2022,Osasuna,Manu Sánchez,ESP,DF,21,2000,23.6,51,35,35,9,7,33,63,52.4,30,33,5,28,14,65,51,0,defense
ESP-La Liga,2022,Osasuna,Moi Gómez,ESP,"MF,FW",28,1994,27.3,26,17,9,14,3,15,32,46.9,17,15,3,12,10,36,5,1,defense
ESP-La Liga,2022,Osasuna,Nacho Vidal,ESP,DF,27,1995,13.9,27,14,16,6,5,17,32,53.1,15,17,4,13,19,46,33,1,defense
ESP-La Liga,2022,Osasuna,Pablo Ibáñez,ESP,MF,23,1998,11.8,29,13,7,17,5,12,35,34.3,23,19,2,17,8,37,24,0,defense
ESP-La Liga,2022,Osasuna,Roberto Torres,ESP,"FW,MF",33,1989,0.1,0,0,0,0,0,0,0,,0,0,0,0,0,0,0,0,defense
ESP-La Liga,2022,Osasuna,Rubén García,ESP,"FW,MF",29,1993,12.9,20,11,12,4,4,7,24,29.2,17,14,1,13,12,32,13,0,defense
ESP-La Liga,2022,Osasuna,Rubén Peña,ESP,"DF,MF",31,1991,14.2,32,18,10,18,4,20,41,48.8,21,23,8,15,17,49,31,0,defense
ESP-La Liga,2022,Osasuna,Sergio Herrera,ESP,GK,29,1993,17.0,2,0,2,0,0,2,2,100.0,0,1,0,1,1,3,6,2,defense
ESP-La Liga,2022,Osasuna,Unai García,ESP,DF,30,1992,19.0,23,13,13,8,2,12,17,70.6,5,23,14,9,19,42,60,2,defense
ESP-La Liga,2022,Rayo Vallecano,Abdul Mumin,GHA,DF,24,1998,10.2,11,9,5,6,0,3,7,42.9,4,13,5,8,9,20,36,2,defense
ESP-La Liga,2022,Rayo Vallecano,Andrés Martín,ESP,"FW,MF",23,1999,2.3,4,2,2,1,1,3,5,60.0,2,2,0,2,1,5,2,0,defense
ESP-La Liga,2022,Rayo Vallecano,Bebé,CPV,FW,32,1990,0.7,0,0,0,0,0,0,2,0.0,2,1,0,1,0,0,0,0,defense
ESP-La Liga,2022,Rayo Vallecano,Catena,ESP,DF,27,1994,34.5,29,14,23,4,2,13,27,48.1,14,32,25,7,28,57,159,1,defense
ESP-La Liga,2022,Rayo Vallecano,Diego López,ESP,GK,40,1981,1.1,0,0,0,0,0,0,0,,0,0,0,0,0,0,0,1,defense
ESP-La Liga,2022,Rayo Vallecano,Diego Méndez,ESP,MF,18,2003,0.0,0,0,0,0,0,0,0,,0,0,0,0,1,1,0,0,defense
ESP-La Liga,2022,Rayo Vallecano,Esteban Saveljich,MNE,FW,31,1991,0.0,0,0,0,0,0,0,0,,0,0,0,0,0,0,0,0,defense
ESP-La Liga,2022,Rayo Vallecano,Florian Lejeune,FRA,DF,31,1991,28.5,28,17,19,8,1,17,25,68.0,8,24,16,8,15,43,123,0,defense
ESP-La Liga,2022,Rayo Vallecano,Fran Garcia,ESP,DF,22,1999,37.9,84,54,53,23,8,55,96,57.3,41,49,8,41,44,128,66,0,defense
ESP-La Liga,2022,Rayo Vallecano,Isaac Palazón Camacho,ESP,"FW,MF",27,1994,32.9,45,30,11,23,11,24,66,36.4,42,42,3,39,17,62,30,0,defense
ESP-La Liga,2022,Rayo Vallecano,Iván Balliu,ALB,DF,30,1992,35.9,52,29,26,20,6,18,30,60.0,12,26,3,23,25,77,72,1,defense
ESP-La Liga,2022,Rayo Vallecano,José Pozo,ESP,"MF,FW",26,1996,1.0,2,2,0,2,0,0,0,,0,0,0,0,1,3,1,0,defense
ESP-La Liga,2022,Rayo Vallecano,Mario Hernández,ESP,DF,23,1999,1.1,3,2,2,1,0,3,7,42.9,4,2,0,2,2,5,0,0,defense
ESP-La Liga,2022,Rayo Vallecano,Mario Suárez,ESP,"MF,DF",35,1987,0.1,0,0,0,0,0,0,0,,0,1,0,1,0,0,0,0,defense
ESP-La Liga,2022,Rayo Vallecano,Pablo Muñoz,ESP,MF,18,2003,0.1,0,0,0,0,0,0,1,0.0,1,0,0,0,0,0,0,0,defense
ESP-La Liga,2022,Rayo Vallecano,Pathé Ciss,SEN,"MF,DF",28,1994,14.2,39,29,11,23,5,15,34,44.1,19,23,10,13,22,61,34,0,defense
ESP-La Liga,2022,Rayo Vallecano,Pep Chavarría,ESP,"FW,MF",24,1998,4.1,6,4,2,1,3,1,5,20.0,4,8,0,8,2,8,8,0,defense
ESP-La Liga,2022,Rayo Vallecano,Radamel Falcao,COL,"FW,MF",36,1986,6.8,4,4,1,3,0,1,8,12.5,7,5,1,4,2,6,10,0,defense
ESP-La Liga,2022,Rayo Vallecano,Randy Nteka,ANG,"FW,MF",24,1997,1.3,4,2,2,2,0,1,1,100.0,0,2,0,2,2,6,3,0,defense
ESP-La Liga,2022,Rayo Vallecano,Raúl de Tomás,ESP,FW,27,1994,8.9,3,2,0,1,2,2,6,33.3,4,4,0,4,0,3,6,0,defense
ESP-La Liga,2022,Rayo Vallecano,Salvi,ESP,"FW,MF",31,1991,5.4,13,8,5,5,3,2,8,25.0,6,0,0,0,2,15,2,0,defense
ESP-La Liga,2022,Rayo Vallecano,Santi Comesaña,ESP,MF,25,1996,27.2,71,44,24,41,6,38,82,46.3,44,39,3,36,32,103,17,0,defense
ESP-La Liga,2022,Rayo Vallecano,Sergio Camello,ESP,FW,21,2001,26.7,16,10,3,9,4,5,17,29.4,12,9,1,8,2,18,26,0,defense
ESP-La Liga,2022,Rayo Vallecano,Stole Dimitrievski,MKD,GK,28,1993,36.9,1,0,1,0,0,1,2,50.0,1,2,0,2,1,2,17,3,defense
ESP-La Liga,2022,Rayo Vallecano,Unai López,ESP,MF,26,1995,13.9,32,20,10,17,5,13,37,35.1,24,12,1,11,15,47,6,1,defense
ESP-La Liga,2022,Rayo Vallecano,Álvaro García,ESP,"FW,MF",29,1992,31.9,49,28,21,13,15,11,33,33.3,22,41,4,37,34,83,24,1,defense
ESP-La Liga,2022,Rayo Vallecano,Óscar Trejo,ARG,"MF,FW",34,1988,23.8,48,32,12,23,13,9,44,20.5,35,31,3,28,8,56,8,1,defense
ESP-La Liga,2022,Rayo Vallecano,Óscar Valentín,ESP,MF,27,1994,28.4,92,51,29,50,13,46,121,38.0,75,60,9,51,44,136,30,0,defense
ESP-La Liga,2022,Real Madrid,Andriy Lunin,UKR,GK,23,1999,7.0,0,0,0,0,0,0,0,,0,0,0,0,0,0,1,0,defense
ESP-La Liga,2022,Real Madrid,Antonio Rüdiger,GER,DF,29,1993,26.8,18,16,12,5,1,14,23,60.9,9,23,13,10,19,37,74,0,defense
ESP-La Liga,2022,Real Madrid,Aurélien Tchouaméni,FRA,MF,22,2000,23.5,64,40,23,36,5,23,38,60.5,15,20,6,14,49,113,50,0,defense
ESP-La Liga,2022,Real Madrid,Casemiro,BRA,MF,30,1992,0.1,0,0,0,0,0,0,0,,0,0,0,0,0,0,1,0,defense
ESP-La Liga,2022,Real Madrid,Dani Carvajal,ESP,DF,30,1992,19.8,32,18,15,12,5,18,35,51.4,17,24,6,18,15,47,49,0,defense
ESP-La Liga,2022,Real Madrid,Dani Ceballos,ESP,MF,25,1996,17.4,43,29,13,15,15,25,64,39.1,39,23,2,21,25,68,6,1,defense
ESP-La Liga,2022,Real Madrid,David Alaba,AUT,DF,30,1992,20.4,15,11,8,4,3,9,15,60.0,6,18,9,9,14,29,37,1,defense
ESP-La Liga,2022,Real Madrid,Eden Hazard,BEL,FW,31,1991,2.2,0,0,0,0,0,0,2,0.0,2,1,0,1,1,1,0,0,defense
ESP-La Liga,2022,Real Madrid,Eduardo Camavinga,FRA,"MF,DF",19,2002,22.3,68,48,32,21,15,24,64,37.5,40,24,5,19,17,85,25,0,defense
ESP-La Liga,2022,Real Madrid,Federico Valverde,URU,"MF,FW",24,1998,27.8,31,20,14,11,6,13,26,50.0,13,31,4,27,17,48,15,0,defense
ESP-La Liga,2022,Real Madrid,Ferland Mendy,FRA,DF,27,1995,15.0,21,12,14,6,1,12,20,60.0,8,7,2,5,14,35,16,0,defense
ESP-La Liga,2022,Real Madrid,Jesús Vallejo,ESP,DF,25,1997,0.2,0,0,0,0,0,0,0,,0,0,0,0,0,0,0,0,defense
ESP-La Liga,2022,Real Madrid,Karim Benzema,FRA,FW,34,1987,22.6,9,5,2,4,3,2,11,18.2,9,11,0,11,2,11,5,0,defense
ESP-La Liga,2022,Real Madrid,Lucas Vázquez,ESP,DF,31,1991,12.7,34,23,22,10,2,20,28,71.4,8,10,0,10,7,41,13,0,defense
ESP-La Liga,2022,Real Madrid,Luka Modrić,CRO,MF,36,1985,19.4,19,9,6,6,7,10,25,40.0,15,15,5,10,10,29,7,0,defense
ESP-La Liga,2022,Real Madrid,Marco Asensio,ESP,"FW,MF",26,1996,16.0,16,10,8,6,2,8,19,42.1,11,8,3,5,5,21,4,0,defense
ESP-La Liga,2022,Real Madrid,Mariano,DOM,FW,28,1993,1.7,1,0,0,1,0,0,0,,0,1,0,1,0,1,0,0,defense
ESP-La Liga,2022,Real Madrid,Nacho,ESP,DF,32,1990,18.2,24,16,17,5,2,12,29,41.4,17,11,6,5,18,42,37,0,defense
ESP-La Liga,2022,Real Madrid,Rodrygo,BRA,"FW,MF",21,2001,26.4,17,10,3,7,7,4,23,17.4,19,23,0,23,8,25,5,0,defense
ESP-La Liga,2022,Real Madrid,Sergio Arribas,ESP,"MF,FW",20,2001,0.2,0,0,0,0,0,0,0,,0,1,0,1,0,0,0,0,defense
ESP-La Liga,2022,Real Madrid,Thibaut Courtois,BEL,GK,30,1992,31.0,1,0,1,0,0,1,1,100.0,0,0,0,0,3,4,7,1,defense
ESP-La Liga,2022,Real Madrid,Toni Kroos,GER,MF,32,1990,23.9,51,32,16,33,2,23,69,33.3,46,23,4,19,24,75,11,0,defense
ESP-La Liga,2022,Real Madrid,Vinicius Júnior,BRA,FW,22,2000,31.4,30,21,10,12,8,14,39,35.9,25,24,1,23,6,36,1,0,defense
ESP-La Liga,2022,Real Madrid,Álvaro Odriozola,ESP,DF,26,1995,0.4,0,0,0,0,0,0,0,,0,0,0,0,0,0,0,0,defense
ESP-La Liga,2022,Real Madrid,Álvaro Rodríguez,URU,FW,18,2004,0.9,2,1,1,0,1,1,1,100.0,0,0,0,0,0,2,1,0,defense
ESP-La Liga,2022,Real Madrid,Éder Militão,BRA,DF,24,1998,30.0,46,32,25,18,3,26,33,78.8,7,67,39,28,42,88,104,2,defense
ESP-La Liga,2022,Real Sociedad,Aihen Muñoz,ESP,DF,24,1997,19.5,38,23,17,17,4,22,47,46.8,25,26,5,21,9,47,38,0,defense
ESP-La Liga,2022,Real Sociedad,Alex Sola,ESP,DF,23,1999,3.9,18,9,14,3,1,7,10,70.0,3,7,2,5,7,25,10,0,defense
ESP-La Liga,2022,Real Sociedad,Alexander Isak,SWE,FW,22,1999,1.7,1,1,0,0,1,0,0,,0,0,0,0,0,1,2,0,defense
ESP-La Liga,2022,Real Sociedad,Alexander Sørloth,NOR,FW,26,1995,26.5,18,9,3,6,9,7,14,50.0,7,15,1,14,2,20,26,1,defense
ESP-La Liga,2022,Real Sociedad,Ander Barrenetxea,ESP,"FW,DF",20,2001,9.8,21,15,15,6,0,12,28,42.9,16,15,1,14,5,26,7,0,defense
ESP-La Liga,2022,Real Sociedad,Ander Guevara,ESP,MF,25,1997,2.5,5,2,2,2,1,1,4,25.0,3,6,1,5,2,7,3,0,defense
ESP-La Liga,2022,Real Sociedad,Ander Martin,ESP,"MF,FW",21,2000,0.5,2,2,1,1,0,1,4,25.0,3,0,0,0,0,2,1,0,defense
ESP-La Liga,2022,Real Sociedad,Andoni Gorosabel,ESP,DF,25,1996,19.0,41,25,23,9,9,26,43,60.5,17,21,2,19,17,58,23,0,defense
ESP-La Liga,2022,Real Sociedad,Aritz Elustondo,ESP,DF,28,1994,16.1,26,17,15,10,1,14,26,53.8,12,15,6,9,20,46,43,1,defense
ESP-La Liga,2022,Real Sociedad,Asier Illarramendi,ESP,MF,32,1990,12.0,36,18,10,22,4,16,44,36.4,28,27,8,19,18,54,20,0,defense
ESP-La Liga,2022,Real Sociedad,Beñat Turrientes,ESP,"MF,FW",20,2002,1.2,3,3,3,0,0,1,5,20.0,4,2,0,2,0,3,3,0,defense
ESP-La Liga,2022,Real Sociedad,Brais Méndez,ESP,MF,25,1997,26.7,58,34,18,30,10,24,64,37.5,40,27,3,24,12,70,14,1,defense
ESP-La Liga,2022,Real Sociedad,Carlos Fernández,ESP,FW,26,1996,7.0,6,4,1,3,2,1,15,6.7,14,1,0,1,1,7,4,0,defense
ESP-La Liga,2022,Real Sociedad,David Silva,ESP,MF,36,1986,21.5,36,21,11,18,7,11,19,57.9,8,17,2,15,15,51,16,0,defense
ESP-La Liga,2022,Real Sociedad,Diego Rico,ESP,DF,29,1993,18.3,35,21,17,11,7,12,27,44.4,15,18,5,13,20,55,51,1,defense
ESP-La Liga,2022,Real Sociedad,Igor Zubeldia,ESP,DF,25,1997,28.2,35,18,28,7,0,25,35,71.4,10,23,17,6,21,56,93,0,defense
ESP-La Liga,2022,Real Sociedad,Jon Karrikaburu,ESP,FW,19,2002,1.0,1,0,0,1,0,0,0,,0,2,0,2,0,1,0,0,defense
ESP-La Liga,2022,Real Sociedad,Jon Magunazelaia,ESP,"MF,FW",22,2000,0.7,1,0,0,0,1,0,2,0.0,2,0,0,0,0,1,1,0,defense
ESP-La Liga,2022,Real Sociedad,Jon Pacheco,ESP,DF,21,2001,13.3,16,10,10,6,0,6,10,60.0,4,9,6,3,12,28,37,1,defense
ESP-La Liga,2022,Real Sociedad,Martín Zubimendi,ESP,MF,23,1999,34.5,59,33,23,30,6,24,45,53.3,21,44,17,27,37,96,55,4,defense
ESP-La Liga,2022,Real Sociedad,Mikel Merino,ESP,MF,26,1996,27.7,77,49,28,33,16,31,62,50.0,31,38,8,30,20,97,51,1,defense
ESP-La Liga,2022,Real Sociedad,Mikel Oyarzabal,ESP,"FW,MF",25,1997,13.5,13,7,5,3,5,5,19,26.3,14,14,4,10,3,16,5,0,defense
ESP-La Liga,2022,Real Sociedad,Mohamed Ali Cho,FRA,"FW,MF",18,2004,6.5,13,10,6,5,2,4,10,40.0,6,9,0,9,2,15,2,0,defense
ESP-La Liga,2022,Real Sociedad,Olasagasti,ESP,"MF,DF",21,2000,0.7,4,4,1,2,1,1,2,50.0,1,2,0,2,0,4,1,0,defense
ESP-La Liga,2022,Real Sociedad,Pablo Marín,ESP,"MF,FW",19,2003,4.0,10,5,5,4,1,2,7,28.6,5,1,0,1,4,14,2,0,defense
ESP-La Liga,2022,Real Sociedad,Roberto Navarro,ESP,"MF,FW",20,2002,3.9,5,4,4,0,1,1,2,50.0,1,7,0,7,2,7,2,0,defense
ESP-La Liga,2022,Real Sociedad,Robin Le Normand,ESP,DF,25,1996,31.1,36,23,25,9,2,14,27,51.9,13,22,14,8,33,69,93,0,defense
ESP-La Liga,2022,Real Sociedad,Takefusa Kubo,JPN,"FW,MF",21,2001,27.1,44,26,18,16,10,16,38,42.1,22,29,1,28,9,53,4,0,defense
ESP-La Liga,2022,Real Sociedad,Umar Sadiq,NGA,FW,25,1997,0.9,1,1,0,0,1,0,1,0.0,1,2,0,2,0,1,0,0,defense
ESP-La Liga,2022,Real Sociedad,Álex Remiro,ESP,GK,27,1995,38.0,1,1,1,0,0,1,3,33.3,2,0,0,0,0,1,17,3,defense
ESP-La Liga,2022,Sevilla,Adnan Januzaj,BEL,FW,27,1995,0.5,0,0,0,0,0,0,1,0.0,1,0,0,0,1,1,0,0,defense
ESP-La Liga,2022,Sevilla,Alex Telles,BRA,DF,29,1992,15.9,21,13,15,6,0,13,25,52.0,12,17,5,12,20,41,38,0,defense
ESP-La Liga,2022,Sevilla,Bryan Gil,ESP,"FW,DF",21,2001,10.2,22,11,11,7,4,10,23,43.5,13,10,0,10,8,30,10,0,defense
ESP-La Liga,2022,Sevilla,Carlos Álvarez,ESP,MF,18,2003,0.1,1,1,0,1,0,0,0,,0,0,0,0,0,1,0,0,defense
ESP-La Liga,2022,Sevilla,Carmona,ESP,DF,20,2002,5.9,13,11,5,3,5,9,16,56.3,7,10,6,4,7,20,17,1,defense
ESP-La Liga,2022,Sevilla,Diego Iturralde,ESP,DF,19,2003,0.5,1,0,1,0,0,0,2,0.0,2,0,0,0,0,1,1,0,defense
ESP-La Liga,2022,Sevilla,Fernando,BRA,"MF,DF",35,1987,17.5,34,23,14,17,3,18,30,60.0,12,21,10,11,24,58,29,0,defense
ESP-La Liga,2022,Sevilla,Gonzalo Montiel,ARG,DF,25,1997,16.9,26,15,12,14,0,15,29,51.7,14,25,7,18,19,45,38,0,defense
ESP-La Liga,2022,Sevilla,Isco,ESP,"MF,FW",30,1992,8.9,15,9,6,5,4,8,14,57.1,6,3,0,3,10,25,3,0,defense
ESP-La Liga,2022,Sevilla,Ivan Rakitić,CRO,MF,34,1988,19.9,37,26,10,18,9,19,40,47.5,21,21,1,20,27,64,20,0,defense
ESP-La Liga,2022,Sevilla,Iván Romero,ESP,MF,21,2001,0.1,0,0,0,0,0,0,0,,0,0,0,0,0,0,0,0,defense
ESP-La Liga,2022,Sevilla,Jesús Corona,MEX,FW,29,1993,1.2,1,0,1,0,0,0,1,0.0,1,0,0,0,1,2,1,0,defense
ESP-La Liga,2022,Sevilla,Jesús Navas,ESP,"DF,FW",36,1985,22.0,19,12,8,3,8,11,22,50.0,11,18,7,11,22,41,52,1,defense
ESP-La Liga,2022,Sevilla,Joan Jordán,ESP,MF,28,1994,17.7,32,17,13,17,2,16,38,42.1,22,14,7,7,16,48,14,2,defense
ESP-La Liga,2022,Sevilla,Karim Rekik,NED,DF,27,1994,13.1,11,5,8,3,0,4,5,80.0,1,12,5,7,10,21,24,0,defense
ESP-La Liga,2022,Sevilla,Kasper Dolberg,DEN,FW,24,1997,2.2,1,0,0,1,0,1,3,33.3,2,0,0,0,0,1,5,0,defense
ESP-La Liga,2022,Sevilla,Kike Salas,ESP,DF,20,2002,4.1,1,1,1,0,0,0,0,,0,4,3,1,5,6,23,0,defense
ESP-La Liga,2022,Sevilla,Loïc Bade,FRA,DF,22,2000,16.1,27,20,23,3,1,17,30,56.7,13,21,13,8,23,50,77,0,defense
ESP-La Liga,2022,Sevilla,Lucas Ocampos,ARG,"FW,MF",28,1994,12.9,22,14,9,9,4,8,31,25.8,23,17,2,15,8,30,5,0,defense
ESP-La Liga,2022,Sevilla,Manu Bueno,ESP,MF,18,2004,1.7,7,4,3,3,1,5,8,62.5,3,0,0,0,0,7,2,0,defense
ESP-La Liga,2022,Sevilla,Marcos Acuña,ARG,DF,30,1991,21.2,57,36,34,17,6,30,42,71.4,12,16,5,11,23,80,36,0,defense
ESP-La Liga,2022,Sevilla,Marcão,BRA,DF,26,1996,4.2,2,2,1,1,0,1,1,100.0,0,3,3,0,6,8,14,0,defense
ESP-La Liga,2022,Sevilla,Marko Dmitrović,SRB,GK,30,1992,14.1,0,0,0,0,0,0,0,,0,0,0,0,0,0,6,0,defense
ESP-La Liga,2022,Sevilla,Nemanja Gudelj,SRB,"DF,MF",30,1991,30.9,43,33,22,18,3,20,33,60.6,13,39,29,10,34,77,102,1,defense
ESP-La Liga,2022,Sevilla,Pape Gueye,SEN,MF,23,1999,13.0,37,22,13,21,3,16,33,48.5,17,21,5,16,22,59,10,0,defense
ESP-La Liga,2022,Sevilla,Papu Gómez,ARG,"FW,MF",34,1988,11.8,6,4,3,3,0,2,10,20.0,8,8,1,7,4,10,5,0,defense
ESP-La Liga,2022,Sevilla,Pedro Ortiz,ESP,MF,21,2000,0.0,0,0,0,0,0,0,0,,0,0,0,0,0,0,0,0,defense
ESP-La Liga,2022,Sevilla,Rafa Mir,ESP,FW,25,1997,14.4,8,2,2,4,2,2,5,40.0,3,5,1,4,4,12,11,0,defense
ESP-La Liga,2022,Sevilla,Suso,ESP,"MF,FW",28,1993,11.8,16,10,5,7,4,10,22,45.5,12,7,1,6,2,18,3,0,defense
ESP-La Liga,2022,Sevilla,Tanguy Nianzou,FRA,DF,20,2002,15.2,20,15,10,9,1,8,11,72.7,3,8,5,3,16,36,44,3,defense
ESP-La Liga,2022,Sevilla,Thomas Delaney,DEN,MF,30,1991,3.4,4,2,0,4,0,3,5,60.0,2,3,2,1,4,8,3,0,defense
ESP-La Liga,2022,Sevilla,Yassine Bounou,MAR,GK,31,1991,23.9,2,1,2,0,0,1,4,25.0,3,0,0,0,2,4,11,1,defense
ESP-La Liga,2022,Sevilla,Youssef En-Nesyri,MAR,FW,25,1997,18.5,16,8,3,7,6,4,14,28.6,10,6,2,4,4,20,16,0,defense
ESP-La Liga,2022,Sevilla,Érik Lamela,ARG,"FW,MF",30,1992,20.5,46,27,14,16,16,12,34,35.3,22,26,2,24,7,53,3,0,defense
ESP-La Liga,2022,Sevilla,Óliver Torres,ESP,"MF,FW",27,1994,23.7,39,23,12,13,14,18,59,30.5,41,26,5,21,10,49,10,0,defense
ESP-La Liga,2022,Valencia,Alberto Marí,ESP,"FW,MF",21,2001,1.0,0,0,0,0,0,0,2,0.0,2,0,0,0,0,0,1,0,defense
ESP-La Liga,2022,Valencia,Carlos Soler,ESP,MF,25,1997,2.7,2,0,0,1,1,2,3,66.7,1,1,0,1,0,2,2,0,defense
ESP-La Liga,2022,Valencia,Cenk Özkacar,TUR,DF,21,2000,15.2,27,20,17,10,0,14,19,73.7,5,14,2,12,12,39,47,4,defense
ESP-La Liga,2022,Valencia,Cristhian Mosquera,ESP,DF,18,2004,1.6,4,2,3,1,0,4,5,80.0,1,1,0,1,1,5,5,0,defense
ESP-La Liga,2022,Valencia,Diego López,ESP,"FW,MF",20,2002,5.0,2,2,1,1,0,2,15,13.3,13,9,0,9,3,5,5,0,defense
ESP-La Liga,2022,Valencia,Dimitri Foulquier,FRA,DF,29,1993,19.3,31,19,17,8,6,20,28,71.4,8,19,3,16,14,45,40,0,defense
ESP-La Liga,2022,Valencia,Domingos André Ribeiro Almeida,POR,MF,22,2000,28.2,66,42,23,32,11,26,57,45.6,31,26,0,26,20,86,16,1,defense
ESP-La Liga,2022,Valencia,Edinson Cavani,URU,FW,35,1987,16.1,7,4,3,3,1,3,15,20.0,12,10,3,7,2,9,11,0,defense
ESP-La Liga,2022,Valencia,Eray Cömert,SUI,DF,24,1998,18.6,35,23,24,10,1,17,33,51.5,16,23,8,15,29,64,76,1,defense
ESP-La Liga,2022,Valencia,Francisco Perez,ESP,"FW,MF",19,2002,1.6,1,1,1,0,0,0,3,0.0,3,0,0,0,0,1,1,0,defense
ESP-La Liga,2022,Valencia,Gabriel Paulista,BRA,DF,31,1990,16.7,17,9,13,4,0,13,19,68.4,6,22,14,8,32,49,79,2,defense
ESP-La Liga,2022,Valencia,Giorgi Mamardashvili,GEO,GK,21,2000,38.0,0,0,0,0,0,0,0,,0,0,0,0,1,1,11,4,defense
ESP-La Liga,2022,Valencia,Hugo Duro,ESP,FW,22,1999,15.4,15,12,2,6,7,7,17,41.2,10,11,1,10,2,17,7,1,defense
ESP-La Liga,2022,Valencia,Hugo Guillamón,ESP,MF,22,2000,18.1,20,12,10,8,2,8,24,33.3,16,14,2,12,19,39,30,2,defense
ESP-La Liga,2022,Valencia,Ilaix Moriba,GUI,MF,19,2003,11.2,35,16,14,17,4,14,24,58.3,10,11,1,10,4,39,12,0,defense
ESP-La Liga,2022,Valencia,Javier Guerra,ESP,MF,19,2003,6.7,16,13,7,4,5,9,20,45.0,11,8,1,7,11,27,9,0,defense
ESP-La Liga,2022,Valencia,Jesus Vazquez,ESP,"DF,MF",19,2003,3.4,13,8,9,1,3,6,11,54.5,5,4,0,4,1,14,8,0,defense
ESP-La Liga,2022,Valencia,José Luis Gayà,ESP,DF,27,1995,30.1,80,46,61,16,3,43,74,58.1,31,28,9,19,23,103,48,0,defense
ESP-La Liga,2022,Valencia,Justin Kluivert,NED,"FW,MF",23,1999,16.1,17,14,7,4,6,6,12,50.0,6,4,0,4,7,24,4,0,defense
ESP-La Liga,2022,Valencia,Marcos André,BRA,"FW,MF",25,1996,5.0,4,1,1,1,2,1,2,50.0,1,4,1,3,0,4,0,0,defense
ESP-La Liga,2022,Valencia,Maxi Gómez,URU,FW,25,1996,1.2,0,0,0,0,0,0,0,,0,0,0,0,0,0,2,0,defense
ESP-La Liga,2022,Valencia,Mouctar Diakhaby,GUI,DF,25,1996,27.2,30,16,19,11,0,13,20,65.0,7,30,17,13,20,50,111,2,defense
ESP-La Liga,2022,Valencia,Nicolás González,ESP,MF,20,2002,15.6,27,15,11,13,3,9,25,36.0,16,21,7,14,19,46,16,0,defense
ESP-La Liga,2022,Valencia,Samu Castillejo,ESP,"FW,MF",27,1995,15.1,21,12,8,9,4,8,40,20.0,32,21,2,19,9,30,2,0,defense
ESP-La Liga,2022,Valencia,Samuel Lino,BRA,"FW,MF",22,1999,32.1,66,43,17,37,12,26,72,36.1,46,34,0,34,18,84,16,0,defense
ESP-La Liga,2022,Valencia,Thierry Correia,POR,DF,23,1999,22.3,71,52,46,22,3,31,54,57.4,23,25,2,23,24,95,54,2,defense
ESP-La Liga,2022,Valencia,Toni Lato,ESP,"DF,MF",24,1997,10.2,23,11,9,12,2,9,21,42.9,12,10,1,9,6,29,14,0,defense
ESP-La Liga,2022,Valencia,Yunus Musah,USA,MF,19,2002,23.4,48,35,17,23,8,20,30,66.7,10,20,1,19,11,59,16,2,defense
ESP-La Liga,2022,Valladolid,Anuar,MAR,"MF,FW",27,1995,2.3,4,4,0,1,3,0,0,,0,5,2,3,3,7,3,0,defense
ESP-La Liga,2022,Valladolid,Babatunde Akinsola,NGA,FW,19,2003,0.1,1,1,0,0,1,0,0,,0,0,0,0,0,1,0,0,defense
ESP-La Liga,2022,Valladolid,Cyle Larin,CAN,FW,27,1995,16.3,9,3,2,4,3,3,7,42.9,4,6,3,3,0,9,15,0,defense
ESP-La Liga,2022,Valladolid,Darwin Machís,VEN,FW,29,1993,6.7,3,2,0,2,1,1,8,12.5,7,5,0,5,3,6,4,0,defense
ESP-La Liga,2022,Valladolid,David Torres,ESP,DF,19,2003,4.3,1,1,0,1,0,1,1,100.0,0,4,2,2,3,4,8,0,defense
ESP-La Liga,2022,Valladolid,Gonzalo Plata,ECU,FW,21,2000,25.6,66,35,31,24,11,23,70,32.9,47,40,0,40,12,78,10,1,defense
ESP-La Liga,2022,Valladolid,Iván Fresneda,ESP,DF,17,2004,19.4,48,34,31,13,4,29,47,61.7,18,32,8,24,15,63,60,0,defense
ESP-La Liga,2022,Valladolid,Iván Sánchez,ESP,"MF,FW",29,1992,12.8,20,14,8,8,4,10,27,37.0,17,14,1,13,8,28,4,0,defense
ESP-La Liga,2022,Valladolid,Javi Sánchez,ESP,DF,25,1997,26.6,43,26,27,15,1,17,26,65.4,9,32,22,10,46,89,116,0,defense
ESP-La Liga,2022,Valladolid,Jawad El Yamiq,MAR,DF,30,1992,17.9,17,11,10,7,0,6,11,54.5,5,27,19,8,37,54,101,0,defense
ESP-La Liga,2022,Valladolid,Joaquín Fernández,ESP,DF,26,1996,24.0,35,28,20,11,4,19,30,63.3,11,31,22,9,27,62,98,1,defense
ESP-La Liga,2022,Valladolid,Jordi Masip,ESP,GK,33,1989,27.9,0,0,0,0,0,0,2,0.0,2,0,0,0,1,1,3,2,defense
ESP-La Liga,2022,Valladolid,Juanjo Narváez,COL,"MF,FW",27,1995,1.6,1,1,1,0,0,1,1,100.0,0,2,0,2,0,1,0,0,defense
ESP-La Liga,2022,Valladolid,Kenedy,BRA,"FW,DF",26,1996,3.1,6,2,3,3,0,2,4,50.0,2,2,0,2,1,7,0,0,defense
ESP-La Liga,2022,Valladolid,Kike Pérez,ESP,MF,25,1997,25.6,67,33,30,32,5,25,68,36.8,43,26,7,19,20,87,28,0,defense
ESP-La Liga,2022,Valladolid,Lucas Olaza,URU,DF,28,1994,16.6,24,14,12,10,2,17,26,65.4,9,20,8,12,14,38,34,0,defense
ESP-La Liga,2022,Valladolid,Lucas Oliveira Rosa,BRA,DF,22,2000,10.3,39,18,23,10,6,12,20,60.0,8,12,2,10,15,54,24,0,defense
ESP-La Liga,2022,Valladolid,Luis Pérez,ESP,DF,27,1995,13.5,44,24,26,12,6,27,38,71.1,11,13,4,9,16,60,29,0,defense
ESP-La Liga,2022,Valladolid,Manuel Pozo,ESP,FW,20,2001,0.2,0,0,0,0,0,0,0,,0,2,0,2,2,2,0,0,defense
ESP-La Liga,2022,Valladolid,Martin Hongla,CMR,"DF,MF",24,1998,14.5,18,13,13,5,0,11,21,52.4,10,15,12,3,8,26,46,1,defense
ESP-La Liga,2022,Valladolid,Mickael Malsa,MTQ,MF,26,1995,0.8,2,2,1,1,0,1,4,25.0,3,1,1,0,2,4,3,0,defense
ESP-La Liga,2022,Valladolid,Monchu,ESP,MF,22,1999,22.6,50,29,20,21,9,19,46,41.3,27,28,11,17,18,68,22,1,defense
ESP-La Liga,2022,Valladolid,Roberto Arroyo,ESP,MF,18,2003,0.2,1,1,0,1,0,1,1,100.0,0,0,0,0,0,1,0,0,defense
ESP-La Liga,2022,Valladolid,Roque Mesa,ESP,MF,33,1989,18.0,27,15,16,10,1,12,38,31.6,26,16,4,12,13,40,18,0,defense
ESP-La Liga,2022,Valladolid,Selim Amallah,MAR,"MF,FW",25,1996,3.0,15,9,7,8,0,5,8,62.5,3,2,0,2,5,20,2,0,defense
ESP-La Liga,2022,Valladolid,Sergi Guardiola,ESP,FW,31,1991,5.6,12,7,6,5,1,2,4,50.0,2,6,0,6,2,14,7,0,defense
ESP-La Liga,2022,Valladolid,Sergio Asenjo,ESP,GK,33,1989,10.0,0,0,0,0,0,0,0,,0,0,0,0,0,0,10,2,defense
ESP-La Liga,2022,Valladolid,Sergio Escudero,ESP,DF,32,1989,16.0,33,19,21,8,4,15,35,42.9,20,26,6,20,26,59,46,0,defense
ESP-La Liga,2022,Valladolid,Sergio León,ESP,FW,33,1989,14.8,6,4,0,4,2,3,6,50.0,3,6,0,6,0,6,4,0,defense
ESP-La Liga,2022,Valladolid,Shon Weissman,ISR,FW,26,1996,8.3,2,1,1,1,0,0,4,0.0,4,8,0,8,1,3,7,0,defense
ESP-La Liga,2022,Valladolid,Sékou Gassama,SEN,FW,27,1995,0.4,0,0,0,0,0,0,0,,0,0,0,0,0,0,0,0,defense
ESP-La Liga,2022,Valladolid,Toni Villa,ESP,MF,27,1995,1.0,6,3,2,3,1,4,9,44.4,5,0,0,0,0,6,0,0,defense
ESP-La Liga,2022,Valladolid,Zouhair Feddal,MAR,DF,33,1989,4.2,4,2,1,3,0,3,4,75.0,1,9,9,0,5,9,27,0,defense
ESP-La Liga,2022,Valladolid,Álvaro Aceves,ESP,GK,19,2003,0.1,0,0,0,0,0,0,0,,0,0,0,0,0,0,0,0,defense
ESP-La Liga,2022,Valladolid,Álvaro Aguado,ESP,MF,26,1996,21.0,27,15,13,11,3,15,25,60.0,10,16,4,12,13,40,15,0,defense
ESP-La Liga,2022,Valladolid,Óscar Plano,ESP,"FW,MF",31,1991,22.6,40,25,9,17,14,12,37,32.4,25,26,2,24,29,69,23,0,defense
ESP-La Liga,2022,Villarreal,Alberto Del Moral,ESP,MF,22,2000,0.1,0,0,0,0,0,0,0,,0,0,0,0,0,0,0,0,defense
ESP-La Liga,2022,Villarreal,Alberto Moreno,ESP,DF,30,1992,14.4,23,12,10,10,3,11,24,45.8,13,12,1,11,23,46,26,0,defense
ESP-La Liga,2022,Villarreal,Alex Baena,ESP,"MF,FW",21,2001,21.6,30,17,9,15,6,15,45,33.3,30,15,3,12,7,37,16,0,defense
ESP-La Liga,2022,Villarreal,Alfonso Pedraza,ESP,DF,26,1996,18.1,35,26,20,10,5,19,29,65.5,10,19,1,18,18,53,31,0,defense
ESP-La Liga,2022,Villarreal,Arnaut Danjuma,NED,FW,25,1997,5.3,3,3,1,0,2,1,2,50.0,1,0,0,0,0,3,1,1,defense
ESP-La Liga,2022,Villarreal,Aïssa Mandi,ALG,DF,30,1991,16.2,18,10,14,3,1,6,12,50.0,6,19,14,5,21,39,58,0,defense
ESP-La Liga,2022,Villarreal,Daniel Parejo,ESP,MF,33,1989,36.5,71,40,32,23,16,30,75,40.0,45,40,12,28,29,100,31,2,defense
ESP-La Liga,2022,Villarreal,Diego Collado,ESP,FW,21,2001,0.1,0,0,0,0,0,0,0,,0,0,0,0,0,0,0,0,defense
ESP-La Liga,2022,Villarreal,Fernando Niño,ESP,"MF,FW",21,2000,0.2,0,0,0,0,0,0,0,,0,0,0,0,0,0,0,0,defense
ESP-La Liga,2022,Villarreal,Filip Jørgensen,DEN,GK,20,2002,2.0,0,0,0,0,0,0,1,0.0,1,0,0,0,0,0,0,0,defense
ESP-La Liga,2022,Villarreal,Francis Coquelin,FRA,MF,31,1991,8.3,18,13,7,9,2,7,7,100.0,0,8,2,6,9,27,7,0,defense
ESP-La Liga,2022,Villarreal,Gerard Moreno,ESP,FW,30,1992,13.7,11,6,0,6,5,3,6,50.0,3,6,2,4,5,16,10,0,defense
ESP-La Liga,2022,Villarreal,Gerónimo Rulli,ARG,GK,30,1992,14.0,0,0,0,0,0,0,0,,0,1,0,1,1,1,6,2,defense
ESP-La Liga,2022,Villarreal,Giovani Lo Celso,ARG,"MF,FW",26,1996,12.5,32,28,7,15,10,12,21,57.1,9,14,2,12,6,38,5,0,defense
ESP-La Liga,2022,Villarreal,Haissem Hassan,FRA,"FW,MF",20,2002,0.6,0,0,0,0,0,0,2,0.0,2,0,0,0,1,1,0,0,defense
ESP-La Liga,2022,Villarreal,Johan Mojica,COL,DF,29,1992,7.1,13,9,9,3,1,5,9,55.6,4,8,3,5,4,17,14,1,defense
ESP-La Liga,2022,Villarreal,Jorge Cuenca,ESP,DF,22,1999,5.6,9,7,7,2,0,4,7,57.1,3,10,8,2,6,15,44,0,defense
ESP-La Liga,2022,Villarreal,José Luis Morales,ESP,"FW,MF",35,1987,13.5,7,6,1,2,4,5,17,29.4,12,12,1,11,2,9,2,0,defense
ESP-La Liga,2022,Villarreal,Juan Foyth,ARG,DF,24,1998,21.8,73,48,49,22,2,41,57,71.9,16,32,11,21,20,93,68,0,defense
ESP-La Liga,2022,Villarreal,Kiko Femenía,ESP,DF,31,1991,12.6,18,9,14,3,1,13,18,72.2,5,15,6,9,20,38,22,0,defense
ESP-La Liga,2022,Villarreal,Mamadou Fall,SEN,DF,19,2002,0.3,0,0,0,0,0,0,0,,0,1,0,1,0,0,1,0,defense
ESP-La Liga,2022,Villarreal,Manu Morlanes,ESP,MF,23,1999,1.8,3,2,2,1,0,3,3,100.0,0,3,2,1,1,4,2,0,defense
ESP-La Liga,2022,Villarreal,Manu Trigueros,ESP,MF,30,1991,9.2,20,14,9,5,6,9,22,40.9,13,9,2,7,5,25,4,0,defense
ESP-La Liga,2022,Villarreal,Nicolas Jackson,SEN,FW,21,2001,17.8,14,11,2,10,2,2,8,25.0,6,18,2,16,2,16,4,0,defense
ESP-La Liga,2022,Villarreal,Pascu,ESP,"DF,FW",19,2003,0.1,0,0,0,0,0,0,0,,0,0,0,0,0,0,0,0,defense
ESP-La Liga,2022,Villarreal,Pau Torres,ESP,DF,25,1997,33.9,43,25,25,13,5,23,36,63.9,13,36,27,9,13,56,146,3,defense
ESP-La Liga,2022,Villarreal,Pepe Reina,ESP,GK,39,1982,22.0,0,0,0,0,0,0,1,0.0,1,0,0,0,1,1,4,4,defense
ESP-La Liga,2022,Villarreal,Ramón Terrats,ESP,MF,21,2000,9.1,15,10,3,8,4,9,17,52.9,8,11,4,7,8,23,6,2,defense
ESP-La Liga,2022,Villarreal,Raúl Albiol,ESP,DF,36,1985,23.5,25,17,17,6,2,14,18,77.8,4,17,13,4,14,39,111,0,defense
ESP-La Liga,2022,Villarreal,Samuel Chukwueze,NGA,"FW,MF",23,1999,26.0,14,7,7,2,5,7,23,30.4,16,13,0,13,12,26,16,0,defense
ESP-La Liga,2022,Villarreal,Yeremi Pino,ESP,"FW,MF",19,2002,27.2,62,38,25,20,17,21,56,37.5,35,41,4,37,15,77,36,0,defense
ESP-La Liga,2022,Villarreal,Étienne Capoue,FRA,MF,34,1988,21.7,21,12,6,13,2,10,18,55.6,8,12,5,7,19,40,20,1,defense
