league,season,team,player,nation,pos,age,born,90s,Tackles Tkl,Tackles TklW,Tackles Def 3rd,Tackles Mid 3rd,Tackles Att 3rd,Challenges Tkl,Challenges Att,Challenges Tkl%,Challenges Lost,Blocks Blocks,Blocks Sh,Blocks Pass,Int,Tkl+Int,Clr,Err,stat_type
ITA-Serie A,2021,Atalanta,Amad Diallo,CIV,MF,18,2002,0.2,0,0,0,0,0,0,0,,0,0,0,0,0,0,0,0,defense
ITA-Serie A,2021,Atalanta,Berat Djimsiti,ALB,DF,27,1993,29.2,41,29,27,12,2,17,34,50.0,17,34,20,14,62,103,89,1,defense
ITA-Serie A,2021,Atalanta,Bosko Sutalo,CRO,DF,20,2000,2.6,5,5,0,3,2,4,5,80.0,1,2,1,1,2,7,7,1,defense
ITA-Serie A,2021,Atalanta,Cristian Romero,ARG,DF,22,1998,28.3,63,32,41,19,3,27,49,55.1,22,31,13,18,96,159,71,2,defense
ITA-Serie A,2021,Atalanta,Cristiano Piccini,ITA,DF,27,1992,0.7,1,1,1,0,0,0,1,0.0,1,1,0,1,0,1,0,0,defense
ITA-Serie A,2021,Atalanta,Davide Angelo Ghislandi,ITA,DF,19,2001,0.1,0,0,0,0,0,0,0,,0,0,0,0,0,0,1,0,defense
ITA-Serie A,2021,Atalanta,Duván Zapata,COL,FW,29,1991,26.4,12,5,2,3,7,4,13,30.8,9,19,5,14,6,18,19,0,defense
ITA-Serie A,2021,Atalanta,Fabio Depaoli,ITA,DF,23,1997,2.1,3,2,0,1,2,1,2,50.0,1,4,0,4,3,6,2,0,defense
ITA-Serie A,2021,Atalanta,Hans Hateboer,NED,DF,26,1994,19.6,28,17,12,14,2,13,23,56.5,10,8,1,7,17,45,9,0,defense
ITA-Serie A,2021,Atalanta,Joakim Mæhle,DEN,DF,23,1997,13.5,18,10,7,5,6,8,19,42.1,11,17,2,15,11,29,5,0,defense
ITA-Serie A,2021,Atalanta,Johan Mojica,COL,DF,27,1992,3.3,4,4,3,1,0,2,3,66.7,1,3,0,3,7,11,6,0,defense
ITA-Serie A,2021,Atalanta,Josip Iličić,SVN,"MF,FW",32,1988,17.0,9,4,1,5,3,5,21,23.8,16,12,0,12,2,11,0,1,defense
ITA-Serie A,2021,Atalanta,José Luis Palomino,ARG,DF,30,1990,27.0,67,33,41,19,7,24,48,50.0,24,30,16,14,79,146,60,2,defense
ITA-Serie A,2021,Atalanta,Luis Muriel,COL,FW,29,1991,16.0,20,9,4,8,8,9,26,34.6,17,17,0,17,7,27,4,0,defense
ITA-Serie A,2021,Atalanta,Manu Gyabuaa,ITA,MF,18,2001,0.0,0,0,0,0,0,0,0,,0,0,0,0,0,0,0,0,defense
ITA-Serie A,2021,Atalanta,Marco Sportiello,ITA,GK,28,1992,14.0,2,2,2,0,0,1,3,33.3,2,0,0,0,2,4,5,1,defense
ITA-Serie A,2021,Atalanta,Mario Pašalić,CRO,MF,25,1995,12.5,26,15,5,17,4,12,19,63.2,7,12,1,11,8,34,6,0,defense
ITA-Serie A,2021,Atalanta,Marten de Roon,NED,MF,29,1991,33.6,80,48,30,36,14,36,84,42.9,48,44,9,35,69,149,40,0,defense
ITA-Serie A,2021,Atalanta,Matteo Pessina,ITA,MF,23,1997,18.3,14,7,4,6,4,7,24,29.2,17,17,2,15,17,31,7,1,defense
ITA-Serie A,2021,Atalanta,Matteo Ruggeri,ITA,DF,18,2002,2.3,3,0,1,2,0,2,3,66.7,1,2,0,2,4,7,2,0,defense
ITA-Serie A,2021,Atalanta,Mattia Caldara,ITA,DF,26,1994,1.2,1,0,0,1,0,1,1,100.0,0,3,2,1,4,5,3,0,defense
ITA-Serie A,2021,Atalanta,Papu Gómez,ARG,"MF,FW",32,1988,7.4,3,2,2,1,0,2,8,25.0,6,8,1,7,1,4,1,0,defense
ITA-Serie A,2021,Atalanta,Pierluigi Gollini,ITA,GK,25,1995,24.0,1,0,1,0,0,1,2,50.0,1,1,0,1,1,2,11,0,defense
ITA-Serie A,2021,Atalanta,Rafael Tolói,ITA,DF,29,1990,28.2,51,23,21,26,4,26,48,54.2,22,37,7,30,33,84,66,0,defense
ITA-Serie A,2021,Atalanta,Remo Freuler,SUI,MF,28,1992,30.1,63,39,17,38,8,32,76,42.1,44,52,4,48,39,102,27,2,defense
ITA-Serie A,2021,Atalanta,Robin Gosens,GER,DF,26,1994,28.0,46,35,20,15,11,17,41,41.5,24,50,7,43,41,87,34,0,defense
ITA-Serie A,2021,Atalanta,Ruslan Malinovskyi,UKR,"MF,FW",27,1993,20.8,19,8,2,13,4,8,23,34.8,15,16,1,15,2,21,4,0,defense
ITA-Serie A,2021,Atalanta,Sam Lammers,NED,"FW,MF",23,1997,3.2,2,0,0,2,0,0,6,0.0,6,0,0,0,0,2,3,0,defense
ITA-Serie A,2021,Atalanta,Viktor Kovalenko,UKR,FW,24,1996,0.0,0,0,0,0,0,0,0,,0,0,0,0,0,0,1,0,defense
ITA-Serie A,2021,Benevento,Adolfo Gaich,ARG,FW,21,1999,8.5,9,4,1,7,1,1,13,7.7,12,4,0,4,2,11,4,0,defense
ITA-Serie A,2021,Benevento,Alessandro Tuia,ITA,DF,30,1990,19.6,39,17,34,4,1,15,25,60.0,10,22,10,12,36,75,91,1,defense
ITA-Serie A,2021,Benevento,Amadou Diambo,GHA,FW,19,2001,0.0,0,0,0,0,0,0,0,,0,0,0,0,0,0,0,0,defense
ITA-Serie A,2021,Benevento,Andrés Tello,COL,"DF,MF",23,1996,4.6,9,6,8,0,1,5,20,25.0,15,8,1,7,6,15,6,0,defense
ITA-Serie A,2021,Benevento,Artur Ioniță,MDA,MF,29,1990,31.5,47,22,11,31,5,17,63,27.0,46,38,14,24,19,66,28,0,defense
ITA-Serie A,2021,Benevento,Bryan Dabo,BFA,MF,28,1992,12.4,11,8,5,3,3,5,16,31.3,11,7,1,6,13,24,16,0,defense
ITA-Serie A,2021,Benevento,Christian Maggio,ITA,DF,38,1982,3.3,9,4,2,7,0,3,9,33.3,6,4,1,3,2,11,6,0,defense
ITA-Serie A,2021,Benevento,Christian Pastina,ITA,DF,19,2001,1.3,0,0,0,0,0,0,1,0.0,1,1,0,1,1,1,8,0,defense
ITA-Serie A,2021,Benevento,Daam Foulon,BEL,DF,21,1999,11.3,26,15,21,5,0,16,28,57.1,12,12,3,9,14,40,34,0,defense
ITA-Serie A,2021,Benevento,Fabio Depaoli,ITA,DF,23,1997,12.4,25,13,15,6,4,15,32,46.9,17,16,4,12,12,37,38,0,defense
ITA-Serie A,2021,Benevento,Federico Barba,ITA,DF,26,1993,29.5,31,16,22,8,1,21,35,60.0,14,39,18,21,48,79,94,4,defense
ITA-Serie A,2021,Benevento,Gabriele Moncini,ITA,"FW,MF",24,1996,4.0,2,1,2,0,0,0,1,0.0,1,2,0,2,2,4,4,0,defense
ITA-Serie A,2021,Benevento,Gaetano Letizia,ITA,DF,30,1990,17.4,36,25,19,13,4,17,36,47.2,19,15,3,12,20,56,42,1,defense
ITA-Serie A,2021,Benevento,Gianluca Caprari,ITA,"MF,FW",27,1993,20.7,16,11,5,5,6,6,31,19.4,25,19,1,18,18,34,8,0,defense
ITA-Serie A,2021,Benevento,Gianluca Lapadula,PER,FW,30,1990,28.5,22,12,3,13,6,6,25,24.0,19,18,3,15,5,27,16,0,defense
ITA-Serie A,2021,Benevento,Giuseppe Di Serio,ITA,"FW,MF",19,2001,3.2,2,2,1,1,0,0,4,0.0,4,5,0,5,0,2,4,0,defense
ITA-Serie A,2021,Benevento,Iago Falque,ESP,"MF,FW",30,1990,4.0,4,2,2,2,0,1,6,16.7,5,4,1,3,0,4,1,0,defense
ITA-Serie A,2021,Benevento,Kamil Glik,POL,DF,32,1988,35.6,44,24,33,10,1,25,53,47.2,28,37,31,6,62,106,153,0,defense
ITA-Serie A,2021,Benevento,Lorenzo Del Pinto,ITA,MF,30,1990,0.1,0,0,0,0,0,0,2,0.0,2,0,0,0,0,0,0,0,defense
ITA-Serie A,2021,Benevento,Lorenzo Montipò,ITA,GK,24,1996,37.0,0,0,0,0,0,0,0,,0,1,0,1,0,0,16,3,defense
ITA-Serie A,2021,Benevento,Luca Caldirola,ITA,DF,29,1991,17.5,21,13,13,6,2,10,22,45.5,12,20,15,5,20,41,56,0,defense
ITA-Serie A,2021,Benevento,Marco Sau,ITA,"MF,FW",32,1987,8.7,6,2,0,6,0,1,16,6.3,15,7,0,7,5,11,3,0,defense
ITA-Serie A,2021,Benevento,Niccolò Manfredini,ITA,GK,32,1988,1.0,0,0,0,0,0,0,0,,0,0,0,0,0,0,2,1,defense
ITA-Serie A,2021,Benevento,Nicolas Viola,ITA,MF,30,1989,11.5,16,9,2,11,3,6,28,21.4,22,10,3,7,9,25,7,0,defense
ITA-Serie A,2021,Benevento,Pasquale Schiattarella,ITA,MF,33,1987,25.0,37,22,25,12,0,19,47,40.4,28,19,5,14,32,69,29,2,defense
ITA-Serie A,2021,Benevento,Përparim Hetemaj,FIN,MF,33,1986,24.6,44,27,21,18,5,26,61,42.6,35,41,5,36,22,66,24,1,defense
ITA-Serie A,2021,Benevento,Riccardo Improta,ITA,"DF,MF",26,1993,25.9,39,23,25,8,6,21,45,46.7,24,23,4,19,28,67,47,0,defense
ITA-Serie A,2021,Benevento,Roberto Insigne,ITA,"MF,FW",26,1994,17.8,16,10,8,3,5,7,27,25.9,20,10,0,10,7,23,9,0,defense
ITA-Serie A,2021,Benevento,Siriki Sanogo,CIV,MF,18,2001,0.1,0,0,0,0,0,0,0,,0,0,0,0,0,0,0,0,defense
ITA-Serie A,2021,Bologna,Aaron Hickey,SCO,DF,18,2002,8.4,12,8,10,2,0,7,17,41.2,10,6,1,5,15,27,15,1,defense
ITA-Serie A,2021,Bologna,Adama Soumaoro,FRA,DF,28,1992,19.5,24,14,17,7,0,6,12,50.0,6,28,23,5,20,44,72,0,defense
ITA-Serie A,2021,Bologna,Andrea Poli,ITA,MF,30,1989,4.3,9,7,4,2,3,6,12,50.0,6,7,1,6,7,16,7,0,defense
ITA-Serie A,2021,Bologna,Andreas Skov Olsen,DEN,"FW,DF",20,1999,13.1,19,10,11,4,4,11,21,52.4,10,15,0,15,3,22,25,0,defense
ITA-Serie A,2021,Bologna,Andri Fannar Baldursson,ISL,MF,18,2002,2.4,6,6,1,2,3,1,3,33.3,2,3,1,2,3,9,7,0,defense
ITA-Serie A,2021,Bologna,Angelo da Costa Júnior,BRA,GK,36,1983,6.0,0,0,0,0,0,0,0,,0,0,0,0,0,0,2,3,defense
ITA-Serie A,2021,Bologna,Antonio Raimondo,ITA,FW,16,2004,0.0,0,0,0,0,0,0,0,,0,0,0,0,0,0,0,0,defense
ITA-Serie A,2021,Bologna,Arturo Calabresi,ITA,"DF,FW",24,1996,0.2,0,0,0,0,0,0,0,,0,0,0,0,0,0,2,0,defense
ITA-Serie A,2021,Bologna,Danilo Larangeira,BRA,DF,36,1984,34.8,33,24,23,10,0,8,29,27.6,21,58,36,22,51,84,127,2,defense
ITA-Serie A,2021,Bologna,Edoardo Vergani,ITA,FW,19,2001,0.1,0,0,0,0,0,0,0,,0,0,0,0,0,0,0,0,defense
ITA-Serie A,2021,Bologna,Emanuel Vignato,ITA,"FW,MF",19,2000,13.4,18,9,9,6,3,3,15,20.0,12,6,1,5,10,28,7,0,defense
ITA-Serie A,2021,Bologna,Federico Ravaglia,ITA,GK,20,1999,4.0,0,0,0,0,0,0,1,0.0,1,0,0,0,0,0,2,0,defense
ITA-Serie A,2021,Bologna,Federico Santander,PAR,FW,29,1991,0.4,0,0,0,0,0,0,0,,0,0,0,0,0,0,0,0,defense
ITA-Serie A,2021,Bologna,Gary Medel,CHI,"DF,MF",32,1987,5.7,12,9,6,5,1,4,10,40.0,6,8,6,2,7,19,10,0,defense
ITA-Serie A,2021,Bologna,Ibrahima Mbaye,SEN,DF,25,1994,4.8,6,5,5,1,0,3,5,60.0,2,5,3,2,1,7,10,0,defense
ITA-Serie A,2021,Bologna,Jerdy Schouten,NED,MF,23,1997,27.9,50,25,23,25,2,16,37,43.2,21,36,13,23,79,129,37,6,defense
ITA-Serie A,2021,Bologna,Kacper Urbanski,POL,FW,15,2004,0.0,0,0,0,0,0,0,0,,0,0,0,0,0,0,0,0,defense
ITA-Serie A,2021,Bologna,Lorenzo De Silvestri,ITA,DF,32,1988,23.8,34,24,18,13,3,16,37,43.2,21,37,10,27,30,64,62,3,defense
ITA-Serie A,2021,Bologna,Mattia Pagliuca,ITA,MF,18,2002,0.1,0,0,0,0,0,0,0,,0,0,0,0,1,1,0,0,defense
ITA-Serie A,2021,Bologna,Mattias Svanberg,SWE,MF,21,1999,20.6,38,17,21,9,8,16,45,35.6,29,25,4,21,30,68,25,1,defense
ITA-Serie A,2021,Bologna,Mitchell Dijks,NED,DF,27,1993,16.5,21,14,15,5,1,12,21,57.1,9,17,2,15,17,38,35,0,defense
ITA-Serie A,2021,Bologna,Musa Barrow,GAM,"FW,MF",21,1998,32.5,26,10,8,10,8,10,25,40.0,15,37,2,35,11,37,15,0,defense
ITA-Serie A,2021,Bologna,Musa Juwara,GAM,"MF,DF",18,2001,0.5,2,2,2,0,0,1,3,33.3,2,1,0,1,0,2,0,0,defense
ITA-Serie A,2021,Bologna,Nehuén Paz,ARG,DF,27,1993,4.0,9,4,4,5,0,6,7,85.7,1,4,2,2,11,20,16,0,defense
ITA-Serie A,2021,Bologna,Nicola Sansone,ITA,"FW,MF",28,1991,13.0,22,11,7,12,3,10,31,32.3,21,15,0,15,9,31,7,0,defense
ITA-Serie A,2021,Bologna,Nicolás Domínguez,ARG,MF,22,1998,13.9,48,28,26,17,5,15,37,40.5,22,26,7,19,24,72,20,0,defense
ITA-Serie A,2021,Bologna,Omar Khailoti,ITA,DF,18,2001,0.3,0,0,0,0,0,0,0,,0,2,0,2,1,1,0,0,defense
ITA-Serie A,2021,Bologna,Paolo Faragò,ITA,DF,27,1993,0.3,1,1,1,0,0,1,2,50.0,1,1,0,1,0,1,0,0,defense
ITA-Serie A,2021,Bologna,Riccardo Orsolini,ITA,"FW,MF",23,1997,19.5,37,18,13,12,12,16,39,41.0,23,22,3,19,10,47,22,0,defense
ITA-Serie A,2021,Bologna,Roberto Soriano,ITA,MF,29,1991,36.1,48,26,15,20,13,15,64,23.4,49,31,8,23,18,66,43,0,defense
ITA-Serie A,2021,Bologna,Rodrigo Palacio,ARG,FW,38,1982,27.8,13,6,2,3,8,1,15,6.7,14,18,0,18,7,20,29,0,defense
ITA-Serie A,2021,Bologna,Simone Rabbi,ITA,"FW,DF",18,2001,0.4,0,0,0,0,0,0,1,0.0,1,0,0,0,0,0,0,0,defense
ITA-Serie A,2021,Bologna,Stefano Denswil,SUR,DF,27,1993,1.3,2,1,1,1,0,0,1,0.0,1,1,0,1,1,3,1,0,defense
ITA-Serie A,2021,Bologna,Takehiro Tomiyasu,JPN,DF,21,1998,30.2,47,31,27,14,6,21,34,61.8,13,37,19,18,54,101,106,0,defense
ITA-Serie A,2021,Bologna,Valentin Antov,BUL,DF,19,2000,2.6,4,2,3,1,0,3,10,30.0,7,6,5,1,4,8,13,0,defense
ITA-Serie A,2021,Bologna,Wisdom Amey,ITA,DF,14,2005,0.0,0,0,0,0,0,0,0,,0,0,0,0,0,0,0,0,defense
ITA-Serie A,2021,Bologna,Łukasz Skorupski,POL,GK,29,1991,28.0,1,1,1,0,0,1,4,25.0,3,0,0,0,0,1,23,5,defense
ITA-Serie A,2021,Cagliari,Adam Ounas,ALG,"MF,FW",23,1996,3.4,3,2,3,0,0,0,11,0.0,11,5,0,5,3,6,0,0,defense
ITA-Serie A,2021,Cagliari,Alberto Cerri,ITA,FW,24,1996,4.1,3,2,0,2,1,0,5,0.0,5,4,2,2,2,5,6,0,defense
ITA-Serie A,2021,Cagliari,Alessandro Deiola,ITA,MF,24,1995,6.8,13,5,5,4,4,8,23,34.8,15,7,2,5,11,24,11,0,defense
ITA-Serie A,2021,Cagliari,Alessandro Tripaldelli,ITA,DF,21,1999,3.3,13,6,5,6,2,5,6,83.3,1,6,1,5,3,16,15,0,defense
ITA-Serie A,2021,Cagliari,Alessio Cragno,ITA,GK,26,1994,34.0,0,0,0,0,0,0,1,0.0,1,0,0,0,1,1,10,0,defense
ITA-Serie A,2021,Cagliari,Alfred Duncan,GHA,MF,27,1993,11.9,18,10,8,9,1,4,21,19.0,17,8,0,8,16,34,8,1,defense
ITA-Serie A,2021,Cagliari,Andrea Carboni,ITA,DF,19,2001,12.1,34,23,23,11,0,15,28,53.6,13,15,4,11,14,48,52,0,defense
ITA-Serie A,2021,Cagliari,Arturo Calabresi,ITA,DF,24,1996,0.2,0,0,0,0,0,0,1,0.0,1,0,0,0,0,0,0,0,defense
ITA-Serie A,2021,Cagliari,Charalambos Lykogiannis,GRE,DF,26,1993,26.9,34,21,22,9,3,22,38,57.9,16,34,13,21,32,66,94,0,defense
ITA-Serie A,2021,Cagliari,Christian Oliva,URU,MF,24,1996,4.3,10,4,6,3,1,6,17,35.3,11,11,1,10,8,18,7,0,defense
ITA-Serie A,2021,Cagliari,Daniele Rugani,ITA,DF,26,1994,11.1,24,11,10,12,2,10,20,50.0,10,15,10,5,15,39,46,0,defense
ITA-Serie A,2021,Cagliari,Diego Godín,URU,DF,34,1986,27.9,60,32,51,9,0,24,39,61.5,15,41,24,17,56,116,117,0,defense
ITA-Serie A,2021,Cagliari,Fabio Pisacane,ITA,DF,34,1986,2.5,3,2,2,1,0,3,7,42.9,4,8,5,3,1,4,9,1,defense
ITA-Serie A,2021,Cagliari,Fabrizio Caligara,ITA,"MF,FW",20,2000,2.0,6,4,2,2,2,6,9,66.7,3,9,2,7,3,9,3,0,defense
ITA-Serie A,2021,Cagliari,Gabriele Zappa,ITA,DF,20,1999,26.6,34,17,16,15,3,22,49,44.9,27,36,4,32,24,58,50,0,defense
ITA-Serie A,2021,Cagliari,Gastón Pereiro,URU,"MF,DF",25,1995,3.0,3,1,2,1,0,1,2,50.0,1,2,0,2,1,4,2,1,defense
ITA-Serie A,2021,Cagliari,Giovanni Simeone,ARG,FW,25,1995,19.3,24,11,2,15,7,7,31,22.6,24,23,1,22,10,34,18,0,defense
ITA-Serie A,2021,Cagliari,Guglielmo Vicario,ITA,GK,23,1996,4.0,0,0,0,0,0,0,0,,0,0,0,0,0,0,1,0,defense
ITA-Serie A,2021,Cagliari,João Pedro,ITA,"FW,MF",28,1992,36.1,13,6,2,6,5,2,27,7.4,25,32,6,26,13,26,28,0,defense
ITA-Serie A,2021,Cagliari,Kiril Despodov,BUL,FW,23,1996,0.1,1,1,0,1,0,1,1,100.0,0,0,0,0,0,1,0,0,defense
ITA-Serie A,2021,Cagliari,Kwadwo Asamoah,GHA,"DF,MF",31,1988,2.5,4,3,2,2,0,2,3,66.7,1,5,1,4,4,8,2,1,defense
ITA-Serie A,2021,Cagliari,Leonardo Pavoletti,ITA,FW,31,1988,17.6,7,3,2,5,0,1,20,5.0,19,4,2,2,4,11,32,0,defense
ITA-Serie A,2021,Cagliari,Luca Ceppitelli,ITA,DF,30,1989,16.3,25,19,13,10,2,14,26,53.8,12,23,12,11,25,50,58,1,defense
ITA-Serie A,2021,Cagliari,Marko Rog,CRO,MF,25,1995,12.9,40,24,15,22,3,16,37,43.2,21,17,6,11,19,59,15,0,defense
ITA-Serie A,2021,Cagliari,Mattéo Tramoni,FRA,"MF,FW",20,2000,0.8,4,2,2,1,1,1,2,50.0,1,5,0,5,1,5,2,0,defense
ITA-Serie A,2021,Cagliari,Nahitan Nández,URU,"MF,DF",24,1995,30.4,56,28,23,23,10,25,68,36.8,43,26,4,22,23,79,49,0,defense
ITA-Serie A,2021,Cagliari,Paolo Faragò,ITA,DF,27,1993,4.1,13,9,10,3,0,9,20,45.0,11,3,2,1,6,19,15,0,defense
ITA-Serie A,2021,Cagliari,Radja Nainggolan,BEL,MF,32,1988,20.5,41,26,22,14,5,19,34,55.9,15,18,0,18,15,56,15,1,defense
ITA-Serie A,2021,Cagliari,Ragnar Klavan,EST,DF,34,1985,8.6,15,9,9,5,1,7,11,63.6,4,9,4,5,8,23,34,0,defense
ITA-Serie A,2021,Cagliari,Riccardo Sottil,ITA,"FW,MF",21,1999,13.2,7,3,2,3,2,0,7,0.0,7,4,0,4,5,12,3,0,defense
ITA-Serie A,2021,Cagliari,Răzvan Marin,ROU,MF,24,1996,32.9,54,33,26,22,6,27,53,50.9,26,29,10,19,29,83,15,0,defense
ITA-Serie A,2021,Cagliari,Sebastian Walukiewicz,POL,DF,20,2000,18.0,27,19,11,13,3,12,30,40.0,18,22,14,8,36,63,60,0,defense
ITA-Serie A,2021,Crotone,Adam Ounas,ALG,"FW,MF",23,1996,13.3,9,4,4,4,1,0,7,0.0,7,12,1,11,3,12,4,0,defense
ITA-Serie A,2021,Crotone,Ahmad Benali,LBY,MF,28,1992,13.5,19,11,10,9,0,11,38,28.9,27,15,2,13,6,25,15,0,defense
ITA-Serie A,2021,Crotone,Alex Cordaz,ITA,GK,37,1983,36.0,0,0,0,0,0,0,0,,0,0,0,0,1,1,7,2,defense
ITA-Serie A,2021,Crotone,Andrea Rispoli,ITA,DF,31,1988,7.2,6,3,2,3,1,2,7,28.6,5,12,3,9,5,11,15,1,defense
ITA-Serie A,2021,Crotone,Antonio Mazzotta,ITA,DF,30,1989,0.6,1,1,0,1,0,0,0,,0,0,0,0,0,1,1,0,defense
ITA-Serie A,2021,Crotone,Arkadiusz Reca,POL,DF,25,1995,25.7,34,16,15,11,8,10,45,22.2,35,30,3,27,50,84,64,0,defense
ITA-Serie A,2021,Crotone,Augustus Kargbo,SLE,FW,20,1999,0.4,0,0,0,0,0,0,0,,0,0,0,0,0,0,0,0,defense
ITA-Serie A,2021,Crotone,Denis Drăguș,ROU,"FW,MF",21,1999,2.0,3,1,0,0,3,0,4,0.0,4,4,0,4,1,4,0,0,defense
ITA-Serie A,2021,Crotone,Eduardo Henrique,BRA,MF,25,1995,10.3,5,2,1,4,0,3,12,25.0,9,6,1,5,7,12,7,1,defense
ITA-Serie A,2021,Crotone,Emmanuel Rivière,FRA,FW,30,1990,7.1,2,1,2,0,0,0,3,0.0,3,5,1,4,1,3,0,0,defense
ITA-Serie A,2021,Crotone,Gian Crespi,ITA,GK,19,2001,1.0,0,0,0,0,0,0,0,,0,0,0,0,0,0,0,0,defense
ITA-Serie A,2021,Crotone,Giovanni Crociata,ITA,DF,22,1997,0.3,1,0,0,1,0,0,1,0.0,1,1,0,1,0,1,0,0,defense
ITA-Serie A,2021,Crotone,Giuseppe Cuomo,ITA,DF,22,1998,8.9,26,19,17,9,0,9,14,64.3,5,10,2,8,18,44,19,1,defense
ITA-Serie A,2021,Crotone,Jacopo Petriccione,ITA,MF,25,1995,10.6,14,8,6,7,1,9,24,37.5,15,11,2,9,8,22,11,0,defense
ITA-Serie A,2021,Crotone,Junior Messias,BRA,"MF,FW",29,1991,35.7,60,35,26,24,10,22,70,31.4,48,32,12,20,35,95,40,0,defense
ITA-Serie A,2021,Crotone,Koffi Djidji,CIV,DF,27,1992,16.9,39,28,30,8,1,10,20,50.0,10,35,20,15,28,67,73,0,defense
ITA-Serie A,2021,Crotone,Lisandro Magallán,ARG,DF,26,1993,24.2,54,31,28,24,2,17,42,40.5,25,29,15,14,44,98,78,1,defense
ITA-Serie A,2021,Crotone,Luca Cigarini,ITA,MF,34,1986,10.3,26,14,11,12,3,12,28,42.9,16,10,1,9,12,38,9,0,defense
ITA-Serie A,2021,Crotone,Luca Marrone,ITA,DF,30,1990,17.6,25,18,16,9,0,13,21,61.9,8,22,11,11,26,51,56,1,defense
ITA-Serie A,2021,Crotone,Luca Siligardi,ITA,"MF,FW",32,1988,0.5,4,2,0,3,1,1,5,20.0,4,0,0,0,0,4,0,0,defense
ITA-Serie A,2021,Crotone,Luis Rojas,CHI,"MF,FW",18,2002,1.2,1,0,0,1,0,1,2,50.0,1,2,0,2,1,2,0,0,defense
ITA-Serie A,2021,Crotone,Marco Festa,ITA,GK,28,1992,1.0,0,0,0,0,0,0,0,,0,0,0,0,0,0,0,0,defense
ITA-Serie A,2021,Crotone,Miloš Vulić,SRB,MF,23,1996,14.5,15,8,9,1,5,8,21,38.1,13,10,1,9,8,23,8,0,defense
ITA-Serie A,2021,Crotone,Niccolò Zanellato,ITA,MF,22,1998,18.2,24,14,16,6,2,13,36,36.1,23,19,5,14,16,40,12,2,defense
ITA-Serie A,2021,Crotone,Pedro Pereira,POR,DF,22,1998,28.3,50,32,29,17,4,21,40,52.5,19,33,11,22,19,69,61,0,defense
ITA-Serie A,2021,Crotone,Salvatore Molina,ITA,"MF,DF",28,1992,25.7,39,22,18,14,7,29,45,64.4,16,30,8,22,17,56,41,0,defense
ITA-Serie A,2021,Crotone,Samuel Di Carmine,ITA,FW,31,1988,5.3,2,2,1,0,1,1,3,33.3,2,2,0,2,0,2,5,0,defense
ITA-Serie A,2021,Crotone,Sebastiano Luperto,ITA,DF,23,1996,20.9,38,20,28,8,2,16,27,59.3,11,17,7,10,27,65,74,1,defense
ITA-Serie A,2021,Crotone,Simeon Nwankwo,NGA,FW,28,1992,32.7,9,2,2,6,1,3,22,13.6,19,21,5,16,6,15,51,0,defense
ITA-Serie A,2021,Crotone,Tomislav Gomelt,CRO,MF,25,1995,0.2,1,1,0,1,0,0,0,,0,0,0,0,1,2,0,0,defense
ITA-Serie A,2021,Crotone,Vladimir Golemić,SVN,DF,29,1991,26.0,33,16,17,13,3,14,19,73.7,5,38,26,12,40,73,97,2,defense
ITA-Serie A,2021,Fiorentina,Aleksandr Kokorin,RUS,"FW,MF",29,1991,1.0,1,0,0,1,0,0,1,0.0,1,1,0,1,0,1,0,0,defense
ITA-Serie A,2021,Fiorentina,Alfred Duncan,GHA,MF,27,1993,1.8,3,0,1,1,1,0,2,0.0,2,2,0,2,2,5,0,0,defense
ITA-Serie A,2021,Fiorentina,Antonio Barreca,ITA,DF,25,1995,0.9,1,0,0,1,0,1,1,100.0,0,0,0,0,0,1,1,0,defense
ITA-Serie A,2021,Fiorentina,Bartłomiej Drągowski,POL,GK,22,1997,35.0,1,0,1,0,0,1,1,100.0,0,0,0,0,1,2,13,1,defense
ITA-Serie A,2021,Fiorentina,Borja Valero,ESP,"MF,FW",35,1985,5.5,13,9,7,4,2,3,15,20.0,12,6,1,5,6,19,2,0,defense
ITA-Serie A,2021,Fiorentina,Christian Kouamé,CIV,FW,22,1997,11.1,9,4,2,4,3,4,12,33.3,8,9,1,8,5,14,4,0,defense
ITA-Serie A,2021,Fiorentina,Cristiano Biraghi,ITA,DF,27,1992,31.1,42,23,19,15,8,27,45,60.0,18,23,9,14,27,69,56,3,defense
ITA-Serie A,2021,Fiorentina,Cristóbal Montiel,ESP,"MF,FW",20,2000,0.0,0,0,0,0,0,0,1,0.0,1,0,0,0,0,0,0,0,defense
ITA-Serie A,2021,Fiorentina,Dušan Vlahović,SRB,FW,20,2000,32.5,13,4,3,4,6,5,16,31.3,11,16,2,14,4,17,15,0,defense
ITA-Serie A,2021,Fiorentina,Erick Pulgar,CHI,MF,26,1994,22.2,41,18,17,23,1,22,49,44.9,27,24,10,14,41,82,45,1,defense
ITA-Serie A,2021,Fiorentina,Federico Ceccherini,ITA,DF,28,1992,3.0,4,1,1,3,0,1,1,100.0,0,6,5,1,7,11,15,0,defense
ITA-Serie A,2021,Fiorentina,Federico Chiesa,ITA,DF,22,1997,2.7,6,2,2,2,2,3,8,37.5,5,3,1,2,1,7,3,0,defense
ITA-Serie A,2021,Fiorentina,Franck Ribéry,FRA,FW,37,1983,23.9,24,11,4,9,11,5,29,17.2,24,11,2,9,3,27,1,0,defense
ITA-Serie A,2021,Fiorentina,Gaetano Castrovilli,ITA,MF,23,1997,25.9,33,19,15,11,7,11,42,26.2,31,25,2,23,34,67,14,0,defense
ITA-Serie A,2021,Fiorentina,Germán Pezzella,ARG,DF,29,1991,30.5,34,20,22,12,0,18,32,56.3,14,26,14,12,36,70,109,1,defense
ITA-Serie A,2021,Fiorentina,Giacomo Bonaventura,ITA,MF,30,1989,25.1,34,19,16,13,5,16,53,30.2,37,26,2,24,39,73,12,0,defense
ITA-Serie A,2021,Fiorentina,Igor,BRA,DF,22,1998,13.0,15,9,9,6,0,7,12,58.3,5,17,9,8,23,38,34,0,defense
ITA-Serie A,2021,Fiorentina,José Callejón,ESP,"FW,MF",33,1987,7.4,10,7,0,6,4,5,9,55.6,4,4,1,3,4,14,5,0,defense
ITA-Serie A,2021,Fiorentina,Kévin Malcuit,MAR,DF,29,1991,2.3,5,3,2,2,1,0,1,0.0,1,5,0,5,3,8,6,0,defense
ITA-Serie A,2021,Fiorentina,Lorenzo Venuti,ITA,DF,25,1995,19.5,24,11,14,7,3,14,28,50.0,14,18,3,15,17,41,24,0,defense
ITA-Serie A,2021,Fiorentina,Lucas Martínez Quarta,ARG,DF,24,1996,16.5,32,20,17,11,4,18,41,43.9,23,27,9,18,39,71,48,0,defense
ITA-Serie A,2021,Fiorentina,Martín Cáceres,URU,DF,33,1987,24.9,28,12,16,11,1,15,35,42.9,20,20,14,6,14,42,52,1,defense
ITA-Serie A,2021,Fiorentina,Maximiliano Olivera,URU,DF,28,1992,1.0,2,0,1,1,0,1,1,100.0,0,3,1,2,0,2,8,0,defense
ITA-Serie A,2021,Fiorentina,Nikola Milenković,SRB,DF,22,1997,33.7,49,29,33,14,2,21,33,63.6,12,42,33,9,44,93,122,1,defense
ITA-Serie A,2021,Fiorentina,Patrick Cutrone,ITA,FW,22,1998,2.2,4,3,1,2,1,1,2,50.0,1,1,0,1,1,5,0,0,defense
ITA-Serie A,2021,Fiorentina,Pietro Terracciano,ITA,GK,30,1990,3.0,0,0,0,0,0,0,0,,0,0,0,0,0,0,1,0,defense
ITA-Serie A,2021,Fiorentina,Pol Lirola,ESP,"DF,FW",22,1997,5.5,13,8,8,2,3,6,12,50.0,6,6,3,3,6,19,9,0,defense
ITA-Serie A,2021,Fiorentina,Riccardo Saponara,ITA,MF,28,1991,0.6,2,1,0,2,0,1,3,33.3,2,0,0,0,1,3,0,0,defense
ITA-Serie A,2021,Fiorentina,Sofyan Amrabat,MAR,MF,23,1996,27.1,39,22,11,24,4,18,48,37.5,30,30,5,25,23,62,12,0,defense
ITA-Serie A,2021,Fiorentina,Valentin Eysseric,FRA,"MF,FW",28,1992,8.1,14,8,6,7,1,5,11,45.5,6,11,0,11,7,21,8,0,defense
ITA-Serie A,2021,Genoa,Alberto Paleari,ITA,GK,27,1992,2.3,0,0,0,0,0,0,0,,0,0,0,0,0,0,1,0,defense
ITA-Serie A,2021,Genoa,Andrea Masiello,ITA,DF,34,1986,28.5,38,22,29,6,3,23,48,47.9,25,32,13,19,53,91,107,3,defense
ITA-Serie A,2021,Genoa,Cristián Zapata,COL,DF,33,1986,10.8,18,12,11,7,0,10,14,71.4,4,15,11,4,15,33,56,0,defense
ITA-Serie A,2021,Genoa,Davide Biraschi,ITA,DF,26,1994,10.2,17,9,12,5,0,5,10,50.0,5,12,6,6,21,38,26,0,defense
ITA-Serie A,2021,Genoa,Davide Zappacosta,ITA,DF,28,1992,22.7,33,16,15,13,5,15,30,50.0,15,17,1,16,18,51,41,0,defense
ITA-Serie A,2021,Genoa,Domenico Criscito,ITA,DF,33,1986,19.2,43,22,29,11,3,22,39,56.4,17,27,14,13,44,87,51,0,defense
ITA-Serie A,2021,Genoa,Edoardo Goldaniga,ITA,DF,26,1993,20.6,28,18,21,7,0,14,23,60.9,9,17,7,10,38,66,62,1,defense
ITA-Serie A,2021,Genoa,Eldor Shomurodov,UZB,FW,25,1995,18.6,28,14,7,13,8,9,37,24.3,28,17,2,15,6,34,11,0,defense
ITA-Serie A,2021,Genoa,Federico Marchetti,ITA,GK,37,1983,3.7,1,0,1,0,0,1,1,100.0,0,0,0,0,0,1,2,1,defense
ITA-Serie A,2021,Genoa,Filippo Melegoni,ITA,"MF,DF",21,1999,4.3,7,6,2,5,0,3,6,50.0,3,5,0,5,5,12,8,0,defense
ITA-Serie A,2021,Genoa,Francesco Cassata,ITA,"DF,FW",23,1997,2.5,7,6,7,0,0,4,7,57.1,3,0,0,0,3,10,1,0,defense
ITA-Serie A,2021,Genoa,Gianluca Scamacca,ITA,FW,21,1999,15.0,19,10,6,7,6,7,19,36.8,12,21,4,17,9,28,12,0,defense
ITA-Serie A,2021,Genoa,Giuseppe Caso,ITA,"DF,FW",21,1998,0.6,0,0,0,0,0,0,0,,0,0,0,0,0,0,0,0,defense
ITA-Serie A,2021,Genoa,Goran Pandev,MKD,"FW,MF",37,1983,15.6,9,5,1,6,2,4,10,40.0,6,6,0,6,2,11,7,1,defense
ITA-Serie A,2021,Genoa,Ivan Radovanović,SRB,"DF,MF",31,1988,24.8,18,15,13,5,0,12,31,38.7,19,39,21,18,37,55,114,2,defense
ITA-Serie A,2021,Genoa,Jérôme Onguéné,CMR,DF,22,1997,2.0,2,1,2,0,0,2,7,28.6,5,2,0,2,2,4,8,0,defense
ITA-Serie A,2021,Genoa,Kevin Strootman,NED,MF,30,1990,14.6,30,18,13,15,2,14,32,43.8,18,35,3,32,25,55,18,0,defense
ITA-Serie A,2021,Genoa,Lennart-Marten Czyborra,GER,DF,21,1999,13.0,19,10,7,7,5,11,19,57.9,8,6,1,5,17,36,27,0,defense
ITA-Serie A,2021,Genoa,Luca Pellegrini,ITA,"DF,MF",21,1999,7.1,9,6,6,2,1,4,10,40.0,6,11,2,9,8,17,13,1,defense
ITA-Serie A,2021,Genoa,Lukas Lerager,DEN,MF,27,1993,12.9,24,13,14,9,1,11,30,36.7,19,13,3,10,14,38,25,1,defense
ITA-Serie A,2021,Genoa,Manolo Portanova,ITA,"MF,FW",20,2000,0.7,3,3,1,1,1,0,2,0.0,2,3,1,2,1,4,2,0,defense
ITA-Serie A,2021,Genoa,Marko Pjaca,CRO,"FW,MF",25,1995,15.8,13,6,6,3,4,4,16,25.0,12,7,2,5,7,20,12,0,defense
ITA-Serie A,2021,Genoa,Mattia Bani,ITA,DF,26,1993,10.2,10,5,5,5,0,5,12,41.7,7,16,11,5,27,37,44,0,defense
ITA-Serie A,2021,Genoa,Mattia Destro,ITA,FW,29,1991,17.8,6,3,0,3,3,2,9,22.2,7,11,0,11,4,10,8,0,defense
ITA-Serie A,2021,Genoa,Mattia Perin,ITA,GK,27,1992,32.0,0,0,0,0,0,0,0,,0,0,0,0,1,1,6,0,defense
ITA-Serie A,2021,Genoa,Miha Zajc,SVN,MF,26,1994,20.7,22,14,9,10,3,13,39,33.3,26,30,4,26,27,49,19,0,defense
ITA-Serie A,2021,Genoa,Milan Badelj,CRO,MF,31,1989,26.8,56,27,27,22,7,26,84,31.0,58,51,10,41,87,143,45,1,defense
ITA-Serie A,2021,Genoa,Nicolò Rovella,ITA,MF,18,2001,13.2,29,16,15,11,3,9,32,28.1,23,11,0,11,20,49,19,1,defense
ITA-Serie A,2021,Genoa,Paolo Ghiglione,ITA,"DF,MF",23,1997,15.1,27,15,17,8,2,13,28,46.4,15,14,2,12,13,40,25,0,defense
ITA-Serie A,2021,Genoa,Steeve-Mike Ebongue,FRA,MF,19,2001,0.6,2,1,1,0,1,0,3,0.0,3,1,0,1,0,2,0,0,defense
ITA-Serie A,2021,Genoa,Stefano Sturaro,ITA,MF,27,1993,4.9,11,5,3,6,2,3,15,20.0,12,5,0,5,7,18,2,0,defense
ITA-Serie A,2021,Genoa,Valon Behrami,SUI,MF,35,1985,9.9,21,9,9,10,2,9,26,34.6,17,13,5,8,9,30,13,0,defense
ITA-Serie A,2021,Genoa,Vittorio Parigini,ITA,"MF,DF",24,1996,0.6,5,2,4,0,1,0,1,0.0,1,0,0,0,0,5,0,0,defense
ITA-Serie A,2021,Genoa,Yayah Kallon,SLE,FW,19,2001,0.5,0,0,0,0,0,0,0,,0,0,0,0,0,0,0,0,defense
ITA-Serie A,2021,Hellas Verona,Adrien Tameze,CMR,MF,26,1994,25.6,39,25,23,15,1,11,27,40.7,16,31,8,23,32,71,46,2,defense
ITA-Serie A,2021,Hellas Verona,Alan Empereur,BRA,DF,26,1994,2.4,0,0,0,0,0,0,0,,0,1,1,0,6,6,7,1,defense
ITA-Serie A,2021,Hellas Verona,Alessandro Berardi,ITA,GK,29,1991,0.3,0,0,0,0,0,0,0,,0,0,0,0,0,0,0,0,defense
ITA-Serie A,2021,Hellas Verona,Andrea Danzi,ITA,DF,21,1999,1.2,0,0,0,0,0,0,1,0.0,1,0,0,0,3,3,1,0,defense
ITA-Serie A,2021,Hellas Verona,Andrea Favilli,ITA,FW,23,1997,3.8,3,1,0,1,2,2,3,66.7,1,2,0,2,0,3,2,0,defense
ITA-Serie A,2021,Hellas Verona,Antonín Barák,CZE,MF,25,1994,30.7,30,19,8,16,6,14,47,29.8,33,26,7,19,12,42,38,1,defense
ITA-Serie A,2021,Hellas Verona,Daniel Bessa,ITA,MF,27,1993,6.8,15,8,3,11,1,6,14,42.9,8,5,1,4,2,17,0,0,defense
ITA-Serie A,2021,Hellas Verona,Darko Lazović,SRB,"DF,MF",29,1990,27.8,29,17,8,17,4,20,42,47.6,22,17,7,10,20,49,29,0,defense
ITA-Serie A,2021,Hellas Verona,Davide Faraoni,ITA,DF,28,1991,32.1,62,33,36,19,7,28,51,54.9,23,48,17,31,49,111,83,1,defense
ITA-Serie A,2021,Hellas Verona,Destiny Udogie,ITA,"DF,MF",17,2002,1.9,6,4,2,2,2,2,2,100.0,0,3,0,3,2,8,4,0,defense
ITA-Serie A,2021,Hellas Verona,Ebrima Colley,GAM,"MF,FW",20,2000,8.2,11,4,2,6,3,3,11,27.3,8,6,0,6,6,17,1,0,defense
ITA-Serie A,2021,Hellas Verona,Eddie Salcedo,ITA,"MF,FW",18,2001,8.4,6,2,3,2,1,3,3,100.0,0,6,0,6,6,12,6,0,defense
ITA-Serie A,2021,Hellas Verona,Federico Ceccherini,ITA,DF,28,1992,19.3,16,12,10,6,0,2,7,28.6,5,15,8,7,40,56,60,0,defense
ITA-Serie A,2021,Hellas Verona,Federico Dimarco,ITA,DF,22,1997,29.0,32,19,23,7,2,13,28,46.4,15,18,9,9,47,79,50,1,defense
ITA-Serie A,2021,Hellas Verona,Giangiacomo Magnani,ITA,DF,24,1995,16.8,26,15,14,9,3,9,16,56.3,7,25,16,9,44,70,105,1,defense
ITA-Serie A,2021,Hellas Verona,Ivan Ilić,SRB,MF,19,2001,20.4,26,14,11,11,4,7,21,33.3,14,17,5,12,27,53,26,0,defense
ITA-Serie A,2021,Hellas Verona,Ivor Pandur,CRO,GK,20,2000,3.7,0,0,0,0,0,0,0,,0,0,0,0,0,0,0,0,defense
ITA-Serie A,2021,Hellas Verona,Kevin Lasagna,ITA,FW,27,1992,14.1,7,3,0,5,2,1,5,20.0,4,12,1,11,1,8,11,0,defense
ITA-Serie A,2021,Hellas Verona,Kevin Rüegg,SUI,"DF,MF",21,1998,2.3,0,0,0,0,0,0,0,,0,3,0,3,2,2,3,0,defense
ITA-Serie A,2021,Hellas Verona,Koray Günter,GER,DF,25,1994,19.6,20,10,10,9,1,4,9,44.4,5,27,21,6,70,90,87,0,defense
ITA-Serie A,2021,Hellas Verona,Marco Silvestri,ITA,GK,29,1991,34.0,0,0,0,0,0,0,0,,0,0,0,0,0,0,14,1,defense
ITA-Serie A,2021,Hellas Verona,Matteo Lovato,ITA,DF,20,2000,15.4,21,12,14,5,2,10,21,47.6,11,20,10,10,37,58,48,1,defense
ITA-Serie A,2021,Hellas Verona,Mattia Zaccagni,ITA,MF,25,1995,29.0,27,13,8,11,8,8,25,32.0,17,28,4,24,27,54,13,1,defense
ITA-Serie A,2021,Hellas Verona,Miguel Veloso,POR,MF,34,1986,14.6,24,17,10,10,4,12,34,35.3,22,12,1,11,12,36,25,0,defense
ITA-Serie A,2021,Hellas Verona,Nikola Kalinić,CRO,FW,32,1988,11.8,5,1,2,2,1,0,3,0.0,3,6,0,6,1,6,7,0,defense
ITA-Serie A,2021,Hellas Verona,Paweł Dawidowicz,POL,DF,25,1995,20.7,42,28,30,10,2,14,24,58.3,10,28,19,9,27,69,62,1,defense
ITA-Serie A,2021,Hellas Verona,Philip Ankhrah,GHA,MF,17,2002,0.1,0,0,0,0,0,0,0,,0,1,0,1,0,0,0,0,defense
ITA-Serie A,2021,Hellas Verona,Ronaldo Vieira,ENG,"MF,DF",22,1998,2.5,5,3,1,3,1,0,2,0.0,2,4,3,1,0,5,2,0,defense
ITA-Serie A,2021,Hellas Verona,Samuel Di Carmine,ITA,FW,31,1988,5.6,1,2,0,1,0,0,3,0.0,3,1,0,1,0,1,5,0,defense
ITA-Serie A,2021,Hellas Verona,Stefano Sturaro,ITA,MF,27,1993,4.7,4,3,3,0,1,2,8,25.0,6,5,1,4,5,9,10,0,defense
ITA-Serie A,2021,Hellas Verona,Yıldırım Mert Çetin,TUR,DF,23,1997,4.6,8,4,3,5,0,2,6,33.3,4,7,5,2,14,22,11,1,defense
ITA-Serie A,2021,Hellas Verona,Ľubomír Tupta,SVK,FW,22,1998,0.6,0,0,0,0,0,0,0,,0,0,0,0,0,0,0,0,defense
ITA-Serie A,2021,Inter,Achraf Hakimi,MAR,DF,21,1998,29.6,53,32,23,19,11,23,48,47.9,25,31,1,30,22,75,23,1,defense
ITA-Serie A,2021,Inter,Aleksandar Kolarov,SRB,DF,34,1985,4.3,4,4,0,4,0,1,2,50.0,1,2,0,2,7,11,8,0,defense
ITA-Serie A,2021,Inter,Alessandro Bastoni,ITA,DF,21,1999,32.5,36,22,13,21,2,17,27,63.0,10,34,16,18,40,76,75,0,defense
ITA-Serie A,2021,Inter,Alexis Sánchez,CHI,FW,31,1988,12.7,14,8,4,4,6,5,18,27.8,13,11,0,11,7,21,1,1,defense
ITA-Serie A,2021,Inter,Andrea Pinamonti,ITA,FW,21,1999,1.9,0,0,0,0,0,0,0,,0,1,0,1,1,1,2,0,defense
ITA-Serie A,2021,Inter,Andrea Ranocchia,ITA,DF,32,1988,7.8,13,10,6,6,1,7,8,87.5,1,5,3,2,12,25,19,0,defense
ITA-Serie A,2021,Inter,Arturo Vidal,CHI,MF,33,1987,12.6,27,14,8,13,6,12,41,29.3,29,23,3,20,29,56,11,0,defense
ITA-Serie A,2021,Inter,Ashley Young,ENG,DF,35,1985,15.8,15,7,8,4,3,3,13,23.1,10,13,0,13,6,21,31,0,defense
ITA-Serie A,2021,Inter,Christian Eriksen,DEN,MF,28,1992,15.4,12,6,6,4,2,7,20,35.0,13,16,1,15,9,21,13,1,defense
ITA-Serie A,2021,Inter,Daniele Padelli,ITA,GK,34,1985,0.5,0,0,0,0,0,0,0,,0,0,0,0,0,0,0,0,defense
ITA-Serie A,2021,Inter,Danilo D'Ambrosio,ITA,DF,31,1988,7.8,15,9,6,7,2,6,15,40.0,9,9,7,2,4,19,15,0,defense
ITA-Serie A,2021,Inter,Ionuț Radu,ROU,GK,23,1997,1.5,0,0,0,0,0,0,0,,0,0,0,0,0,0,1,0,defense
ITA-Serie A,2021,Inter,Ivan Perišić,CRO,"DF,FW",31,1989,19.9,22,13,11,6,5,12,33,36.4,21,33,4,29,19,41,36,1,defense
ITA-Serie A,2021,Inter,Lautaro Martínez,ARG,FW,22,1997,28.5,25,12,5,11,9,7,24,29.2,17,31,1,30,27,52,16,0,defense
ITA-Serie A,2021,Inter,Marcelo Brozović,CRO,MF,27,1992,28.7,54,29,23,24,7,20,61,32.8,41,43,17,26,40,94,38,0,defense
ITA-Serie A,2021,Inter,Matteo Darmian,ITA,DF,30,1989,12.9,30,16,12,7,11,16,28,57.1,12,9,2,7,17,47,35,0,defense
ITA-Serie A,2021,Inter,Matías Vecino,URU,MF,28,1991,3.1,1,1,0,0,1,0,5,0.0,5,7,1,6,4,5,3,0,defense
ITA-Serie A,2021,Inter,Milan Škriniar,SVK,DF,25,1995,30.9,48,32,29,16,3,23,34,67.6,11,30,19,11,30,78,89,1,defense
ITA-Serie A,2021,Inter,Nicolò Barella,ITA,MF,23,1997,32.2,58,31,23,29,6,23,72,31.9,49,29,4,25,26,84,14,0,defense
ITA-Serie A,2021,Inter,Radja Nainggolan,BEL,MF,32,1988,0.5,0,0,0,0,0,0,0,,0,0,0,0,1,1,0,0,defense
ITA-Serie A,2021,Inter,Roberto Gagliardini,ITA,MF,26,1994,13.7,30,17,17,8,5,5,28,17.9,23,15,3,12,19,49,16,0,defense
ITA-Serie A,2021,Inter,Romelu Lukaku,BEL,FW,27,1993,32.0,11,1,1,6,4,6,14,42.9,8,11,1,10,3,14,34,0,defense
ITA-Serie A,2021,Inter,Samir Handanović,SVN,GK,36,1984,36.0,1,0,1,0,0,1,1,100.0,0,0,0,0,0,1,6,3,defense
ITA-Serie A,2021,Inter,Stefan de Vrij,NED,DF,28,1992,30.4,28,16,15,12,1,15,24,62.5,9,24,18,6,41,69,95,0,defense
ITA-Serie A,2021,Inter,Stefano Sensi,ITA,MF,24,1995,6.7,9,6,3,5,1,4,11,36.4,7,6,1,5,7,16,1,0,defense
ITA-Serie A,2021,Juventus,Aaron Ramsey,WAL,MF,29,1990,12.1,22,14,8,13,1,8,25,32.0,17,13,2,11,7,29,8,2,defense
ITA-Serie A,2021,Juventus,Adrien Rabiot,FRA,MF,25,1995,25.7,72,42,24,41,7,28,60,46.7,32,32,11,21,43,115,29,1,defense
ITA-Serie A,2021,Juventus,Alessandro Di Pardo,ITA,"FW,DF",21,1999,0.2,0,0,0,0,0,0,0,,0,1,1,0,0,0,0,0,defense
ITA-Serie A,2021,Juventus,Alex Sandro,BRA,DF,29,1991,20.6,37,23,19,13,5,13,25,52.0,12,20,4,16,31,68,57,0,defense
ITA-Serie A,2021,Juventus,Arthur Melo,BRA,MF,23,1996,12.9,17,9,7,10,0,12,31,38.7,19,6,1,5,18,35,9,1,defense
ITA-Serie A,2021,Juventus,Carlo Pinsoglio,ITA,GK,30,1990,0.3,0,0,0,0,0,0,0,,0,0,0,0,0,0,0,0,defense
ITA-Serie A,2021,Juventus,Cristiano Ronaldo,POR,FW,35,1985,31.1,6,3,1,3,2,3,15,20.0,12,11,3,8,5,11,15,1,defense
ITA-Serie A,2021,Juventus,Danilo,BRA,"DF,MF",29,1991,32.4,62,31,37,16,9,35,66,53.0,31,32,12,20,66,128,68,2,defense
ITA-Serie A,2021,Juventus,Dejan Kulusevski,SWE,"MF,FW",20,2000,21.4,33,19,12,10,11,14,43,32.6,29,22,0,22,9,42,2,1,defense
ITA-Serie A,2021,Juventus,Douglas Costa,BRA,"MF,FW",29,1990,0.5,1,0,1,0,0,1,3,33.3,2,0,0,0,0,1,0,0,defense
ITA-Serie A,2021,Juventus,Federico Bernardeschi,ITA,"MF,DF",26,1994,10.8,9,4,3,5,1,4,20,20.0,16,6,2,4,14,23,7,1,defense
ITA-Serie A,2021,Juventus,Federico Chiesa,ITA,"MF,DF",22,1997,24.6,47,26,21,14,12,19,50,38.0,31,23,1,22,12,59,16,0,defense
ITA-Serie A,2021,Juventus,Félix Correia,POR,MF,19,2001,0.1,0,0,0,0,0,0,0,,0,0,0,0,0,0,1,0,defense
ITA-Serie A,2021,Juventus,Giacomo Vrioni,ALB,FW,21,1998,0.0,0,0,0,0,0,0,0,,0,0,0,0,0,0,0,0,defense
ITA-Serie A,2021,Juventus,Gianluca Frabotta,ITA,"DF,MF",21,1999,7.7,7,4,5,0,2,5,12,41.7,7,9,1,8,14,21,15,0,defense
ITA-Serie A,2021,Juventus,Gianluigi Buffon,ITA,GK,42,1978,8.0,0,0,0,0,0,0,0,,0,0,0,0,0,0,3,1,defense
ITA-Serie A,2021,Juventus,Giorgio Chiellini,ITA,DF,35,1984,15.4,12,9,9,3,0,5,11,45.5,6,18,13,5,27,39,56,0,defense
ITA-Serie A,2021,Juventus,Juan Cuadrado,COL,"DF,MF",32,1988,24.2,43,25,22,15,6,29,60,48.3,31,16,2,14,43,86,22,2,defense
ITA-Serie A,2021,Juventus,Leonardo Bonucci,ITA,DF,33,1987,22.5,19,14,10,8,1,6,14,42.9,8,24,13,11,33,52,67,0,defense
ITA-Serie A,2021,Juventus,Manolo Portanova,ITA,MF,20,2000,0.8,2,0,2,0,0,0,2,0.0,2,4,1,3,0,2,1,0,defense
ITA-Serie A,2021,Juventus,Matthijs de Ligt,NED,DF,20,1999,24.7,37,19,20,16,1,18,28,64.3,10,42,21,21,31,68,64,0,defense
ITA-Serie A,2021,Juventus,Mattia De Sciglio,ITA,DF,27,1992,0.3,0,0,0,0,0,0,0,,0,0,0,0,0,0,1,0,defense
ITA-Serie A,2021,Juventus,Merih Demiral,TUR,DF,22,1998,10.4,12,9,8,4,0,5,13,38.5,8,16,9,7,21,33,40,0,defense
ITA-Serie A,2021,Juventus,Nicolò Fagioli,ITA,MF,19,2001,0.2,0,0,0,0,0,0,0,,0,0,0,0,0,0,1,0,defense
ITA-Serie A,2021,Juventus,Paulo Dybala,ARG,FW,26,1993,12.6,14,8,3,4,7,2,14,14.3,12,15,0,15,1,15,1,0,defense
ITA-Serie A,2021,Juventus,Radu Drăgușin,ROU,DF,18,2002,0.0,0,0,0,0,0,0,0,,0,0,0,0,0,0,0,0,defense
ITA-Serie A,2021,Juventus,Rodrigo Bentancur,URU,MF,23,1997,25.8,63,33,21,37,5,20,59,33.9,39,35,12,23,47,110,46,1,defense
ITA-Serie A,2021,Juventus,Weston McKennie,USA,MF,21,1998,18.9,34,19,9,20,5,12,33,36.4,21,21,3,18,28,62,26,0,defense
ITA-Serie A,2021,Juventus,Wojciech Szczęsny,POL,GK,30,1990,29.7,0,0,0,0,0,0,0,,0,2,0,2,3,3,5,1,defense
ITA-Serie A,2021,Juventus,Álvaro Morata,ESP,FW,27,1992,22.4,17,12,2,10,5,4,28,14.3,24,22,2,20,5,22,21,0,defense
ITA-Serie A,2021,Lazio,Adam Marušić,MNE,DF,27,1992,33.0,38,22,22,15,1,20,40,50.0,20,38,6,32,40,78,54,0,defense
ITA-Serie A,2021,Lazio,Andreas Pereira,BRA,"FW,MF",24,1996,6.0,5,0,1,3,1,2,12,16.7,10,6,0,6,1,6,4,0,defense
ITA-Serie A,2021,Lazio,Bastos,ANG,DF,29,1991,0.7,3,1,2,0,1,3,5,60.0,2,1,0,1,0,3,3,0,defense
ITA-Serie A,2021,Lazio,Ciro Immobile,ITA,FW,30,1990,31.7,14,13,4,6,4,7,22,31.8,15,13,1,12,6,20,9,0,defense
ITA-Serie A,2021,Lazio,Danilo Cataldi,ITA,MF,25,1994,6.3,7,2,1,5,1,4,18,22.2,14,3,1,2,9,16,7,0,defense
ITA-Serie A,2021,Lazio,Denis Vavro,SVK,DF,24,1996,0.4,0,0,0,0,0,0,1,0.0,1,0,0,0,1,1,3,0,defense
ITA-Serie A,2021,Lazio,Djavan Anderson,NED,DF,25,1995,0.8,0,0,0,0,0,0,1,0.0,1,1,0,1,1,1,0,0,defense
ITA-Serie A,2021,Lazio,Felipe Caicedo,ECU,FW,31,1988,10.3,10,7,4,4,2,1,8,12.5,7,7,0,7,4,14,2,0,defense
ITA-Serie A,2021,Lazio,Francesco Acerbi,ITA,DF,32,1988,31.3,51,32,34,13,4,18,40,45.0,22,24,15,9,76,127,121,2,defense
ITA-Serie A,2021,Lazio,Gonzalo Escalante,ARG,MF,27,1993,8.1,26,13,11,14,1,8,28,28.6,20,10,3,7,19,45,13,0,defense
ITA-Serie A,2021,Lazio,Jean-Daniel Akpa-Akpro,CIV,MF,27,1992,11.7,38,25,13,22,3,8,27,29.6,19,24,6,18,18,56,13,0,defense
ITA-Serie A,2021,Lazio,Joaquín Correa,ARG,FW,25,1994,21.5,21,12,6,11,4,7,25,28.0,18,14,0,14,7,28,12,0,defense
ITA-Serie A,2021,Lazio,Lucas Leiva,BRA,MF,33,1987,23.7,68,32,38,28,2,30,86,34.9,56,21,0,21,57,125,21,0,defense
ITA-Serie A,2021,Lazio,Luis Alberto,ESP,MF,27,1992,29.1,43,24,15,19,9,15,73,20.5,58,41,2,39,13,56,11,1,defense
ITA-Serie A,2021,Lazio,Luiz Felipe,ITA,DF,23,1997,10.1,32,20,19,11,2,16,24,66.7,8,20,9,11,21,53,29,1,defense
ITA-Serie A,2021,Lazio,Manuel Lazzari,ITA,DF,26,1993,29.0,24,14,15,4,5,14,39,35.9,25,22,3,19,18,42,28,0,defense
ITA-Serie A,2021,Lazio,Marco Bertini,ITA,MF,17,2002,0.1,1,0,1,0,0,0,0,,0,0,0,0,0,1,0,0,defense
ITA-Serie A,2021,Lazio,Marco Parolo,ITA,"DF,MF",35,1985,7.3,21,8,8,11,2,8,20,40.0,12,20,6,14,14,35,31,0,defense
ITA-Serie A,2021,Lazio,Mateo Musacchio,ARG,DF,29,1990,2.5,1,1,1,0,0,0,0,,0,5,2,3,2,3,5,0,defense
ITA-Serie A,2021,Lazio,Mohamed Fares,ALG,DF,24,1996,12.7,20,15,9,7,4,11,19,57.9,8,14,1,13,16,36,21,0,defense
ITA-Serie A,2021,Lazio,Nicolò Armini,ITA,DF,19,2001,0.1,0,0,0,0,0,0,0,,0,0,0,0,0,0,0,0,defense
ITA-Serie A,2021,Lazio,Patric,ESP,DF,27,1993,17.7,30,16,15,11,4,13,24,54.2,11,13,3,10,18,48,51,1,defense
ITA-Serie A,2021,Lazio,Pepe Reina,ESP,GK,37,1982,29.0,0,0,0,0,0,0,1,0.0,1,0,0,0,1,1,6,0,defense
ITA-Serie A,2021,Lazio,Raúl Moro,ESP,FW,17,2002,0.1,0,0,0,0,0,0,1,0.0,1,0,0,0,0,0,0,0,defense
ITA-Serie A,2021,Lazio,Senad Lulić,BIH,DF,34,1986,8.0,14,7,6,5,3,7,15,46.7,8,10,1,9,4,18,13,0,defense
ITA-Serie A,2021,Lazio,Sergej Milinković-Savić,SRB,MF,25,1995,30.5,59,40,20,30,9,27,84,32.1,57,52,12,40,33,92,47,0,defense
ITA-Serie A,2021,Lazio,Thomas Strakosha,ALB,GK,25,1995,9.0,1,1,1,0,0,0,0,,0,0,0,0,1,2,4,0,defense
ITA-Serie A,2021,Lazio,Vedat Muriqi,KVX,FW,26,1994,9.2,3,1,0,2,1,0,8,0.0,8,9,2,7,3,6,20,0,defense
ITA-Serie A,2021,Lazio,Wesley Hoedt,NED,DF,26,1994,10.6,22,16,18,4,0,10,17,58.8,7,9,5,4,17,39,48,1,defense
ITA-Serie A,2021,Lazio,Ștefan Radu,ROU,DF,33,1986,27.3,43,24,20,19,4,25,40,62.5,15,27,14,13,45,88,73,1,defense
ITA-Serie A,2021,Milan,Alessio Romagnoli,ITA,DF,25,1995,21.2,17,7,8,7,2,8,19,42.1,11,29,22,7,24,41,80,0,defense
ITA-Serie A,2021,Milan,Alexis Saelemaekers,BEL,FW,21,1999,22.4,43,26,20,18,5,19,60,31.7,41,29,1,28,25,68,6,0,defense
ITA-Serie A,2021,Milan,Andrea Conti,ITA,DF,26,1994,0.3,1,1,1,0,0,0,1,0.0,1,0,0,0,1,2,0,0,defense
ITA-Serie A,2021,Milan,Ante Rebić,CRO,FW,26,1993,19.7,26,9,4,8,14,8,37,21.6,29,21,1,20,7,33,17,0,defense
ITA-Serie A,2021,Milan,Brahim Díaz,MAR,"MF,FW",20,1999,13.6,18,10,7,7,4,10,23,43.5,13,10,0,10,2,20,2,0,defense
ITA-Serie A,2021,Milan,Ciprian Tătărușanu,ROU,GK,34,1986,1.0,0,0,0,0,0,0,0,,0,0,0,0,0,0,0,1,defense
ITA-Serie A,2021,Milan,Daniel Maldini,ITA,"FW,DF",18,2001,0.3,1,0,0,1,0,0,2,0.0,2,0,0,0,0,1,0,0,defense
ITA-Serie A,2021,Milan,Davide Calabria,ITA,DF,23,1996,29.4,101,64,61,32,8,54,90,60.0,36,42,9,33,37,138,82,1,defense
ITA-Serie A,2021,Milan,Diogo Dalot,POR,DF,21,1999,12.1,32,17,23,6,3,17,34,50.0,17,18,5,13,25,57,42,0,defense
ITA-Serie A,2021,Milan,Fikayo Tomori,ENG,DF,22,1997,16.3,28,18,17,9,2,8,14,57.1,6,32,20,12,18,46,61,1,defense
ITA-Serie A,2021,Milan,Franck Kessié,CIV,MF,23,1996,35.8,53,30,28,19,6,20,38,52.6,18,47,15,32,46,99,51,0,defense
ITA-Serie A,2021,Milan,Gianluigi Donnarumma,ITA,GK,21,1999,37.0,0,0,0,0,0,0,1,0.0,1,1,0,1,1,1,23,2,defense
ITA-Serie A,2021,Milan,Hakan Çalhanoğlu,TUR,"MF,FW",26,1994,29.0,26,7,3,17,6,7,28,25.0,21,21,6,15,15,41,24,1,defense
ITA-Serie A,2021,Milan,Ismaël Bennacer,ALG,MF,22,1997,14.7,39,18,17,21,1,15,32,46.9,17,10,1,9,20,59,12,0,defense
ITA-Serie A,2021,Milan,Jens Petter Hauge,NOR,FW,20,1999,5.9,7,4,3,3,1,6,10,60.0,4,4,0,4,1,8,3,0,defense
ITA-Serie A,2021,Milan,Lorenzo Colombo,ITA,FW,18,2002,1.0,2,1,1,1,0,0,3,0.0,3,0,0,0,0,2,3,0,defense
ITA-Serie A,2021,Milan,Léo Duarte,BRA,DF,24,1996,0.2,1,1,0,1,0,0,0,,0,0,0,0,1,2,0,0,defense
ITA-Serie A,2021,Milan,Mario Mandžukić,CRO,FW,34,1986,2.4,7,6,2,4,1,2,3,66.7,1,0,0,0,2,9,3,0,defense
ITA-Serie A,2021,Milan,Mateo Musacchio,ARG,DF,29,1990,0.4,2,1,2,0,0,2,3,66.7,1,1,0,1,3,5,0,0,defense
ITA-Serie A,2021,Milan,Matteo Gabbia,ITA,DF,20,1999,6.2,9,5,3,6,0,2,2,100.0,0,8,6,2,3,12,21,0,defense
ITA-Serie A,2021,Milan,Pierre Kalulu,FRA,DF,20,2000,8.1,18,14,11,6,1,10,14,71.4,4,9,3,6,19,37,20,0,defense
ITA-Serie A,2021,Milan,Rade Krunić,BIH,"MF,FW",26,1993,8.0,15,12,6,6,3,7,17,41.2,10,12,2,10,10,25,9,0,defense
ITA-Serie A,2021,Milan,Rafael Leão,POR,FW,21,1999,21.4,13,6,4,7,2,6,15,40.0,9,17,0,17,4,17,14,1,defense
ITA-Serie A,2021,Milan,Samu Castillejo,ESP,FW,25,1995,13.1,24,12,9,14,1,14,40,35.0,26,21,0,21,6,30,9,0,defense
ITA-Serie A,2021,Milan,Sandro Tonali,ITA,MF,20,2000,14.8,28,19,14,13,1,13,28,46.4,15,18,5,13,22,50,18,0,defense
ITA-Serie A,2021,Milan,Simon Kjær,DEN,DF,31,1989,26.6,45,26,23,20,2,18,30,60.0,12,42,26,16,42,87,125,0,defense
ITA-Serie A,2021,Milan,Soualiho Meïté,FRA,MF,26,1994,6.5,18,10,10,6,2,8,17,47.1,9,9,2,7,8,26,16,0,defense
ITA-Serie A,2021,Milan,Theo Hernández,FRA,DF,22,1997,32.6,48,29,22,21,5,19,38,50.0,19,29,6,23,34,82,64,5,defense
ITA-Serie A,2021,Milan,Zlatan Ibrahimović,SWE,FW,38,1981,16.6,5,4,0,4,1,3,6,50.0,3,5,3,2,6,11,27,1,defense
ITA-Serie A,2021,Napoli,Alex Meret,ITA,GK,23,1997,22.0,0,0,0,0,0,0,1,0.0,1,0,0,0,0,0,5,0,defense
ITA-Serie A,2021,Napoli,Amir Rrahmani,KVX,DF,26,1994,12.2,13,8,7,6,0,6,9,66.7,3,17,14,3,8,21,39,1,defense
ITA-Serie A,2021,Napoli,Andrea Petagna,ITA,FW,25,1995,10.7,2,0,0,2,0,2,7,28.6,5,4,0,4,1,3,7,0,defense
ITA-Serie A,2021,Napoli,Antonio Cioffi,ITA,FW,17,2002,0.1,0,0,0,0,0,0,0,,0,1,0,1,1,1,0,0,defense
ITA-Serie A,2021,Napoli,David Ospina,COL,GK,31,1988,16.0,0,0,0,0,0,0,0,,0,0,0,0,0,0,4,0,defense
ITA-Serie A,2021,Napoli,Diego Demme,GER,MF,28,1991,17.7,56,32,26,22,8,23,63,36.5,40,14,1,13,11,67,15,1,defense
ITA-Serie A,2021,Napoli,Dries Mertens,BEL,"FW,MF",33,1987,16.2,16,14,4,7,5,5,25,20.0,20,7,1,6,9,25,3,1,defense
ITA-Serie A,2021,Napoli,Elif Elmas,MKD,"MF,FW",20,1999,8.2,15,4,3,6,6,7,12,58.3,5,11,1,10,2,17,10,0,defense
ITA-Serie A,2021,Napoli,Elseid Hysaj,ALB,DF,26,1994,19.6,29,17,16,11,2,17,33,51.5,16,18,4,14,30,59,52,0,defense
ITA-Serie A,2021,Napoli,Fabián Ruiz Peña,ESP,MF,24,1996,28.5,58,31,26,21,11,25,70,35.7,45,33,3,30,36,94,32,1,defense
ITA-Serie A,2021,Napoli,Faouzi Ghoulam,ALG,"DF,FW",29,1991,3.2,6,5,3,2,1,0,1,0.0,1,4,2,2,3,9,1,0,defense
ITA-Serie A,2021,Napoli,Fernando Llorente,ESP,"FW,MF",35,1985,0.6,0,0,0,0,0,0,0,,0,0,0,0,0,0,0,0,defense
ITA-Serie A,2021,Napoli,Giovanni Di Lorenzo,ITA,DF,26,1993,36.0,79,50,54,21,4,43,75,57.3,32,37,13,24,35,114,64,1,defense
ITA-Serie A,2021,Napoli,Hirving Lozano,MEX,FW,25,1995,21.8,29,18,10,13,6,10,36,27.8,26,37,1,36,18,47,14,0,defense
ITA-Serie A,2021,Napoli,Kalidou Koulibaly,SEN,DF,29,1991,24.5,36,24,25,7,4,19,32,59.4,13,46,26,20,29,65,64,2,defense
ITA-Serie A,2021,Napoli,Kostas Manolas,GRE,DF,29,1991,25.5,31,18,24,7,0,17,24,70.8,7,22,13,9,23,54,82,2,defense
ITA-Serie A,2021,Napoli,Kévin Malcuit,MAR,"FW,MF",29,1991,0.4,2,1,2,0,0,0,1,0.0,1,0,0,0,2,4,2,0,defense
ITA-Serie A,2021,Napoli,Lorenzo Insigne,ITA,FW,29,1991,31.8,26,18,8,12,6,13,72,18.1,59,30,1,29,37,63,6,1,defense
ITA-Serie A,2021,Napoli,Matteo Politano,ITA,"FW,MF",26,1993,21.2,24,16,13,9,2,11,47,23.4,36,14,1,13,14,38,18,0,defense
ITA-Serie A,2021,Napoli,Mário Rui,POR,DF,29,1991,18.5,24,13,17,6,1,17,33,51.5,16,17,4,13,28,52,29,1,defense
ITA-Serie A,2021,Napoli,Nikola Maksimović,SRB,DF,28,1991,13.4,18,9,11,6,1,9,18,50.0,9,15,6,9,21,39,49,3,defense
ITA-Serie A,2021,Napoli,Piotr Zieliński,POL,MF,26,1994,28.0,18,10,8,7,3,7,20,35.0,13,23,4,19,18,36,12,0,defense
ITA-Serie A,2021,Napoli,Stanislav Lobotka,SVK,MF,25,1994,1.7,1,1,0,1,0,0,1,0.0,1,1,1,0,0,1,1,1,defense
ITA-Serie A,2021,Napoli,Tiemoué Bakayoko,FRA,MF,25,1994,21.8,69,41,21,41,7,23,40,57.5,17,24,2,22,36,105,13,2,defense
ITA-Serie A,2021,Napoli,Victor Osimhen,NGA,FW,21,1998,17.5,22,15,2,6,14,3,15,20.0,12,6,0,6,7,29,10,0,defense
ITA-Serie A,2021,Parma,Alberto Grassi,ITA,"MF,DF",25,1995,13.1,30,11,14,13,3,8,29,27.6,21,22,9,13,26,56,32,0,defense
ITA-Serie A,2021,Parma,Andrea Adorante,ITA,FW,20,2000,0.1,0,0,0,0,0,0,0,,0,0,0,0,0,0,0,0,defense
ITA-Serie A,2021,Parma,Andrea Conti,ITA,DF,26,1994,9.0,21,10,16,4,1,13,26,50.0,13,13,4,9,16,37,23,0,defense
ITA-Serie A,2021,Parma,Andreas Cornelius,DEN,FW,27,1993,21.1,11,4,1,5,5,2,12,16.7,10,9,2,7,1,12,25,1,defense
ITA-Serie A,2021,Parma,Botond Balogh,HUN,DF,18,2002,1.8,9,7,9,0,0,2,5,40.0,3,4,3,1,2,11,8,0,defense
ITA-Serie A,2021,Parma,Bruno Alves,POR,DF,38,1981,18.1,13,10,10,3,0,7,9,77.8,2,17,12,5,26,39,81,0,defense
ITA-Serie A,2021,Parma,Chaka Traorè,CIV,"FW,DF",15,2004,0.2,0,0,0,0,0,0,0,,0,0,0,0,0,0,1,1,defense
ITA-Serie A,2021,Parma,Daan Dierckx,BEL,DF,17,2003,5.2,5,4,5,0,0,3,5,60.0,2,10,6,4,13,18,21,0,defense
ITA-Serie A,2021,Parma,Dennis Man,ROU,"FW,MF",21,1998,7.8,12,6,6,4,2,6,21,28.6,15,5,0,5,2,14,6,0,defense
ITA-Serie A,2021,Parma,Drissa Camara,CIV,MF,18,2002,0.2,0,0,0,0,0,0,0,,0,0,0,0,0,0,0,0,defense
ITA-Serie A,2021,Parma,Gastón Brugman,URU,MF,27,1992,18.0,35,19,18,15,2,11,44,25.0,33,33,4,29,45,80,34,0,defense
ITA-Serie A,2021,Parma,Gervinho,CIV,FW,33,1987,22.5,5,1,2,2,1,1,14,7.1,13,11,1,10,10,15,3,0,defense
ITA-Serie A,2021,Parma,Giacomo Ricci,ITA,DF,23,1996,0.7,3,1,1,2,0,0,0,,0,2,2,0,1,4,4,0,defense
ITA-Serie A,2021,Parma,Giuseppe Pezzella,ITA,DF,22,1997,20.3,34,19,23,9,2,22,41,53.7,19,22,9,13,12,46,52,3,defense
ITA-Serie A,2021,Parma,Graziano Pellè,ITA,FW,35,1985,6.8,2,2,0,1,1,1,8,12.5,7,3,0,3,2,4,8,0,defense
ITA-Serie A,2021,Parma,Hernani,BRA,MF,26,1994,24.3,51,25,21,27,3,29,66,43.9,37,35,4,31,31,82,40,1,defense
ITA-Serie A,2021,Parma,Jacopo Dezi,ITA,"FW,MF",28,1992,0.9,4,3,0,2,2,3,6,50.0,3,2,0,2,0,4,0,0,defense
ITA-Serie A,2021,Parma,Jasmin Kurtić,SVN,MF,31,1989,30.4,46,28,22,21,3,21,70,30.0,49,22,2,20,33,79,57,1,defense
ITA-Serie A,2021,Parma,Joshua Zirkzee,NED,"FW,MF",19,2001,1.3,2,2,1,1,0,1,3,33.3,2,1,1,0,0,2,1,0,defense
ITA-Serie A,2021,Parma,Juan Brunetta,ARG,"FW,MF",23,1997,5.3,2,2,0,2,0,1,6,16.7,5,5,0,5,1,3,2,0,defense
ITA-Serie A,2021,Parma,Juraj Kucka,SVK,"MF,FW",33,1987,25.9,67,36,21,37,9,26,74,35.1,48,25,3,22,28,95,25,0,defense
ITA-Serie A,2021,Parma,Kastriot Dermaku,ALB,DF,28,1992,1.1,1,1,1,0,0,0,0,,0,2,1,1,2,3,8,0,defense
ITA-Serie A,2021,Parma,Lautaro Valenti,ARG,DF,21,1999,5.5,10,4,7,2,1,6,15,40.0,9,11,3,8,11,21,30,0,defense
ITA-Serie A,2021,Parma,Luca Siligardi,ITA,"FW,MF",32,1988,0.4,0,0,0,0,0,0,2,0.0,2,0,0,0,0,0,0,0,defense
ITA-Serie A,2021,Parma,Luigi Sepe,ITA,GK,29,1991,36.0,0,0,0,0,0,0,2,0.0,2,0,0,0,2,2,13,2,defense
ITA-Serie A,2021,Parma,Matteo Darmian,ITA,DF,30,1989,2.3,6,5,3,3,0,4,7,57.1,3,2,0,2,6,12,7,0,defense
ITA-Serie A,2021,Parma,Matteo Scozzarella,ITA,MF,32,1988,1.7,4,0,3,1,0,2,3,66.7,1,3,1,2,6,10,0,0,defense
ITA-Serie A,2021,Parma,Mattia Bani,ITA,DF,26,1993,12.7,20,11,15,4,1,4,8,50.0,4,10,6,4,33,53,50,0,defense
ITA-Serie A,2021,Parma,Mattia Sprocati,ITA,"MF,FW",27,1993,0.2,1,0,0,1,0,1,1,100.0,0,0,0,0,1,2,0,0,defense
ITA-Serie A,2021,Parma,Maxime Busi,BEL,DF,20,1999,13.3,23,13,19,3,1,11,28,39.3,17,14,1,13,16,39,32,0,defense
ITA-Serie A,2021,Parma,Márk Kosznovszky,HUN,MF,18,2002,1.0,2,2,1,1,0,1,4,25.0,3,2,0,2,1,3,1,0,defense
ITA-Serie A,2021,Parma,Riccardo Gagliolo,SWE,DF,30,1990,21.7,45,18,35,8,2,28,45,62.2,17,34,7,27,36,81,64,1,defense
ITA-Serie A,2021,Parma,Roberto Inglese,ITA,FW,28,1991,6.4,5,2,1,2,2,2,11,18.2,9,10,0,10,0,5,3,0,defense
ITA-Serie A,2021,Parma,Simon Sohm,SUI,MF,19,2001,10.0,18,12,11,6,1,11,26,42.3,15,8,0,8,5,23,7,0,defense
ITA-Serie A,2021,Parma,Simone Colombi,ITA,GK,29,1991,2.0,0,0,0,0,0,0,0,,0,0,0,0,0,0,2,0,defense
ITA-Serie A,2021,Parma,Simone Iacoponi,ITA,DF,33,1987,13.3,22,12,16,5,1,13,26,50.0,13,9,4,5,11,33,42,1,defense
ITA-Serie A,2021,Parma,Valentin Mihaila,ROU,"FW,MF",20,2000,7.8,2,1,1,1,0,0,10,0.0,10,8,1,7,5,7,8,0,defense
ITA-Serie A,2021,Parma,Vasilios Zagaritis,GRE,DF,19,2001,0.7,0,0,0,0,0,0,0,,0,1,0,1,0,0,0,0,defense
ITA-Serie A,2021,Parma,Vincent Laurini,FRA,DF,31,1989,9.7,16,11,8,6,2,7,9,77.8,2,8,4,4,17,33,22,1,defense
ITA-Serie A,2021,Parma,Wylan Cyprien,FRA,MF,25,1995,4.6,9,4,5,3,1,2,4,50.0,2,13,8,5,5,14,6,1,defense
ITA-Serie A,2021,Parma,Yann Karamoh,FRA,"FW,MF",22,1998,14.4,27,17,8,12,7,11,31,35.5,20,6,0,6,4,31,11,0,defense
ITA-Serie A,2021,Parma,Yordan Osorio,VEN,DF,26,1994,20.1,22,14,13,9,0,9,24,37.5,15,30,18,12,53,75,77,1,defense
ITA-Serie A,2021,Roma,Amadou Diawara,GUI,MF,23,1997,7.3,10,8,4,6,0,2,8,25.0,6,11,2,9,12,22,4,0,defense
ITA-Serie A,2021,Roma,Antonio Mirante,ITA,GK,37,1983,12.8,0,0,0,0,0,0,1,0.0,1,1,0,1,0,0,7,2,defense
ITA-Serie A,2021,Roma,Borja Mayoral,ESP,FW,23,1997,17.2,3,2,0,0,3,1,10,10.0,9,5,0,5,0,3,5,2,defense
ITA-Serie A,2021,Roma,Bruno Peres,BRA,DF,30,1990,15.9,21,11,11,7,3,13,24,54.2,11,18,4,14,27,48,11,0,defense
ITA-Serie A,2021,Roma,Bryan Cristante,ITA,"DF,MF",25,1995,23.9,27,20,10,14,3,10,28,35.7,18,21,7,14,40,67,61,1,defense
ITA-Serie A,2021,Roma,Bryan Reynolds,USA,DF,19,2001,3.1,4,2,1,1,2,1,5,20.0,4,4,0,4,6,10,4,0,defense
ITA-Serie A,2021,Roma,Carles Pérez,ESP,"MF,FW",22,1998,8.6,9,4,3,6,0,6,31,19.4,25,9,0,9,6,15,1,0,defense
ITA-Serie A,2021,Roma,Chris Smalling,ENG,DF,30,1989,12.3,14,8,5,7,2,6,10,60.0,4,17,11,6,28,42,46,1,defense
ITA-Serie A,2021,Roma,Daniel Fuzato,BRA,GK,23,1997,5.0,0,0,0,0,0,0,0,,0,1,0,1,0,0,1,1,defense
ITA-Serie A,2021,Roma,Davide Santon,ITA,DF,29,1991,6.5,4,3,2,2,0,3,7,42.9,4,10,1,9,4,8,12,0,defense
ITA-Serie A,2021,Roma,Ebrima Darboe,GAM,MF,19,2001,3.6,5,2,3,1,1,3,10,30.0,7,3,0,3,8,13,0,1,defense
ITA-Serie A,2021,Roma,Edin Džeko,BIH,FW,34,1986,20.3,8,6,2,3,3,3,9,33.3,6,9,4,5,1,9,11,0,defense
ITA-Serie A,2021,Roma,Edoardo Bove,ITA,MF,18,2002,0.1,0,0,0,0,0,0,1,0.0,1,0,0,0,0,0,0,0,defense
ITA-Serie A,2021,Roma,Federico Fazio,ARG,DF,33,1987,4.5,3,2,3,0,0,3,4,75.0,1,3,3,0,7,10,18,1,defense
ITA-Serie A,2021,Roma,Gianluca Mancini,ITA,DF,24,1996,31.7,50,29,29,19,2,18,31,58.1,13,38,18,20,72,122,77,3,defense
ITA-Serie A,2021,Roma,Gonzalo Villar,ESP,MF,22,1998,20.7,44,18,14,24,6,18,61,29.5,43,25,3,22,22,66,14,1,defense
ITA-Serie A,2021,Roma,Henrikh Mkhitaryan,ARM,"MF,FW",31,1989,30.5,58,24,13,27,18,13,62,21.0,49,34,0,34,39,97,10,0,defense
ITA-Serie A,2021,Roma,Javier Pastore,ARG,"MF,FW",31,1989,0.9,2,2,2,0,0,2,2,100.0,0,0,0,0,0,2,0,0,defense
ITA-Serie A,2021,Roma,Jordan Veretout,FRA,MF,27,1993,22.8,20,12,8,12,0,9,33,27.3,24,14,3,11,14,34,21,3,defense
ITA-Serie A,2021,Roma,Juan Jesus,BRA,DF,29,1991,1.7,3,1,2,1,0,2,4,50.0,2,1,0,1,2,5,5,0,defense
ITA-Serie A,2021,Roma,Justin Kluivert,NED,MF,21,1999,0.2,0,0,0,0,0,0,0,,0,0,0,0,0,0,0,0,defense
ITA-Serie A,2021,Roma,Leonardo Spinazzola,ITA,DF,27,1993,23.6,12,6,3,9,0,8,20,40.0,12,16,1,15,25,37,31,0,defense
ITA-Serie A,2021,Roma,Lorenzo Pellegrini,ITA,MF,24,1996,28.9,40,24,13,20,7,21,60,35.0,39,37,2,35,42,82,23,1,defense
ITA-Serie A,2021,Roma,Marash Kumbulla,ALB,DF,20,2000,15.1,16,11,8,7,1,5,17,29.4,12,12,5,7,24,40,38,1,defense
ITA-Serie A,2021,Roma,Nicola Zalewski,POL,MF,18,2002,0.1,1,1,0,1,0,1,1,100.0,0,0,0,0,0,1,0,0,defense
ITA-Serie A,2021,Roma,Pau López,ESP,GK,25,1994,20.2,2,0,2,0,0,2,2,100.0,0,1,0,1,0,2,7,4,defense
ITA-Serie A,2021,Roma,Pedro,ESP,"MF,FW",33,1987,17.7,22,14,6,11,5,7,35,20.0,28,10,0,10,9,31,2,1,defense
ITA-Serie A,2021,Roma,Riccardo Calafiori,ITA,DF,18,2002,0.7,1,0,1,0,0,1,4,25.0,3,1,0,1,0,1,0,0,defense
ITA-Serie A,2021,Roma,Rick Karsdorp,NED,DF,25,1995,28.3,36,23,19,12,5,21,48,43.8,27,18,1,17,30,66,32,0,defense
ITA-Serie A,2021,Roma,Roger Ibanez,BRA,DF,21,1998,26.6,59,37,28,25,6,25,45,55.6,20,38,17,21,68,127,78,3,defense
ITA-Serie A,2021,Roma,Stephan El Shaarawy,ITA,"MF,FW",27,1992,6.4,4,3,0,3,1,2,9,22.2,7,3,1,2,3,7,2,0,defense
ITA-Serie A,2021,Sampdoria,Adrien Silva,POR,MF,31,1989,17.8,49,22,21,22,6,18,54,33.3,36,34,1,33,30,79,10,1,defense
ITA-Serie A,2021,Sampdoria,Albin Ekdal,SWE,MF,31,1989,25.5,56,29,21,32,3,23,65,35.4,42,31,12,19,49,105,35,0,defense
ITA-Serie A,2021,Sampdoria,Alex Ferrari,ITA,DF,26,1994,9.8,27,15,16,9,2,15,24,62.5,9,18,6,12,23,50,26,0,defense
ITA-Serie A,2021,Sampdoria,Antonino La Gumina,ITA,FW,24,1996,3.8,3,2,0,1,2,0,3,0.0,3,5,1,4,3,6,5,0,defense
ITA-Serie A,2021,Sampdoria,Antonio Candreva,ITA,MF,33,1987,27.8,28,19,17,9,2,21,53,39.6,32,24,3,21,9,37,27,1,defense
ITA-Serie A,2021,Sampdoria,Antonio Palumbo,ITA,MF,23,1996,0.1,0,0,0,0,0,0,1,0.0,1,0,0,0,0,0,0,0,defense
ITA-Serie A,2021,Sampdoria,Bartosz Bereszyński,POL,DF,28,1992,29.0,66,44,37,22,7,41,73,56.2,32,40,20,20,42,108,88,0,defense
ITA-Serie A,2021,Sampdoria,Emil Audero,IDN,GK,23,1997,37.0,1,1,1,0,0,1,2,50.0,1,0,0,0,1,2,16,0,defense
ITA-Serie A,2021,Sampdoria,Ernesto Torregrossa,VEN,FW,28,1992,1.9,1,1,0,0,1,0,2,0.0,2,4,0,4,1,2,1,0,defense
ITA-Serie A,2021,Sampdoria,Fabio Depaoli,ITA,MF,23,1997,0.9,1,0,0,1,0,0,2,0.0,2,0,0,0,1,2,1,0,defense
ITA-Serie A,2021,Sampdoria,Fabio Quagliarella,ITA,FW,37,1983,24.5,12,8,4,4,4,2,19,10.5,17,14,1,13,7,19,10,0,defense
ITA-Serie A,2021,Sampdoria,Federico Bonazzoli,ITA,FW,23,1997,1.5,0,0,0,0,0,0,0,,0,1,0,1,0,0,0,0,defense
ITA-Serie A,2021,Sampdoria,Gastón Ramírez,URU,"FW,MF",29,1990,10.8,31,15,10,17,4,8,27,29.6,19,19,3,16,4,35,13,0,defense
ITA-Serie A,2021,Sampdoria,Jakub Jankto,CZE,MF,24,1996,26.8,28,17,14,7,7,11,35,31.4,24,16,1,15,24,52,34,0,defense
ITA-Serie A,2021,Sampdoria,Karlo Letica,CRO,GK,23,1997,1.0,0,0,0,0,0,0,0,,0,0,0,0,0,0,2,0,defense
ITA-Serie A,2021,Sampdoria,Keita Baldé,SEN,FW,25,1995,13.3,9,6,2,6,1,4,10,40.0,6,10,1,9,0,9,3,0,defense
ITA-Serie A,2021,Sampdoria,Kristoffer Askildsen,NOR,MF,19,2001,1.1,0,0,0,0,0,0,0,,0,2,0,2,3,3,3,0,defense
ITA-Serie A,2021,Sampdoria,Lorenzo Tonelli,ITA,DF,30,1990,19.8,33,18,20,11,2,10,21,47.6,11,21,14,7,25,58,94,1,defense
ITA-Serie A,2021,Sampdoria,Manolo Gabbiadini,ITA,FW,28,1991,9.7,2,2,0,2,0,0,1,0.0,1,3,1,2,3,5,5,0,defense
ITA-Serie A,2021,Sampdoria,Maya Yoshida,JPN,DF,31,1988,25.3,17,4,10,7,0,7,13,53.8,6,45,34,11,57,74,93,1,defense
ITA-Serie A,2021,Sampdoria,Mehdi Léris,ALG,"DF,MF",22,1998,4.3,11,5,6,4,1,6,16,37.5,10,12,2,10,12,23,15,0,defense
ITA-Serie A,2021,Sampdoria,Mikkel Damsgaard,DEN,"MF,FW",20,2000,19.7,42,21,14,20,8,22,70,31.4,48,40,4,36,24,66,17,0,defense
ITA-Serie A,2021,Sampdoria,Morten Thorsby,NOR,MF,24,1996,29.4,76,42,32,36,8,20,60,33.3,40,51,16,35,25,101,30,0,defense
ITA-Serie A,2021,Sampdoria,Omar Colley,GAM,DF,27,1992,28.8,28,16,19,8,1,13,23,56.5,10,43,29,14,68,96,133,1,defense
ITA-Serie A,2021,Sampdoria,Tommaso Augello,ITA,DF,25,1994,35.7,42,30,27,10,5,23,39,59.0,16,22,2,20,32,74,76,1,defense
ITA-Serie A,2021,Sampdoria,Valerio Verre,ITA,"FW,MF",26,1994,11.1,11,7,2,7,2,4,19,21.1,15,14,2,12,9,20,3,0,defense
ITA-Serie A,2021,Sampdoria,Vasco Regini,ITA,DF,29,1990,1.0,2,2,2,0,0,2,2,100.0,0,1,1,0,1,3,5,0,defense
ITA-Serie A,2021,Sassuolo,Andrea Consigli,ITA,GK,33,1987,37.0,2,2,2,0,0,2,2,100.0,0,0,0,0,0,2,14,4,defense
ITA-Serie A,2021,Sassuolo,Brian Oddei,ITA,"FW,MF",17,2002,0.5,2,1,1,1,0,2,3,66.7,1,1,0,1,0,2,1,0,defense
ITA-Serie A,2021,Sassuolo,Domenico Berardi,ITA,FW,25,1994,27.5,42,22,17,11,14,21,62,33.9,41,23,1,22,26,68,34,0,defense
ITA-Serie A,2021,Sassuolo,Federico Peluso,ITA,DF,36,1984,2.3,1,1,1,0,0,1,2,50.0,1,2,2,0,3,4,12,0,defense
ITA-Serie A,2021,Sassuolo,Federico Ricci,ITA,FW,26,1994,0.0,0,0,0,0,0,0,0,,0,0,0,0,0,0,0,0,defense
ITA-Serie A,2021,Sassuolo,Filip Đuričić,SRB,"MF,FW",28,1992,23.1,32,23,6,16,10,12,30,40.0,18,20,2,18,9,41,12,0,defense
ITA-Serie A,2021,Sassuolo,Francesco Caputo,ITA,FW,32,1987,18.9,0,0,0,0,0,0,2,0.0,2,4,0,4,1,1,3,0,defense
ITA-Serie A,2021,Sassuolo,Francesco Magnanelli,ITA,MF,35,1984,4.9,7,5,2,5,0,3,10,30.0,7,6,2,4,13,20,10,0,defense
ITA-Serie A,2021,Sassuolo,Giacomo Raspadori,ITA,"FW,MF",20,2000,13.7,5,3,1,1,3,0,4,0.0,4,13,5,8,2,7,9,0,defense
ITA-Serie A,2021,Sassuolo,Gian Marco Ferrari,ITA,DF,28,1992,33.5,32,20,15,14,3,10,23,43.5,13,46,37,9,50,82,100,1,defense
ITA-Serie A,2021,Sassuolo,Gianluca Pegolo,ITA,GK,39,1981,1.0,0,0,0,0,0,0,0,,0,0,0,0,0,0,1,0,defense
ITA-Serie A,2021,Sassuolo,Giorgos Kyriakopoulos,GRE,DF,24,1996,16.2,35,18,17,12,6,8,28,28.6,20,16,5,11,15,50,42,0,defense
ITA-Serie A,2021,Sassuolo,Grégoire Defrel,MTQ,"MF,FW",29,1991,14.8,13,8,5,5,3,5,13,38.5,8,9,0,9,7,20,5,0,defense
ITA-Serie A,2021,Sassuolo,Hamed Junior Traorè,CIV,"MF,FW",20,2000,19.9,29,17,10,10,9,14,35,40.0,21,27,3,24,18,47,9,0,defense
ITA-Serie A,2021,Sassuolo,Isaac Karamoko,FRA,DF,18,2002,0.0,1,0,0,0,1,1,1,100.0,0,0,0,0,0,1,0,0,defense
ITA-Serie A,2021,Sassuolo,Jeremie Boga,CIV,"FW,MF",23,1997,19.8,11,9,5,0,6,3,11,27.3,8,10,0,10,8,19,7,0,defense
ITA-Serie A,2021,Sassuolo,Jeremy Toljan,GER,DF,25,1994,16.6,21,12,16,3,2,12,27,44.4,15,15,7,8,13,34,28,0,defense
ITA-Serie A,2021,Sassuolo,Kaan Ayhan,TUR,DF,25,1994,8.8,15,9,8,5,2,8,13,61.5,5,9,5,4,16,31,33,0,defense
ITA-Serie A,2021,Sassuolo,Lukáš Haraslín,SVK,"FW,MF",24,1996,3.7,8,4,2,5,1,2,5,40.0,3,1,0,1,0,8,2,0,defense
ITA-Serie A,2021,Sassuolo,Manuel Locatelli,ITA,MF,22,1998,32.0,81,47,43,28,10,29,56,51.8,27,35,15,20,51,132,65,1,defense
ITA-Serie A,2021,Sassuolo,Marlon,BRA,DF,24,1995,19.4,19,13,13,6,0,13,18,72.2,5,23,17,6,27,46,44,2,defense
ITA-Serie A,2021,Sassuolo,Maxime Lopez,FRA,MF,22,1997,20.7,24,13,15,6,3,14,41,34.1,27,9,0,9,16,40,10,1,defense
ITA-Serie A,2021,Sassuolo,Mehdi Bourabia,MAR,MF,28,1991,5.9,6,5,1,4,1,2,7,28.6,5,14,6,8,12,18,8,0,defense
ITA-Serie A,2021,Sassuolo,Mert Müldür,TUR,DF,21,1999,18.6,43,20,26,9,8,27,53,50.9,26,17,1,16,36,79,41,0,defense
ITA-Serie A,2021,Sassuolo,Nicolás Schiappacasse,URU,MF,21,1999,0.2,0,0,0,0,0,0,0,,0,0,0,0,0,0,0,0,defense
ITA-Serie A,2021,Sassuolo,Pedro Obiang,EQG,MF,28,1992,16.3,35,22,17,15,3,12,35,34.3,23,26,7,19,22,57,27,0,defense
ITA-Serie A,2021,Sassuolo,Rogério,BRA,DF,22,1998,20.9,26,13,19,5,2,19,27,70.4,8,26,5,21,31,57,53,0,defense
ITA-Serie A,2021,Sassuolo,Vlad Chiricheș,ROU,DF,30,1989,20.4,38,23,34,3,1,21,35,60.0,14,31,21,10,50,88,59,2,defense
ITA-Serie A,2021,Spezia,Alessandro Deiola,ITA,MF,24,1995,4.0,6,3,2,3,1,5,13,38.5,8,3,1,2,3,9,1,0,defense
ITA-Serie A,2021,Spezia,Andrey Galabinov,BUL,FW,31,1988,4.8,2,1,1,1,0,1,3,33.3,2,2,0,2,0,2,5,0,defense
ITA-Serie A,2021,Spezia,Ardian Ismajli,ALB,DF,23,1996,14.4,19,9,10,8,1,8,13,61.5,5,10,7,3,23,42,52,1,defense
ITA-Serie A,2021,Spezia,Claudio Terzi,ITA,DF,36,1984,20.8,34,21,19,14,1,19,28,67.9,9,23,12,11,35,69,55,1,defense
ITA-Serie A,2021,Spezia,Cristian Dell'Orco,ITA,DF,26,1994,2.9,1,0,1,0,0,1,3,33.3,2,8,5,3,7,8,9,1,defense
ITA-Serie A,2021,Spezia,Daniele Verde,ITA,FW,24,1996,10.9,5,4,2,2,1,4,10,40.0,6,5,0,5,9,14,7,0,defense
ITA-Serie A,2021,Spezia,Diego Farias,BRA,FW,30,1990,16.8,9,5,4,1,4,4,21,19.0,17,12,0,12,13,22,3,0,defense
ITA-Serie A,2021,Spezia,Elio Capradossi,UGA,DF,24,1996,1.0,2,1,2,0,0,2,2,100.0,0,0,0,0,1,3,5,0,defense
ITA-Serie A,2021,Spezia,Emmanuel Gyasi,GHA,FW,26,1994,31.7,30,16,16,10,4,9,31,29.0,22,13,2,11,14,44,8,0,defense
ITA-Serie A,2021,Spezia,Federico Mattiello,ITA,DF,25,1995,0.4,0,0,0,0,0,0,0,,0,0,0,0,0,0,0,0,defense
ITA-Serie A,2021,Spezia,Gennaro Acampora,ITA,"MF,FW",26,1994,4.9,6,4,1,4,1,2,7,28.6,5,4,1,3,4,10,4,0,defense
ITA-Serie A,2021,Spezia,Giulio Maggiore,ITA,MF,22,1998,24.6,61,36,26,28,7,21,53,39.6,32,33,6,27,19,80,25,1,defense
ITA-Serie A,2021,Spezia,Giuseppe Mastinu,ITA,FW,28,1991,0.4,1,1,0,0,1,1,1,100.0,0,1,0,1,0,1,0,0,defense
ITA-Serie A,2021,Spezia,Ivan Provedel,ITA,GK,26,1994,29.0,2,0,2,0,0,2,6,33.3,4,0,0,0,2,4,20,1,defense
ITA-Serie A,2021,Spezia,Jacopo Sala,ITA,DF,28,1991,4.2,17,9,14,1,2,8,22,36.4,14,5,2,3,5,22,6,0,defense
ITA-Serie A,2021,Spezia,Jeroen Zoet,NED,GK,29,1991,6.7,0,0,0,0,0,0,1,0.0,1,0,0,0,0,0,4,2,defense
ITA-Serie A,2021,Spezia,Juan Manuel Ramos,URU,DF,23,1996,3.3,5,0,3,0,2,4,7,57.1,3,1,0,1,2,7,6,0,defense
ITA-Serie A,2021,Spezia,Julian Chabot,GER,DF,22,1998,18.4,48,34,28,16,4,23,37,62.2,14,25,13,12,37,85,43,1,defense
ITA-Serie A,2021,Spezia,Kevin Agudelo,COL,FW,21,1998,15.1,39,28,9,15,15,12,34,35.3,22,30,0,30,10,49,2,0,defense
ITA-Serie A,2021,Spezia,Luca Mora,ITA,MF,32,1988,1.3,3,1,1,2,0,2,4,50.0,2,2,1,1,0,3,2,0,defense
ITA-Serie A,2021,Spezia,Luca Vignali,ITA,DF,24,1996,17.7,19,9,10,6,3,7,25,28.0,18,13,5,8,22,41,25,0,defense
ITA-Serie A,2021,Spezia,Lucien Agoume,FRA,MF,18,2002,8.9,18,10,11,7,0,6,19,31.6,13,10,5,5,15,33,10,0,defense
ITA-Serie A,2021,Spezia,Léo Sena,BRA,MF,24,1995,9.8,22,12,7,10,5,12,26,46.2,14,19,4,15,11,33,5,0,defense
ITA-Serie A,2021,Spezia,M'Bala Nzola,ANG,FW,23,1996,21.1,12,5,2,6,4,4,7,57.1,3,15,1,14,3,15,20,0,defense
ITA-Serie A,2021,Spezia,Martin Erlic,CRO,DF,22,1998,20.0,23,14,16,6,1,11,20,55.0,9,22,16,6,41,64,71,2,defense
ITA-Serie A,2021,Spezia,Matteo Ricci,ITA,MF,26,1994,24.8,40,23,14,24,2,27,52,51.9,25,24,4,20,34,74,13,0,defense
ITA-Serie A,2021,Spezia,Nahuel Estévez,ARG,MF,24,1995,19.6,13,5,4,6,3,5,32,15.6,27,23,5,18,20,33,22,1,defense
ITA-Serie A,2021,Spezia,Paolo Bartolomei,ITA,MF,30,1989,3.6,6,2,3,1,2,4,7,57.1,3,1,0,1,1,7,2,0,defense
ITA-Serie A,2021,Spezia,Rafael,BRA,GK,38,1982,2.3,0,0,0,0,0,0,0,,0,0,0,0,0,0,0,0,defense
ITA-Serie A,2021,Spezia,Riccardo Marchizza,ITA,DF,22,1998,17.3,20,11,12,5,3,12,21,57.1,9,13,4,9,11,31,27,0,defense
ITA-Serie A,2021,Spezia,Riccardo Saponara,ITA,"FW,MF",28,1991,4.3,4,1,1,0,3,1,3,33.3,2,1,0,1,1,5,4,0,defense
ITA-Serie A,2021,Spezia,Roberto Piccoli,ITA,FW,19,2001,7.8,7,3,0,4,3,2,4,50.0,2,4,0,4,2,9,5,0,defense
ITA-Serie A,2021,Spezia,Salvador Ferrer,ESP,DF,22,1998,13.2,20,10,10,8,2,8,22,36.4,14,13,4,9,24,44,37,1,defense
ITA-Serie A,2021,Spezia,Simone Bastoni,ITA,DF,23,1996,16.9,50,29,26,22,2,27,52,51.9,25,19,1,18,16,66,31,0,defense
ITA-Serie A,2021,Spezia,Tommaso Pobega,ITA,MF,21,1999,13.7,24,13,7,13,4,11,31,35.5,20,10,2,8,9,33,22,0,defense
ITA-Serie A,2021,Torino,Alessandro Buongiorno,ITA,DF,21,1999,9.5,12,5,8,4,0,7,12,58.3,5,15,9,6,11,23,44,1,defense
ITA-Serie A,2021,Torino,Amer Gojak,BIH,"MF,FW",23,1997,5.3,1,0,1,0,0,1,7,14.3,6,5,0,5,3,4,1,0,defense
ITA-Serie A,2021,Torino,Andrea Belotti,ITA,FW,26,1993,32.1,30,18,4,16,10,11,35,31.4,24,27,4,23,12,42,21,0,defense
ITA-Serie A,2021,Torino,Antonio Sanabria,PAR,FW,24,1996,10.9,8,3,0,4,4,2,9,22.2,7,5,0,5,5,13,8,0,defense
ITA-Serie A,2021,Torino,Armando Izzo,ITA,DF,28,1992,22.3,30,16,13,13,4,13,33,39.4,20,22,9,13,53,83,62,0,defense
ITA-Serie A,2021,Torino,Cristian Ansaldi,ARG,"DF,FW",33,1986,21.6,48,33,25,14,9,24,38,63.2,14,21,7,14,16,64,38,0,defense
ITA-Serie A,2021,Torino,Daniele Baselli,ITA,MF,28,1992,4.4,12,7,3,6,3,6,10,60.0,4,2,0,2,9,21,5,0,defense
ITA-Serie A,2021,Torino,Federico Bonazzoli,ITA,FW,23,1997,6.3,6,4,0,4,2,2,13,15.4,11,3,0,3,2,8,3,0,defense
ITA-Serie A,2021,Torino,Gleison Bremer,BRA,DF,23,1997,32.6,51,34,36,14,1,21,36,58.3,15,54,21,33,70,121,142,1,defense
ITA-Serie A,2021,Torino,Jacopo Segre,ITA,MF,23,1997,2.1,5,2,2,1,2,2,5,40.0,3,0,0,0,0,5,1,0,defense
ITA-Serie A,2021,Torino,Karol Linetty,POL,MF,25,1995,20.4,38,28,13,19,6,16,45,35.6,29,19,5,14,15,53,7,0,defense
ITA-Serie A,2021,Torino,Lyanco,BRA,DF,23,1997,21.8,21,14,13,6,2,8,14,57.1,6,36,26,10,46,67,76,0,defense
ITA-Serie A,2021,Torino,Mërgim Vojvoda,KVX,"DF,FW",25,1995,15.1,24,14,18,5,1,12,22,54.5,10,19,4,15,18,42,35,1,defense
ITA-Serie A,2021,Torino,Nicola Murru,ITA,DF,25,1994,6.3,9,6,1,5,3,3,5,60.0,2,11,1,10,12,21,24,0,defense
ITA-Serie A,2021,Torino,Nicolas Nkoulou,CMR,DF,30,1990,15.1,14,9,11,3,0,7,12,58.3,5,28,14,14,33,47,71,1,defense
ITA-Serie A,2021,Torino,Ricardo Rodríguez,SUI,DF,27,1992,13.8,21,14,11,8,2,13,22,59.1,9,16,5,11,20,41,43,0,defense
ITA-Serie A,2021,Torino,Rolando Mandragora,ITA,MF,23,1997,16.9,19,4,4,9,6,7,30,23.3,23,19,6,13,20,39,19,0,defense
ITA-Serie A,2021,Torino,Salvatore Sirigu,ITA,GK,33,1987,32.0,1,0,1,0,0,1,2,50.0,1,0,0,0,0,1,6,2,defense
ITA-Serie A,2021,Torino,Samir Ujkani,KVX,GK,32,1988,1.0,0,0,0,0,0,0,0,,0,0,0,0,0,0,1,0,defense
ITA-Serie A,2021,Torino,Saša Lukić,SRB,MF,23,1996,23.4,32,13,11,18,3,15,50,30.0,35,23,5,18,17,49,17,0,defense
ITA-Serie A,2021,Torino,Simone Edera,ITA,"DF,MF",23,1997,0.6,3,1,2,1,0,3,4,75.0,1,0,0,0,1,4,1,0,defense
ITA-Serie A,2021,Torino,Simone Verdi,ITA,"MF,FW",28,1992,18.0,19,12,10,6,3,6,19,31.6,13,8,0,8,8,27,2,2,defense
ITA-Serie A,2021,Torino,Simone Zaza,ITA,FW,29,1991,16.6,15,9,4,6,5,6,20,30.0,14,14,0,14,3,18,5,1,defense
ITA-Serie A,2021,Torino,Soualiho Meïté,FRA,MF,26,1994,10.2,11,7,6,4,1,5,16,31.3,11,18,1,17,10,21,9,1,defense
ITA-Serie A,2021,Torino,Tomás Rincón,VEN,MF,32,1988,31.6,68,38,27,33,8,36,71,50.7,35,32,7,25,31,99,44,0,defense
ITA-Serie A,2021,Torino,Vanja Milinković-Savić,SRB,GK,23,1997,5.0,1,1,1,0,0,1,1,100.0,0,0,0,0,0,1,1,3,defense
ITA-Serie A,2021,Torino,Vincenzo Millico,ITA,"FW,MF",19,2000,0.2,0,0,0,0,0,0,0,,0,0,0,0,0,0,0,0,defense
ITA-Serie A,2021,Torino,Wilfried Singo,CIV,DF,19,2000,20.6,29,14,16,6,7,17,33,51.5,16,13,3,10,29,58,40,0,defense
ITA-Serie A,2021,Torino,Álex Berenguer,ESP,MF,25,1995,1.5,2,0,0,0,2,2,5,40.0,3,2,0,2,0,2,1,0,defense
ITA-Serie A,2021,Udinese,Bram Nuytinck,NED,DF,30,1990,18.2,21,15,10,9,2,13,20,65.0,7,30,17,13,25,46,77,0,defense
ITA-Serie A,2021,Udinese,Fernando Forestieri,ITA,"FW,MF",30,1990,6.1,9,7,4,4,1,3,7,42.9,4,7,0,7,2,11,0,0,defense
ITA-Serie A,2021,Udinese,Fernando Llorente,ESP,FW,35,1985,7.9,4,1,2,2,0,2,5,40.0,3,3,0,3,2,6,17,0,defense
ITA-Serie A,2021,Udinese,Gerard Deulofeu,ESP,"FW,MF",26,1994,6.6,2,2,1,1,0,2,12,16.7,10,2,0,2,3,5,0,0,defense
ITA-Serie A,2021,Udinese,Hidde ter Avest,NED,DF,23,1997,3.9,5,2,3,2,0,2,5,40.0,3,3,1,2,2,7,5,0,defense
ITA-Serie A,2021,Udinese,Ignacio Pussetto,ARG,FW,24,1995,8.4,16,8,5,6,5,6,17,35.3,11,14,0,14,13,29,6,0,defense
ITA-Serie A,2021,Udinese,Ilija Nestorovski,MKD,"FW,MF",30,1990,7.8,6,4,2,3,1,2,13,15.4,11,5,0,5,1,7,7,0,defense
ITA-Serie A,2021,Udinese,Jayden Braaf,NED,FW,17,2002,1.3,0,0,0,0,0,0,1,0.0,1,0,0,0,0,0,0,0,defense
ITA-Serie A,2021,Udinese,Jean-Victor Makengo,FRA,MF,22,1998,5.8,8,7,5,3,0,3,13,23.1,10,7,1,6,5,13,7,0,defense
ITA-Serie A,2021,Udinese,Jens Stryger Larsen,DEN,DF,29,1991,29.3,17,11,14,3,0,8,25,32.0,17,26,11,15,24,41,65,0,defense
ITA-Serie A,2021,Udinese,Juan Musso,ARG,GK,26,1994,35.0,1,1,1,0,0,1,1,100.0,0,0,0,0,1,2,8,1,defense
ITA-Serie A,2021,Udinese,Kevin Bonifazi,ITA,DF,24,1996,27.4,32,21,24,6,2,8,23,34.8,15,33,20,13,50,82,85,1,defense
ITA-Serie A,2021,Udinese,Kevin Lasagna,ITA,FW,27,1992,12.3,6,1,2,3,1,3,14,21.4,11,11,0,11,6,12,7,0,defense
ITA-Serie A,2021,Udinese,Mamadou Coulibaly,SEN,MF,21,1999,2.0,10,8,5,5,0,0,0,,0,2,0,2,1,11,0,0,defense
ITA-Serie A,2021,Udinese,Manuel Gasparini,ITA,GK,18,2002,0.0,0,0,0,0,0,0,0,,0,0,0,0,0,0,0,0,defense
ITA-Serie A,2021,Udinese,Martin Palumbo,NOR,MF,18,2002,0.7,0,0,0,0,0,0,0,,0,5,0,5,1,1,0,0,defense
ITA-Serie A,2021,Udinese,Marvin Zeegelaar,NED,DF,29,1990,19.3,40,18,23,16,1,20,39,51.3,19,21,9,12,24,64,43,0,defense
ITA-Serie A,2021,Udinese,Mato Jajalo,BIH,MF,32,1988,0.4,1,1,1,0,0,1,1,100.0,0,1,0,1,2,3,0,0,defense
ITA-Serie A,2021,Udinese,Nahuel Molina,ARG,DF,22,1998,20.3,27,18,13,10,4,16,42,38.1,26,26,4,22,21,48,49,1,defense
ITA-Serie A,2021,Udinese,Nícolas Andrade,BRA,GK,32,1988,2.0,0,0,0,0,0,0,0,,0,0,0,0,0,0,0,0,defense
ITA-Serie A,2021,Udinese,Petar Mićin,SRB,MF,21,1998,0.2,0,0,0,0,0,0,0,,0,0,0,0,0,0,0,0,defense
ITA-Serie A,2021,Udinese,Roberto Pereyra,ARG,"MF,FW",29,1991,32.5,18,11,7,8,3,7,23,30.4,16,24,5,19,27,45,24,0,defense
ITA-Serie A,2021,Udinese,Rodrigo Becão,BRA,DF,24,1996,30.9,59,33,36,20,3,27,49,55.1,22,48,27,21,68,127,94,2,defense
ITA-Serie A,2021,Udinese,Rodrigo De Paul,ARG,MF,26,1994,35.6,41,24,17,22,2,15,60,25.0,45,32,1,31,17,58,20,1,defense
ITA-Serie A,2021,Udinese,Rolando Mandragora,ITA,MF,23,1997,4.4,8,5,3,4,1,3,10,30.0,7,10,3,7,6,14,5,0,defense
ITA-Serie A,2021,Udinese,Ryder Matos,BRA,MF,27,1993,0.1,0,0,0,0,0,0,0,,0,0,0,0,0,0,0,0,defense
ITA-Serie A,2021,Udinese,Samir Santos,BRA,DF,25,1994,24.6,40,23,26,12,2,13,29,44.8,16,33,17,16,58,98,60,1,defense
ITA-Serie A,2021,Udinese,Sebastien De Maio,FRA,DF,33,1987,9.5,15,10,6,9,0,4,5,80.0,1,16,9,7,18,33,41,0,defense
ITA-Serie A,2021,Udinese,Simone Scuffet,ITA,GK,24,1996,1.0,0,0,0,0,0,0,0,,0,0,0,0,0,0,0,0,defense
ITA-Serie A,2021,Udinese,Stefano Okaka,ITA,FW,30,1989,16.5,10,7,2,5,3,2,10,20.0,8,7,1,6,2,12,19,0,defense
ITA-Serie A,2021,Udinese,Thomas Ouwejan,NED,DF,23,1996,4.6,4,1,0,3,1,2,9,22.2,7,4,0,4,5,9,6,0,defense
ITA-Serie A,2021,Udinese,Tolgay Arslan,GER,MF,29,1990,20.2,52,32,24,24,4,25,54,46.3,29,22,2,20,22,74,15,1,defense
ITA-Serie A,2021,Udinese,Walace,BRA,MF,25,1995,22.8,50,23,28,19,3,21,60,35.0,39,36,3,33,34,84,23,0,defense
