league,season,team,player,nation,pos,age,born,90s,Tackles Tkl,Tackles TklW,Tackles Def 3rd,Tackles Mid 3rd,Tackles Att 3rd,Challenges Tkl,Challenges Att,Challenges Tkl%,Challenges Lost,Blocks Blocks,Blocks Sh,Blocks Pass,Int,Tkl+Int,Clr,Err,stat_type
ESP-La Liga,2023,Alavés,Abderrahman Rebbach,ALG,"FW,MF",24.0,1998.0,8.0,9,5,4,2,3,5,15,33.3,10,10,1,9,3,12,7,0,defense
ESP-La Liga,2023,Alavés,Aleksandar Sedlar,SRB,DF,31.0,1991.0,10.5,14,10,10,4,0,10,16,62.5,6,8,4,4,13,27,43,0,defense
ESP-La Liga,2023,Alavés,Alex Sola,ESP,"FW,MF",24.0,1999.0,14.0,27,15,11,9,7,14,26,53.8,12,18,2,16,11,38,16,0,defense
ESP-La Liga,2023,Alavés,Ander Guevara,ESP,MF,26.0,1997.0,32.6,59,32,28,25,6,31,64,48.4,33,34,12,22,13,72,46,1,defense
ESP-La Liga,2023,Alavés,Andoni Gorosabel,ESP,DF,26.0,1996.0,31.7,62,42,40,17,5,38,75,50.7,37,24,8,16,28,90,69,0,defense
ESP-La Liga,2023,Alavés,Antonio Blanco,ESP,MF,23.0,2000.0,27.0,61,36,29,27,5,31,86,36.0,55,25,2,23,35,96,30,0,defense
ESP-La Liga,2023,Alavés,Antonio Sivera,ESP,GK,26.0,1996.0,34.0,0,0,0,0,0,0,1,0.0,1,0,0,0,0,0,17,1,defense
ESP-La Liga,2023,Alavés,Carlos Benavídez,URU,MF,25.0,1998.0,12.6,56,35,19,26,11,19,34,55.9,15,13,5,8,19,75,31,0,defense
ESP-La Liga,2023,Alavés,Carlos Vicente,ESP,FW,24.0,1999.0,12.4,16,6,7,7,2,10,25,40.0,15,4,0,4,4,20,9,0,defense
ESP-La Liga,2023,Alavés,Eneko Ortiz,ESP,DF,20.0,2003.0,0.2,0,0,0,0,0,0,0,,0,0,0,0,0,0,0,0,defense
ESP-La Liga,2023,Alavés,Giuliano Simeone,ARG,FW,20.0,2002.0,7.0,7,5,2,3,2,5,17,29.4,12,10,0,10,5,12,3,0,defense
ESP-La Liga,2023,Alavés,Ianis Hagi,ROU,"MF,FW",24.0,1998.0,8.9,17,12,2,14,1,5,12,41.7,7,8,0,8,5,22,4,0,defense
ESP-La Liga,2023,Alavés,Javi López,ESP,DF,21.0,2002.0,26.5,23,12,11,9,3,15,26,57.7,11,25,9,16,10,33,77,1,defense
ESP-La Liga,2023,Alavés,Jesús Owono,EQG,GK,22.0,2001.0,4.0,0,0,0,0,0,0,0,,0,0,0,0,0,0,3,0,defense
ESP-La Liga,2023,Alavés,Joaquín Panichelli,ARG,"FW,MF",20.0,2002.0,2.5,3,3,1,1,1,1,2,50.0,1,1,0,1,1,4,4,0,defense
ESP-La Liga,2023,Alavés,Jon Guridi,ESP,MF,28.0,1995.0,29.8,42,24,10,27,5,12,45,26.7,33,23,3,20,22,64,22,0,defense
ESP-La Liga,2023,Alavés,Jon Karrikaburu,ESP,"MF,FW",20.0,2002.0,0.2,0,0,0,0,0,0,0,,0,0,0,0,0,0,0,0,defense
ESP-La Liga,2023,Alavés,Kiké,ESP,"FW,MF",33.0,1989.0,15.8,8,4,2,3,3,4,9,44.4,5,16,5,11,1,9,12,0,defense
ESP-La Liga,2023,Alavés,Luis Rioja,ESP,"FW,MF",29.0,1993.0,27.8,27,19,10,12,5,14,43,32.6,29,28,1,27,16,43,28,0,defense
ESP-La Liga,2023,Alavés,Mamadou Sylla,SEN,"FW,MF",29.0,1994.0,0.2,0,0,0,0,0,0,0,,0,1,1,0,0,0,1,0,defense
ESP-La Liga,2023,Alavés,Miguel,ESP,"FW,MF",23.0,1999.0,0.7,0,0,0,0,0,0,0,,0,2,0,2,0,0,0,0,defense
ESP-La Liga,2023,Alavés,Nahuel Tenaglia,ARG,DF,27.0,1996.0,12.7,29,19,22,4,3,16,28,57.1,12,14,8,6,12,41,59,0,defense
ESP-La Liga,2023,Alavés,Rafa Marín,ESP,DF,21.0,2002.0,27.1,32,20,23,9,0,14,27,51.9,13,34,21,13,33,65,129,2,defense
ESP-La Liga,2023,Alavés,Rubén Duarte,ESP,DF,27.0,1995.0,20.9,39,20,21,16,2,21,31,67.7,10,21,6,15,23,62,69,0,defense
ESP-La Liga,2023,Alavés,Samu Omorodion,ESP,FW,19.0,2004.0,21.3,6,3,1,4,1,0,4,0.0,4,11,2,9,1,7,14,0,defense
ESP-La Liga,2023,Alavés,Tomás Mendes,ESP,MF,18.0,2004.0,0.1,0,0,0,0,0,0,0,,0,0,0,0,0,0,0,0,defense
ESP-La Liga,2023,Alavés,Unai Ropero,ESP,MF,21.0,2001.0,0.1,0,0,0,0,0,0,0,,0,0,0,0,0,0,0,0,defense
ESP-La Liga,2023,Alavés,Victor Parada,ESP,"FW,MF",21.0,2002.0,0.0,1,1,0,1,0,1,1,100.0,0,0,0,0,0,1,0,0,defense
ESP-La Liga,2023,Alavés,Xeber,ESP,"FW,MF",26.0,1997.0,3.4,5,5,3,2,0,3,7,42.9,4,2,1,1,1,6,2,0,defense
ESP-La Liga,2023,Almería,Adri Embarba,ESP,"FW,MF",31.0,1992.0,27.5,55,37,29,15,11,26,53,49.1,27,37,1,36,15,70,12,0,defense
ESP-La Liga,2023,Almería,Alejandro Pozo Pozo,ESP,"DF,MF",24.0,1999.0,10.8,19,12,11,6,2,12,20,60.0,8,14,4,10,7,26,21,0,defense
ESP-La Liga,2023,Almería,Aleksandar Radovanović,SRB,DF,29.0,1993.0,6.3,8,7,7,1,0,6,6,100.0,0,8,8,0,11,19,48,0,defense
ESP-La Liga,2023,Almería,Anthony Lozano,HON,FW,30.0,1993.0,8.6,7,5,2,5,0,4,7,57.1,3,6,1,5,2,9,12,0,defense
ESP-La Liga,2023,Almería,Arnau Puigmal,ESP,"FW,DF",22.0,2001.0,2.8,2,1,1,1,0,1,3,33.3,2,3,0,3,3,5,2,0,defense
ESP-La Liga,2023,Almería,Bruno Langa,MOZ,DF,25.0,1997.0,9.1,17,12,10,5,2,6,14,42.9,8,11,4,7,4,21,33,2,defense
ESP-La Liga,2023,Almería,Chumi,ESP,DF,24.0,1999.0,27.0,34,22,22,12,0,16,26,61.5,10,38,23,15,14,48,107,3,defense
ESP-La Liga,2023,Almería,César Montes,MEX,DF,26.0,1997.0,19.9,22,13,13,9,0,9,18,50.0,9,21,9,12,11,33,94,0,defense
ESP-La Liga,2023,Almería,Diego Mariño,ESP,GK,33.0,1990.0,1.0,0,0,0,0,0,0,0,,0,0,0,0,0,0,1,0,defense
ESP-La Liga,2023,Almería,Dion Lopy,SEN,MF,21.0,2002.0,21.3,62,37,36,20,6,17,44,38.6,27,23,5,18,15,77,22,2,defense
ESP-La Liga,2023,Almería,Fernando,ESP,GK,33.0,1990.0,4.0,0,0,0,0,0,0,0,,0,1,0,1,0,0,2,0,defense
ESP-La Liga,2023,Almería,Gonzalo Melero,ESP,"MF,FW",29.0,1994.0,12.3,14,8,7,5,2,7,19,36.8,12,12,4,8,4,18,11,0,defense
ESP-La Liga,2023,Almería,Houboulang Mendes,GNB,DF,25.0,1998.0,4.4,16,13,11,5,0,8,16,50.0,8,4,2,2,1,17,17,1,defense
ESP-La Liga,2023,Almería,Ibrahima Koné,MLI,FW,24.0,1999.0,3.1,1,0,1,0,0,1,1,100.0,0,1,0,1,0,1,4,0,defense
ESP-La Liga,2023,Almería,Iddrisu Baba,GHA,MF,27.0,1996.0,15.9,46,26,27,18,1,17,39,43.6,22,20,6,14,11,57,27,2,defense
ESP-La Liga,2023,Almería,Jonathan Viera,ESP,MF,33.0,1989.0,10.1,19,9,6,9,4,10,19,52.6,9,4,0,4,4,23,1,0,defense
ESP-La Liga,2023,Almería,Kaiky,BRA,DF,19.0,2004.0,5.8,7,4,6,0,1,3,6,50.0,3,9,7,2,3,10,29,1,defense
ESP-La Liga,2023,Almería,Largie Ramazani,BEL,"FW,MF",22.0,2001.0,17.3,12,7,5,6,1,6,26,23.1,20,16,2,14,34,46,10,0,defense
ESP-La Liga,2023,Almería,Lucas Robertone,ARG,MF,26.0,1997.0,26.5,61,33,28,23,10,25,50,50.0,25,43,9,34,51,112,43,0,defense
ESP-La Liga,2023,Almería,Luis Javier Suárez,COL,FW,25.0,1997.0,10.2,7,5,2,5,0,2,6,33.3,4,11,0,11,0,7,13,0,defense
ESP-La Liga,2023,Almería,Luka Romero,ARG,FW,18.0,2004.0,4.9,5,1,2,3,0,2,4,50.0,2,12,1,11,1,6,2,1,defense
ESP-La Liga,2023,Almería,Luís Maximiano,POR,GK,24.0,1999.0,33.0,0,0,0,0,0,0,1,0.0,1,0,0,0,0,0,19,2,defense
ESP-La Liga,2023,Almería,Lázaro,BRA,"FW,MF",21.0,2002.0,3.2,4,1,2,0,2,2,8,25.0,6,4,0,4,1,5,1,0,defense
ESP-La Liga,2023,Almería,Léo Baptistão,BRA,FW,30.0,1992.0,20.4,25,16,12,8,5,9,25,36.0,16,13,1,12,11,36,22,0,defense
ESP-La Liga,2023,Almería,Marc Pubill,ESP,DF,20.0,2003.0,20.9,47,23,35,8,4,22,39,56.4,17,20,8,12,15,62,83,1,defense
ESP-La Liga,2023,Almería,Marciano Tchami,GNB,"FW,MF",19.0,2004.0,0.5,0,0,0,0,0,0,0,,0,0,0,0,0,0,0,0,defense
ESP-La Liga,2023,Almería,Marcos Peña,ESP,MF,18.0,2005.0,4.9,19,14,12,7,0,6,12,50.0,6,9,3,6,13,32,8,0,defense
ESP-La Liga,2023,Almería,Marko Milovanović,SRB,"FW,MF",19.0,2003.0,3.4,4,4,1,3,0,2,4,50.0,2,2,0,2,0,4,5,0,defense
ESP-La Liga,2023,Almería,Paco Sanz,ESP,DF,18.0,2004.0,0.3,0,0,0,0,0,0,1,0.0,1,0,0,0,0,0,4,0,defense
ESP-La Liga,2023,Almería,Rachad Fettal,MAR,FW,18.0,2005.0,0.2,1,1,1,0,0,0,0,,0,0,0,0,0,1,0,0,defense
ESP-La Liga,2023,Almería,Sergio Akieme,ESP,DF,25.0,1997.0,18.6,27,15,18,7,2,13,16,81.3,3,14,4,10,10,37,34,0,defense
ESP-La Liga,2023,Almería,Sergio Arribas,ESP,"MF,FW",21.0,2001.0,22.7,34,17,16,17,1,14,31,45.2,17,20,1,19,16,50,8,1,defense
ESP-La Liga,2023,Almería,Srđan Babić,SRB,DF,27.0,1996.0,1.0,2,2,0,2,0,1,1,100.0,0,1,1,0,0,2,2,0,defense
ESP-La Liga,2023,Almería,Álex Centelles,ESP,DF,25.0,1997.0,10.9,11,6,9,2,0,8,18,44.4,10,5,2,3,18,29,29,0,defense
ESP-La Liga,2023,Almería,Édgar González,ESP,"DF,MF",26.0,1997.0,28.0,45,21,22,20,3,25,49,51.0,24,48,28,20,38,83,130,3,defense
ESP-La Liga,2023,Athletic Club,Adu Ares,ESP,FW,21.0,2001.0,2.9,8,4,4,2,2,2,3,66.7,1,1,0,1,1,9,0,0,defense
ESP-La Liga,2023,Athletic Club,Aingeru Olabarrieta,ESP,FW,17.0,2005.0,0.1,0,0,0,0,0,0,0,,0,0,0,0,0,0,0,0,defense
ESP-La Liga,2023,Athletic Club,Aitor Paredes,ESP,DF,23.0,2000.0,30.0,20,11,11,9,0,7,14,50.0,7,23,11,12,33,53,104,0,defense
ESP-La Liga,2023,Athletic Club,Ander Herrera,ESP,MF,33.0,1989.0,11.4,44,32,11,26,7,20,36,55.6,16,16,6,10,15,59,18,1,defense
ESP-La Liga,2023,Athletic Club,Asier Villalibre,ESP,FW,25.0,1997.0,5.7,2,1,0,0,2,2,2,100.0,0,2,1,1,0,2,6,0,defense
ESP-La Liga,2023,Athletic Club,Beñat Prados,ESP,"MF,DF",22.0,2001.0,16.1,45,28,11,23,11,23,42,54.8,19,32,5,27,23,68,27,0,defense
ESP-La Liga,2023,Athletic Club,Dani García,ESP,MF,33.0,1990.0,8.3,17,11,4,7,6,12,24,50.0,12,9,3,6,8,25,11,0,defense
ESP-La Liga,2023,Athletic Club,Daniel Vivian,ESP,DF,24.0,1999.0,32.0,42,28,29,11,2,28,45,62.2,17,49,25,24,31,73,104,0,defense
ESP-La Liga,2023,Athletic Club,Gorka Guruzeta,ESP,FW,26.0,1996.0,24.6,34,23,6,25,3,9,30,30.0,21,36,2,34,17,51,23,0,defense
ESP-La Liga,2023,Athletic Club,Iker Muniain,ESP,"MF,FW",30.0,1992.0,6.6,5,1,2,3,0,1,3,33.3,2,4,1,3,0,5,0,0,defense
ESP-La Liga,2023,Athletic Club,Imanol,ESP,DF,23.0,2000.0,5.8,7,5,1,5,1,5,18,27.8,13,6,0,6,7,14,15,0,defense
ESP-La Liga,2023,Athletic Club,Iñaki Williams,GHA,FW,29.0,1994.0,31.6,24,17,6,8,10,13,34,38.2,21,42,8,34,14,38,29,0,defense
ESP-La Liga,2023,Athletic Club,Iñigo Lekue,ESP,DF,30.0,1993.0,22.2,40,22,25,10,5,27,53,50.9,26,24,6,18,15,55,50,0,defense
ESP-La Liga,2023,Athletic Club,Iñigo Ruiz de Galarreta,ESP,MF,29.0,1993.0,23.2,49,31,15,26,8,24,49,49.0,25,18,5,13,12,61,17,0,defense
ESP-La Liga,2023,Athletic Club,Julen Agirrezabala,ESP,GK,22.0,2000.0,2.6,0,0,0,0,0,0,0,,0,0,0,0,0,0,0,0,defense
ESP-La Liga,2023,Athletic Club,Mikel Jauregizar,ESP,MF,19.0,2003.0,1.7,0,0,0,0,0,0,6,0.0,6,5,0,5,0,0,2,0,defense
ESP-La Liga,2023,Athletic Club,Mikel Vesga,ESP,MF,30.0,1993.0,17.0,40,20,11,23,6,19,49,38.8,30,19,7,12,32,72,35,1,defense
ESP-La Liga,2023,Athletic Club,Nico Williams,ESP,FW,21.0,2002.0,25.1,31,12,9,15,7,13,36,36.1,23,18,2,16,3,34,4,1,defense
ESP-La Liga,2023,Athletic Club,Oihan Sancet,ESP,MF,23.0,2000.0,21.9,19,11,3,10,6,8,21,38.1,13,5,1,4,10,29,5,0,defense
ESP-La Liga,2023,Athletic Club,Peru Nolaskoain,ESP,"DF,MF",24.0,1998.0,0.1,1,1,1,0,0,1,1,100.0,0,0,0,0,0,1,1,0,defense
ESP-La Liga,2023,Athletic Club,Raúl García,ESP,"FW,MF",37.0,1986.0,4.7,9,6,2,4,3,4,9,44.4,5,10,1,9,3,12,9,0,defense
ESP-La Liga,2023,Athletic Club,Unai Gómez,ESP,MF,20.0,2003.0,9.7,12,10,2,6,4,5,10,50.0,5,13,2,11,2,14,9,0,defense
ESP-La Liga,2023,Athletic Club,Unai Simón,ESP,GK,26.0,1997.0,35.4,2,1,1,1,0,2,3,66.7,1,0,0,0,1,3,9,0,defense
ESP-La Liga,2023,Athletic Club,Yeray Álvarez,ESP,DF,28.0,1995.0,12.8,18,9,15,3,0,12,19,63.2,7,8,5,3,11,29,34,1,defense
ESP-La Liga,2023,Athletic Club,Yuri Berchiche,ESP,DF,33.0,1990.0,21.4,33,25,13,14,6,19,33,57.6,14,28,9,19,20,53,62,0,defense
ESP-La Liga,2023,Athletic Club,Álex Berenguer,ESP,FW,28.0,1995.0,17.7,23,14,9,9,5,7,24,29.2,17,23,0,23,5,28,13,0,defense
ESP-La Liga,2023,Athletic Club,Óscar de Marcos,ESP,DF,34.0,1989.0,25.1,56,39,26,24,6,42,71,59.2,29,28,6,22,15,71,44,0,defense
ESP-La Liga,2023,Atlético Madrid,Abdellah Raihani,MAR,FW,19.0,2004.0,0.1,0,0,0,0,0,0,1,0.0,1,0,0,0,0,0,0,0,defense
ESP-La Liga,2023,Atlético Madrid,Antoine Griezmann,FRA,"FW,MF",32.0,1991.0,29.4,33,19,14,14,5,15,41,36.6,26,34,3,31,10,43,23,1,defense
ESP-La Liga,2023,Atlético Madrid,Arthur Vermeeren,BEL,MF,18.0,2005.0,1.8,1,0,0,1,0,0,1,0.0,1,5,0,5,6,7,2,0,defense
ESP-La Liga,2023,Atlético Madrid,Axel Witsel,BEL,DF,34.0,1989.0,30.9,35,21,23,12,0,17,24,70.8,7,40,21,19,16,51,119,0,defense
ESP-La Liga,2023,Atlético Madrid,César Azpilicueta,ESP,DF,33.0,1989.0,15.8,25,14,15,9,1,12,19,63.2,7,25,6,19,16,41,46,0,defense
ESP-La Liga,2023,Atlético Madrid,Gabriel Paulista,BRA,DF,32.0,1990.0,4.5,7,5,4,3,0,3,4,75.0,1,5,3,2,4,11,27,0,defense
ESP-La Liga,2023,Atlético Madrid,Jan Oblak,SVN,GK,30.0,1993.0,38.0,0,0,0,0,0,0,0,,0,0,0,0,0,0,10,0,defense
ESP-La Liga,2023,Atlético Madrid,Javi Galán,ESP,DF,28.0,1994.0,1.0,5,4,2,2,1,4,5,80.0,1,1,0,1,1,6,3,0,defense
ESP-La Liga,2023,Atlético Madrid,José María Giménez,URU,DF,28.0,1995.0,14.7,18,10,10,7,1,5,16,31.3,11,16,12,4,10,28,95,0,defense
ESP-La Liga,2023,Atlético Madrid,Koke,ESP,MF,31.0,1992.0,27.7,66,44,27,32,7,36,79,45.6,43,37,12,25,16,82,34,1,defense
ESP-La Liga,2023,Atlético Madrid,Marcos Llorente,ESP,"MF,DF",28.0,1995.0,28.5,40,23,18,17,5,16,44,36.4,28,36,11,25,14,54,35,0,defense
ESP-La Liga,2023,Atlético Madrid,Mario Hermoso,ESP,DF,28.0,1995.0,28.4,46,25,29,13,4,28,51,54.9,23,27,9,18,30,76,93,0,defense
ESP-La Liga,2023,Atlético Madrid,Memphis,NED,FW,29.0,1994.0,9.9,5,2,0,3,2,3,6,50.0,3,2,0,2,1,6,0,0,defense
ESP-La Liga,2023,Atlético Madrid,Nahuel Molina,ARG,DF,25.0,1998.0,20.6,38,22,16,18,4,26,54,48.1,28,19,3,16,9,47,36,1,defense
ESP-La Liga,2023,Atlético Madrid,Pablo Barrios,ESP,MF,20.0,2003.0,17.3,45,25,15,29,1,19,40,47.5,21,20,3,17,28,73,24,2,defense
ESP-La Liga,2023,Atlético Madrid,Reinildo Mandava,MOZ,DF,29.0,1994.0,8.1,30,22,16,11,3,19,22,86.4,3,10,2,8,15,45,21,0,defense
ESP-La Liga,2023,Atlético Madrid,Rodrigo De Paul,ARG,MF,29.0,1994.0,23.1,31,21,11,14,6,15,38,39.5,23,28,1,27,11,42,15,2,defense
ESP-La Liga,2023,Atlético Madrid,Rodrigo Riquelme,ESP,"DF,MF",23.0,2000.0,17.0,30,19,18,4,8,18,46,39.1,28,19,0,19,9,39,20,0,defense
ESP-La Liga,2023,Atlético Madrid,Salim El Jebari,MAR,MF,19.0,2004.0,0.1,1,0,0,1,0,0,0,,0,0,0,0,0,1,1,0,defense
ESP-La Liga,2023,Atlético Madrid,Samuel Lino,BRA,"DF,MF",23.0,1999.0,23.1,61,34,32,17,12,35,70,50.0,35,37,1,36,14,75,27,0,defense
ESP-La Liga,2023,Atlético Madrid,Saúl Ñíguez,ESP,MF,28.0,1994.0,15.3,64,39,29,29,6,30,49,61.2,19,36,9,27,14,78,56,0,defense
ESP-La Liga,2023,Atlético Madrid,Stefan Savić,MNE,DF,32.0,1991.0,18.1,27,19,16,7,4,15,30,50.0,15,29,15,14,27,54,61,1,defense
ESP-La Liga,2023,Atlético Madrid,Thomas Lemar,FRA,MF,27.0,1995.0,1.8,3,1,2,1,0,1,2,50.0,1,0,0,0,0,3,0,0,defense
ESP-La Liga,2023,Atlético Madrid,Yannick Carrasco,BEL,DF,29.0,1993.0,2.5,4,4,3,1,0,2,7,28.6,5,2,0,2,1,5,6,0,defense
ESP-La Liga,2023,Atlético Madrid,Álvaro Morata,ESP,FW,30.0,1992.0,21.2,16,10,4,7,5,3,5,60.0,2,18,3,15,1,17,26,0,defense
ESP-La Liga,2023,Atlético Madrid,Ángel Correa,ARG,"FW,MF",28.0,1995.0,17.0,22,15,3,11,8,5,17,29.4,12,13,0,13,2,24,6,0,defense
ESP-La Liga,2023,Atlético Madrid,Çağlar Söyüncü,TUR,DF,27.0,1996.0,1.3,1,1,1,0,0,0,0,,0,1,0,1,1,2,7,0,defense
ESP-La Liga,2023,Barcelona,Abde Ezzalzouli,MAR,"FW,MF",21.0,2001.0,0.8,1,1,0,0,1,0,1,0.0,1,1,0,1,0,1,0,0,defense
ESP-La Liga,2023,Barcelona,Alejandro Balde,ESP,DF,19.0,2003.0,15.3,20,11,11,6,3,7,11,63.6,4,14,1,13,5,25,21,1,defense
ESP-La Liga,2023,Barcelona,Andreas Christensen,DEN,"DF,MF",27.0,1996.0,22.0,23,14,7,14,2,16,28,57.1,12,23,10,13,21,44,41,0,defense
ESP-La Liga,2023,Barcelona,Ansu Fati,ESP,"MF,FW",20.0,2002.0,0.6,0,0,0,0,0,0,1,0.0,1,0,0,0,0,0,0,0,defense
ESP-La Liga,2023,Barcelona,Eric García,ESP,DF,22.0,2001.0,0.6,0,0,0,0,0,0,0,,0,1,1,0,0,0,0,0,defense
ESP-La Liga,2023,Barcelona,Fermin López,ESP,"MF,FW",20.0,2003.0,16.1,41,21,15,18,8,14,40,35.0,26,14,1,13,4,45,9,0,defense
ESP-La Liga,2023,Barcelona,Ferrán Torres,ESP,FW,23.0,2000.0,13.5,9,6,1,6,2,5,16,31.3,11,7,1,6,5,14,6,0,defense
ESP-La Liga,2023,Barcelona,Frenkie de Jong,NED,MF,26.0,1997.0,18.2,43,26,14,23,6,8,19,42.1,11,18,8,10,14,57,28,1,defense
ESP-La Liga,2023,Barcelona,Gavi,ESP,"MF,FW",18.0,2004.0,10.5,39,21,20,14,5,18,36,50.0,18,19,3,16,8,47,16,1,defense
ESP-La Liga,2023,Barcelona,Héctor Fort,ESP,DF,16.0,2006.0,3.5,6,5,5,1,0,4,10,40.0,6,0,0,0,2,8,4,0,defense
ESP-La Liga,2023,Barcelona,Iñaki Peña,ESP,GK,24.0,1999.0,10.0,0,0,0,0,0,0,1,0.0,1,0,0,0,0,0,5,1,defense
ESP-La Liga,2023,Barcelona,Iñigo Martínez,ESP,DF,32.0,1991.0,14.4,10,7,9,1,0,6,8,75.0,2,13,10,3,11,21,50,0,defense
ESP-La Liga,2023,Barcelona,João Cancelo,POR,DF,29.0,1994.0,27.8,64,44,35,21,8,38,58,65.5,20,35,6,29,29,93,59,1,defense
ESP-La Liga,2023,Barcelona,João Félix,POR,FW,23.0,1999.0,17.1,22,16,9,7,6,8,22,36.4,14,14,1,13,10,32,11,0,defense
ESP-La Liga,2023,Barcelona,Jules Koundé,FRA,DF,24.0,1998.0,32.2,37,23,22,10,5,28,51,54.9,23,32,12,20,25,62,83,5,defense
ESP-La Liga,2023,Barcelona,Lamine Yamal,ESP,FW,16.0,2007.0,24.5,61,37,32,15,14,18,48,37.5,30,32,0,32,19,80,11,0,defense
ESP-La Liga,2023,Barcelona,Marc Casado,ESP,MF,19.0,2003.0,0.2,1,1,1,0,0,1,1,100.0,0,0,0,0,1,2,2,0,defense
ESP-La Liga,2023,Barcelona,Marc Guiu,ESP,"FW,MF",17.0,2006.0,0.8,1,0,0,1,0,0,0,,0,0,0,0,0,1,0,0,defense
ESP-La Liga,2023,Barcelona,Marc-André ter Stegen,GER,GK,31.0,1992.0,28.0,0,0,0,0,0,0,0,,0,0,0,0,0,0,3,3,defense
ESP-La Liga,2023,Barcelona,Marcos Alonso,ESP,DF,32.0,1990.0,2.8,5,3,2,3,0,3,4,75.0,1,2,0,2,4,9,6,0,defense
ESP-La Liga,2023,Barcelona,Oriol Romeu,ESP,MF,31.0,1991.0,10.4,34,20,17,14,3,13,24,54.2,11,12,2,10,10,44,18,0,defense
ESP-La Liga,2023,Barcelona,Pau Cubarsí,ESP,DF,16.0,2007.0,17.3,22,14,18,3,1,13,18,72.2,5,20,16,4,12,34,65,0,defense
ESP-La Liga,2023,Barcelona,Pedri,ESP,"MF,FW",20.0,2002.0,16.4,33,24,16,13,4,8,27,29.6,19,27,3,24,14,47,10,0,defense
ESP-La Liga,2023,Barcelona,Raphinha,BRA,"FW,MF",26.0,1996.0,15.2,14,8,6,6,2,4,18,22.2,14,17,1,16,13,27,11,0,defense
ESP-La Liga,2023,Barcelona,Robert Lewandowski,POL,FW,34.0,1988.0,30.6,8,5,0,6,2,4,12,33.3,8,13,4,9,9,17,18,0,defense
ESP-La Liga,2023,Barcelona,Ronald Araújo,URU,DF,24.0,1999.0,22.2,27,22,11,15,1,12,17,70.6,5,20,11,9,12,39,66,2,defense
ESP-La Liga,2023,Barcelona,Sergi Roberto,ESP,"MF,DF",31.0,1992.0,9.6,15,10,4,10,1,3,11,27.3,8,7,2,5,8,23,7,1,defense
ESP-La Liga,2023,Barcelona,Vitor Roque,BRA,FW,18.0,2005.0,3.6,3,2,2,0,1,0,2,0.0,2,3,0,3,0,3,5,0,defense
ESP-La Liga,2023,Barcelona,İlkay Gündoğan,GER,MF,32.0,1990.0,33.3,32,22,14,16,2,12,39,30.8,27,19,4,15,21,53,18,1,defense
ESP-La Liga,2023,Betis,Abde Ezzalzouli,MAR,FW,21.0,2001.0,9.6,17,14,7,5,5,4,14,28.6,10,10,0,10,5,22,5,0,defense
ESP-La Liga,2023,Betis,Abner,BRA,DF,23.0,2000.0,15.6,25,19,15,9,1,17,34,50.0,17,23,5,18,15,40,62,0,defense
ESP-La Liga,2023,Betis,Aitor Ruibal,ESP,"DF,FW",27.0,1996.0,11.3,46,27,28,13,5,32,59,54.2,27,12,1,11,14,60,33,1,defense
ESP-La Liga,2023,Betis,Andrés Guardado,MEX,MF,36.0,1986.0,5.0,17,12,5,9,3,7,14,50.0,7,4,2,2,6,23,5,0,defense
ESP-La Liga,2023,Betis,Assane Diao,SEN,FW,17.0,2005.0,11.6,20,12,5,9,6,6,17,35.3,11,22,4,18,7,27,7,0,defense
ESP-La Liga,2023,Betis,Ayoze Pérez,ESP,FW,30.0,1993.0,25.5,59,32,16,33,10,21,49,42.9,28,42,4,38,22,81,18,0,defense
ESP-La Liga,2023,Betis,Borja Iglesias,ESP,FW,30.0,1993.0,4.5,0,0,0,0,0,0,3,0.0,3,0,0,0,2,2,2,0,defense
ESP-La Liga,2023,Betis,Chadi Riad,MAR,DF,20.0,2003.0,24.0,35,24,17,18,0,17,27,63.0,10,23,14,9,23,58,108,0,defense
ESP-La Liga,2023,Betis,Claudio Bravo,CHI,GK,40.0,1983.0,7.0,0,0,0,0,0,0,1,0.0,1,0,0,0,0,0,2,0,defense
ESP-La Liga,2023,Betis,Cédric Bakambu,COD,FW,32.0,1991.0,2.2,1,0,0,1,0,0,0,,0,2,0,2,0,1,0,0,defense
ESP-La Liga,2023,Betis,Ezequiel Ávila,ARG,FW,29.0,1994.0,3.3,2,1,0,2,0,1,3,33.3,2,2,0,2,1,3,4,0,defense
ESP-La Liga,2023,Betis,Fran Vieites,ESP,GK,24.0,1999.0,3.5,1,0,1,0,0,1,1,100.0,0,0,0,0,0,1,2,1,defense
ESP-La Liga,2023,Betis,Germán Pezzella,ARG,DF,32.0,1991.0,30.7,34,24,24,10,0,23,38,60.5,15,31,18,13,31,65,150,0,defense
ESP-La Liga,2023,Betis,Guido Rodríguez,ARG,MF,29.0,1994.0,20.5,53,30,21,24,8,34,55,61.8,21,27,6,21,29,82,44,0,defense
ESP-La Liga,2023,Betis,Héctor Bellerín,ESP,DF,28.0,1995.0,19.0,34,22,14,16,4,20,53,37.7,33,13,5,8,22,56,40,1,defense
ESP-La Liga,2023,Betis,Isco,ESP,MF,31.0,1992.0,25.8,41,27,15,21,5,14,38,36.8,24,19,1,18,10,51,7,0,defense
ESP-La Liga,2023,Betis,Johnny Cardoso,USA,MF,21.0,2001.0,14.8,48,29,19,24,5,22,33,66.7,11,20,5,15,32,80,31,0,defense
ESP-La Liga,2023,Betis,Juan Cruz,ESP,FW,23.0,2000.0,0.8,0,0,0,0,0,0,1,0.0,1,0,0,0,0,0,0,0,defense
ESP-La Liga,2023,Betis,Juan Miranda,ESP,DF,23.0,2000.0,20.6,38,24,21,13,4,17,31,54.8,14,31,6,25,19,57,62,0,defense
ESP-La Liga,2023,Betis,Luiz Felipe,ITA,DF,26.0,1997.0,4.0,7,3,5,2,0,4,5,80.0,1,10,4,6,4,11,16,0,defense
ESP-La Liga,2023,Betis,Luiz Henrique,BRA,FW,22.0,2001.0,6.8,15,11,4,10,1,9,14,64.3,5,11,0,11,5,20,8,0,defense
ESP-La Liga,2023,Betis,Marc Bartra,ESP,DF,32.0,1991.0,2.5,4,3,3,1,0,4,5,80.0,1,3,1,2,3,7,10,0,defense
ESP-La Liga,2023,Betis,Marc Roca,ESP,MF,26.0,1996.0,22.0,52,36,17,29,6,30,53,56.6,23,29,6,23,17,69,23,1,defense
ESP-La Liga,2023,Betis,Nabil Fekir,FRA,"MF,FW",30.0,1993.0,11.7,15,10,5,7,3,5,10,50.0,5,9,0,9,7,22,3,0,defense
ESP-La Liga,2023,Betis,Pablo Busto,ESP,DF,17.0,2005.0,0.5,1,1,0,0,1,1,1,100.0,0,0,0,0,1,2,3,0,defense
ESP-La Liga,2023,Betis,Pablo Fornals,ESP,"FW,MF",27.0,1996.0,12.8,24,16,8,11,5,12,22,54.5,10,14,0,14,22,46,10,2,defense
ESP-La Liga,2023,Betis,Paul Akouokou,CIV,MF,25.0,1997.0,0.3,5,3,0,2,3,3,3,100.0,0,3,1,2,1,6,1,0,defense
ESP-La Liga,2023,Betis,Ricardo Visus,ESP,DF,22.0,2001.0,1.8,2,2,1,1,0,2,2,100.0,0,2,2,0,2,4,9,1,defense
ESP-La Liga,2023,Betis,Rodri,ESP,"FW,MF",23.0,2000.0,11.7,17,10,6,7,4,8,21,38.1,13,11,0,11,8,25,2,0,defense
ESP-La Liga,2023,Betis,Rui Silva,POR,GK,29.0,1994.0,27.5,0,0,0,0,0,0,3,0.0,3,0,0,0,1,1,13,1,defense
ESP-La Liga,2023,Betis,Sergi Altimira,ESP,MF,21.0,2001.0,6.3,15,8,8,6,1,11,23,47.8,12,12,1,11,9,24,10,0,defense
ESP-La Liga,2023,Betis,Sokratis Papastathopoulos,GRE,DF,35.0,1988.0,12.6,21,14,16,5,0,13,17,76.5,4,15,9,6,6,27,60,0,defense
ESP-La Liga,2023,Betis,William Carvalho,POR,MF,31.0,1992.0,7.6,20,12,11,7,2,10,16,62.5,6,8,1,7,8,28,9,1,defense
ESP-La Liga,2023,Betis,Willian José,BRA,FW,31.0,1991.0,21.9,7,3,1,2,4,2,5,40.0,3,8,2,6,2,9,15,0,defense
ESP-La Liga,2023,Betis,Youssouf Sabaly,SEN,DF,30.0,1993.0,11.6,16,11,12,3,1,8,12,66.7,4,6,3,3,11,27,27,0,defense
ESP-La Liga,2023,Celta Vigo,Anastasios Douvikas,GRE,FW,23.0,1999.0,10.1,15,7,2,6,7,3,8,37.5,5,6,3,3,2,17,9,0,defense
ESP-La Liga,2023,Celta Vigo,Carl Starfelt,SWE,DF,28.0,1995.0,24.6,36,30,30,5,1,19,28,67.9,9,35,28,7,34,70,159,2,defense
ESP-La Liga,2023,Celta Vigo,Carles Pérez,ESP,"MF,DF",25.0,1998.0,8.6,13,5,6,5,2,7,18,38.9,11,14,1,13,5,18,8,0,defense
ESP-La Liga,2023,Celta Vigo,Carlos Dominguez,ESP,DF,22.0,2001.0,17.6,33,21,17,9,7,23,37,62.2,14,24,12,12,22,55,78,0,defense
ESP-La Liga,2023,Celta Vigo,Carlos Dotor,ESP,MF,22.0,2001.0,7.9,14,7,3,8,3,4,13,30.8,9,12,2,10,4,18,4,0,defense
ESP-La Liga,2023,Celta Vigo,Damián Rodríguez,ESP,MF,20.0,2003.0,2.9,6,3,1,3,2,1,3,33.3,2,4,2,2,1,7,2,0,defense
ESP-La Liga,2023,Celta Vigo,Fran Beltrán,ESP,MF,24.0,1999.0,27.0,56,32,22,23,11,24,63,38.1,39,28,2,26,18,74,34,0,defense
ESP-La Liga,2023,Celta Vigo,Franco Cervi,ARG,"MF,DF",29.0,1994.0,6.1,24,18,13,9,2,13,24,54.2,11,16,0,16,9,33,4,0,defense
ESP-La Liga,2023,Celta Vigo,Gabriel Veiga,ESP,FW,21.0,2002.0,0.2,0,0,0,0,0,0,0,,0,0,0,0,0,0,0,0,defense
ESP-La Liga,2023,Celta Vigo,Hugo Sotelo,ESP,MF,19.0,2003.0,8.0,19,17,3,13,3,8,20,40.0,12,7,1,6,2,21,5,0,defense
ESP-La Liga,2023,Celta Vigo,Hugo Álvarez,ESP,"MF,DF",20.0,2003.0,8.5,14,9,8,3,3,9,20,45.0,11,4,1,3,5,19,9,0,defense
ESP-La Liga,2023,Celta Vigo,Iago Aspas,ESP,FW,35.0,1987.0,30.1,11,6,4,6,1,1,15,6.7,14,23,3,20,10,21,8,0,defense
ESP-La Liga,2023,Celta Vigo,Iván Villar,ESP,GK,26.0,1997.0,11.3,0,0,0,0,0,0,1,0.0,1,0,0,0,0,0,6,0,defense
ESP-La Liga,2023,Celta Vigo,Jailson Siqueira,BRA,"DF,MF",27.0,1995.0,10.0,27,18,22,5,0,13,24,54.2,11,13,5,8,12,39,32,0,defense
ESP-La Liga,2023,Celta Vigo,Javier Manquillo,ESP,"DF,MF",29.0,1994.0,8.3,15,11,6,5,4,8,15,53.3,7,14,3,11,3,18,17,0,defense
ESP-La Liga,2023,Celta Vigo,Javier Rueda Garcia,ESP,"MF,DF",21.0,2002.0,0.2,0,0,0,0,0,0,0,,0,0,0,0,0,0,0,0,defense
ESP-La Liga,2023,Celta Vigo,Jonathan Bamba,CIV,"MF,FW",27.0,1996.0,22.0,14,9,4,8,2,2,17,11.8,15,20,0,20,18,32,12,0,defense
ESP-La Liga,2023,Celta Vigo,Joseph Aidoo,GHA,DF,27.0,1995.0,4.5,8,3,6,2,0,4,8,50.0,4,3,1,2,4,12,28,0,defense
ESP-La Liga,2023,Celta Vigo,Jørgen Strand Larsen,NOR,FW,23.0,2000.0,31.8,21,11,1,15,5,8,38,21.1,30,15,1,14,5,26,17,0,defense
ESP-La Liga,2023,Celta Vigo,Kevin Vázquez,ESP,DF,30.0,1993.0,7.8,15,13,7,7,1,12,21,57.1,9,11,3,8,5,20,25,0,defense
ESP-La Liga,2023,Celta Vigo,Luca de la Torre,USA,MF,25.0,1998.0,21.7,39,21,12,22,5,22,43,51.2,21,23,4,19,12,51,17,0,defense
ESP-La Liga,2023,Celta Vigo,Manu Sánchez,ESP,"DF,MF",22.0,2000.0,19.7,54,28,21,25,8,31,55,56.4,24,23,3,20,19,73,65,0,defense
ESP-La Liga,2023,Celta Vigo,Miguel Rodríguez,ESP,MF,20.0,2003.0,3.3,6,3,3,1,2,3,9,33.3,6,8,0,8,4,10,0,0,defense
ESP-La Liga,2023,Celta Vigo,Mihailo Ristić,SRB,"DF,MF",27.0,1995.0,9.0,15,9,9,6,0,9,12,75.0,3,9,2,7,10,25,23,0,defense
ESP-La Liga,2023,Celta Vigo,Renato Tapia,PER,"MF,DF",28.0,1995.0,14.9,41,29,19,19,3,14,25,56.0,11,31,7,24,21,62,50,1,defense
ESP-La Liga,2023,Celta Vigo,Tadeo Allende,ARG,"MF,FW",24.0,1999.0,3.7,6,1,3,2,1,4,6,66.7,2,3,0,3,3,9,3,0,defense
ESP-La Liga,2023,Celta Vigo,Unai Núñez,ESP,DF,26.0,1997.0,31.1,51,28,30,19,2,23,49,46.9,26,38,24,14,52,103,153,3,defense
ESP-La Liga,2023,Celta Vigo,Vicente Guaita,ESP,GK,36.0,1987.0,26.7,1,1,1,0,0,1,2,50.0,1,0,0,0,0,1,9,1,defense
ESP-La Liga,2023,Celta Vigo,Williot Swedberg,SWE,"FW,MF",19.0,2004.0,4.9,9,4,3,6,0,5,8,62.5,3,11,1,10,0,9,4,0,defense
ESP-La Liga,2023,Celta Vigo,Yoel Lago,ESP,DF,19.0,2004.0,1.0,2,0,2,0,0,0,0,,0,1,0,1,0,2,2,0,defense
ESP-La Liga,2023,Celta Vigo,Óscar Mingueza,ESP,"DF,MF",24.0,1999.0,33.3,62,38,44,11,7,37,80,46.3,43,38,7,31,17,79,49,2,defense
ESP-La Liga,2023,Cádiz,Aiham Ousou,SYR,DF,23.0,2000.0,4.8,8,5,6,2,0,5,5,100.0,0,1,0,1,7,15,15,0,defense
ESP-La Liga,2023,Cádiz,Borja Vázquez,ESP,FW,18.0,2005.0,0.0,1,0,1,0,0,1,1,100.0,0,0,0,0,0,1,1,0,defense
ESP-La Liga,2023,Cádiz,Brian Ocampo,URU,"MF,FW",24.0,1999.0,2.8,4,3,1,3,0,2,5,40.0,3,4,0,4,3,7,0,0,defense
ESP-La Liga,2023,Cádiz,Chris Ramos,ESP,"FW,MF",26.0,1997.0,29.0,28,15,9,15,4,8,27,29.6,19,23,7,16,9,37,44,0,defense
ESP-La Liga,2023,Cádiz,Darwin Machís,VEN,MF,30.0,1993.0,8.7,23,14,7,9,7,13,24,54.2,11,8,1,7,4,27,2,0,defense
ESP-La Liga,2023,Cádiz,David Gil,ESP,GK,29.0,1994.0,4.1,0,0,0,0,0,0,1,0.0,1,0,0,0,0,0,3,0,defense
ESP-La Liga,2023,Cádiz,Diadie Samassékou,MLI,MF,27.0,1996.0,1.0,5,3,2,2,1,5,6,83.3,1,0,0,0,3,8,1,0,defense
ESP-La Liga,2023,Cádiz,Fali,ESP,DF,29.0,1993.0,28.3,41,26,29,11,1,21,36,58.3,15,38,24,14,27,68,120,0,defense
ESP-La Liga,2023,Cádiz,Fede San Emeterio,ESP,MF,26.0,1997.0,1.7,3,2,2,1,0,1,4,25.0,3,3,2,1,2,5,1,0,defense
ESP-La Liga,2023,Cádiz,Gonzalo Escalante,ARG,MF,30.0,1993.0,18.9,39,24,16,14,9,20,55,36.4,35,23,5,18,26,65,33,2,defense
ESP-La Liga,2023,Cádiz,Isaac Carcelen,ESP,DF,30.0,1993.0,29.0,50,31,30,15,5,25,45,55.6,20,24,7,17,27,77,87,2,defense
ESP-La Liga,2023,Cádiz,Iván Alejo,ESP,MF,28.0,1995.0,18.8,40,23,23,11,6,17,57,29.8,40,20,0,20,7,47,17,0,defense
ESP-La Liga,2023,Cádiz,Javi Hernández,ESP,DF,25.0,1998.0,27.9,43,24,26,12,5,25,46,54.3,21,34,9,25,19,62,72,1,defense
ESP-La Liga,2023,Cádiz,Jeremías Ledesma,ARG,GK,30.0,1993.0,33.9,1,1,1,0,0,1,4,25.0,3,0,0,0,0,1,15,3,defense
ESP-La Liga,2023,Cádiz,Jorge Meré,ESP,DF,26.0,1997.0,7.5,8,7,6,2,0,4,7,57.1,3,5,3,2,8,16,33,0,defense
ESP-La Liga,2023,Cádiz,Joseba Zaldúa,ESP,DF,31.0,1992.0,7.8,20,12,17,2,1,13,21,61.9,8,6,4,2,2,22,20,0,defense
ESP-La Liga,2023,Cádiz,José Mari,ESP,"MF,FW",35.0,1987.0,0.2,2,1,0,2,0,1,2,50.0,1,0,0,0,0,2,0,0,defense
ESP-La Liga,2023,Cádiz,Juanmi,ESP,FW,30.0,1993.0,9.7,9,4,2,7,0,2,9,22.2,7,6,0,6,6,15,3,0,defense
ESP-La Liga,2023,Cádiz,Karl Etta,CMR,FW,19.0,2003.0,0.2,1,1,0,1,0,0,0,,0,0,0,0,0,1,0,0,defense
ESP-La Liga,2023,Cádiz,Lucas,BRA,DF,22.0,2001.0,17.1,47,27,32,11,4,32,55,58.2,23,27,4,23,17,64,45,0,defense
ESP-La Liga,2023,Cádiz,Luis Hernández,ESP,DF,34.0,1989.0,8.0,7,3,4,3,0,4,8,50.0,4,3,2,1,8,15,25,0,defense
ESP-La Liga,2023,Cádiz,Mamadou Mbaye,SEN,DF,25.0,1998.0,3.2,6,3,3,3,0,2,5,40.0,3,10,7,3,5,11,26,0,defense
ESP-La Liga,2023,Cádiz,Maxi Gómez,URU,FW,26.0,1996.0,12.9,6,4,2,3,1,3,5,60.0,2,8,3,5,3,9,3,0,defense
ESP-La Liga,2023,Cádiz,Milutin Osmajić,MNE,MF,24.0,1999.0,0.1,0,0,0,0,0,0,0,,0,0,0,0,0,0,0,0,defense
ESP-La Liga,2023,Cádiz,Moussa Diakité,MLI,MF,19.0,2003.0,0.0,0,0,0,0,0,0,0,,0,0,0,0,0,0,0,0,defense
ESP-La Liga,2023,Cádiz,Roberto Navarro,ESP,"MF,FW",21.0,2002.0,21.0,46,29,20,21,5,22,43,51.2,21,33,0,33,19,65,7,1,defense
ESP-La Liga,2023,Cádiz,Roger Martí,ESP,FW,32.0,1991.0,15.1,12,6,1,9,2,2,7,28.6,5,16,1,15,7,19,4,0,defense
ESP-La Liga,2023,Cádiz,Rominigue Kouamé,MLI,MF,26.0,1996.0,9.1,14,9,6,7,1,7,15,46.7,8,10,2,8,13,27,10,1,defense
ESP-La Liga,2023,Cádiz,Rubén Alcaraz,ESP,MF,32.0,1991.0,34.8,97,59,39,52,6,50,121,41.3,71,60,14,46,33,130,55,2,defense
ESP-La Liga,2023,Cádiz,Rubén Sobrino,ESP,"MF,FW",31.0,1992.0,18.3,52,28,18,26,8,22,51,43.1,29,26,2,24,16,68,18,0,defense
ESP-La Liga,2023,Cádiz,Sergi Guardiola,ESP,"FW,MF",32.0,1991.0,5.5,10,7,2,6,2,4,9,44.4,5,10,0,10,0,10,4,0,defense
ESP-La Liga,2023,Cádiz,Víctor Chust,ESP,DF,23.0,2000.0,20.7,29,18,23,5,1,18,32,56.3,14,27,21,6,11,40,92,1,defense
ESP-La Liga,2023,Cádiz,Álex Fernández,ESP,MF,30.0,1992.0,14.3,19,9,10,9,0,11,22,50.0,11,17,5,12,15,34,30,0,defense
ESP-La Liga,2023,Cádiz,Álvaro Negredo,ESP,"FW,MF",37.0,1985.0,0.6,0,0,0,0,0,0,0,,0,1,0,1,1,1,0,0,defense
ESP-La Liga,2023,Getafe,Alberto Risco,ESP,MF,17.0,2005.0,1.5,2,2,1,1,0,0,4,0.0,4,0,0,0,0,2,1,0,defense
ESP-La Liga,2023,Getafe,Anthony Lozano,HON,"MF,FW",30.0,1993.0,1.0,0,0,0,0,0,0,1,0.0,1,0,0,0,0,0,1,0,defense
ESP-La Liga,2023,Getafe,Borja Mayoral,ESP,FW,26.0,1997.0,23.9,9,5,2,2,5,5,22,22.7,17,7,0,7,4,13,16,0,defense
ESP-La Liga,2023,Getafe,Carles Aleñá,ESP,MF,25.0,1998.0,11.3,24,8,7,14,3,10,24,41.7,14,14,3,11,4,28,13,0,defense
ESP-La Liga,2023,Getafe,Carmona,ESP,"DF,MF",21.0,2002.0,14.6,30,21,13,14,3,9,28,32.1,19,15,2,13,21,51,25,0,defense
ESP-La Liga,2023,Getafe,Damián Suárez,URU,DF,35.0,1988.0,14.4,36,21,16,16,4,26,45,57.8,19,13,3,10,10,46,31,0,defense
ESP-La Liga,2023,Getafe,Daniel Fuzato,BRA,GK,26.0,1997.0,0.1,0,0,0,0,0,0,0,,0,0,0,0,0,0,1,0,defense
ESP-La Liga,2023,Getafe,David Soria,ESP,GK,30.0,1993.0,37.9,0,0,0,0,0,0,2,0.0,2,0,0,0,0,0,21,6,defense
ESP-La Liga,2023,Getafe,Diego Rico,ESP,DF,30.0,1993.0,28.2,64,48,32,23,9,41,76,53.9,35,25,8,17,41,105,76,0,defense
ESP-La Liga,2023,Getafe,Djené,TOG,"DF,MF",31.0,1991.0,27.6,34,19,18,13,3,15,26,57.7,11,31,15,16,23,57,70,0,defense
ESP-La Liga,2023,Getafe,Domingos Duarte,POR,DF,28.0,1995.0,10.1,7,4,6,0,1,5,7,71.4,2,7,5,2,8,15,27,0,defense
ESP-La Liga,2023,Getafe,Enes Ünal,TUR,"FW,MF",26.0,1997.0,1.6,0,0,0,0,0,0,0,,0,1,0,1,0,0,2,0,defense
ESP-La Liga,2023,Getafe,Fabrizio Angileri,ARG,"DF,MF",29.0,1994.0,1.8,1,1,1,0,0,1,3,33.3,2,0,0,0,4,5,8,0,defense
ESP-La Liga,2023,Getafe,Gastón Álvarez,URU,DF,23.0,2000.0,28.2,68,37,43,20,5,37,57,64.9,20,40,11,29,35,103,80,0,defense
ESP-La Liga,2023,Getafe,Gorka Rivera Alonso,ESP,DF,18.0,2004.0,0.0,0,0,0,0,0,0,0,,0,0,0,0,0,0,0,0,defense
ESP-La Liga,2023,Getafe,Iglesias,ESP,"DF,FW",25.0,1998.0,15.7,41,22,25,11,5,21,33,63.6,12,18,7,11,16,57,53,0,defense
ESP-La Liga,2023,Getafe,Ilaix Moriba,GUI,"MF,FW",20.0,2003.0,6.7,20,11,3,11,6,4,9,44.4,5,3,1,2,4,24,10,0,defense
ESP-La Liga,2023,Getafe,Jaime Mata,ESP,"FW,MF",34.0,1988.0,19.9,24,15,12,8,4,11,26,42.3,15,18,1,17,17,41,31,0,defense
ESP-La Liga,2023,Getafe,Jeremy Jorge,ESP,FW,20.0,2003.0,0.0,0,0,0,0,0,0,0,,0,0,0,0,0,0,0,0,defense
ESP-La Liga,2023,Getafe,Jesús Santiago,ESP,MF,19.0,2004.0,7.3,17,8,8,5,4,4,7,57.1,3,3,0,3,0,17,8,0,defense
ESP-La Liga,2023,Getafe,Jordi,ESP,"MF,DF",22.0,2001.0,6.4,16,11,3,11,2,7,15,46.7,8,7,2,5,8,24,7,0,defense
ESP-La Liga,2023,Getafe,Juanmi Latasa,ESP,FW,22.0,2001.0,17.3,9,7,0,6,3,1,11,9.1,10,9,0,9,4,13,21,0,defense
ESP-La Liga,2023,Getafe,Luis Milla,ESP,MF,28.0,1994.0,23.5,57,33,19,28,10,28,47,59.6,19,20,1,19,32,89,10,0,defense
ESP-La Liga,2023,Getafe,Mason Greenwood,ENG,"MF,FW",21.0,2001.0,29.6,11,6,3,5,3,4,21,19.0,17,9,0,9,4,15,4,0,defense
ESP-La Liga,2023,Getafe,Mauro Arambarri,URU,MF,27.0,1995.0,3.8,6,2,3,2,1,1,6,16.7,5,1,0,1,2,8,7,0,defense
ESP-La Liga,2023,Getafe,Nabil Aberdin,FRA,DF,20.0,2002.0,2.0,0,0,0,0,0,0,1,0.0,1,0,0,0,0,0,4,0,defense
ESP-La Liga,2023,Getafe,Nemanja Maksimović,SRB,MF,28.0,1995.0,36.3,65,43,26,31,8,23,41,56.1,18,56,23,33,46,111,61,0,defense
ESP-La Liga,2023,Getafe,Omar Alderete,PAR,DF,26.0,1996.0,24.4,28,21,15,13,0,19,35,54.3,16,30,18,12,13,41,111,0,defense
ESP-La Liga,2023,Getafe,Portu,ESP,FW,31.0,1992.0,1.1,5,3,4,0,1,5,6,83.3,1,0,0,0,0,5,0,0,defense
ESP-La Liga,2023,Getafe,Santiago García,ESP,FW,21.0,2001.0,0.3,1,0,0,0,1,1,1,100.0,0,0,0,0,0,1,0,0,defense
ESP-La Liga,2023,Getafe,Stefan Mitrović,SRB,DF,33.0,1990.0,7.8,9,3,7,2,0,4,8,50.0,4,3,2,1,6,15,26,0,defense
ESP-La Liga,2023,Getafe,Yassin Tallal,ESP,FW,18.0,2005.0,0.0,0,0,0,0,0,0,0,,0,0,0,0,0,0,0,0,defense
ESP-La Liga,2023,Getafe,Óscar Rodríguez Arnaiz,ESP,"MF,FW",25.0,1998.0,10.7,24,13,2,15,7,9,15,60.0,6,12,1,11,5,29,5,0,defense
ESP-La Liga,2023,Girona,Aleix García,ESP,MF,26.0,1997.0,35.5,49,28,17,26,6,28,54,51.9,26,45,17,28,36,85,53,3,defense
ESP-La Liga,2023,Girona,Antal Yaakobishvili,HUN,DF,19.0,2004.0,0.7,2,1,1,1,0,1,1,100.0,0,0,0,0,3,5,3,0,defense
ESP-La Liga,2023,Girona,Arnau Martinez,ESP,DF,20.0,2003.0,13.8,25,16,17,6,2,15,32,46.9,17,15,5,10,10,35,41,3,defense
ESP-La Liga,2023,Girona,Artem Dovbyk,UKR,FW,26.0,1997.0,28.7,4,3,2,1,1,0,2,0.0,2,8,1,7,0,4,17,0,defense
ESP-La Liga,2023,Girona,Bernardo Espinosa,COL,DF,34.0,1989.0,0.0,1,1,1,0,0,1,1,100.0,0,0,0,0,0,1,2,0,defense
ESP-La Liga,2023,Girona,Cristhian Stuani,URU,FW,36.0,1986.0,8.9,14,11,4,6,4,4,7,57.1,3,9,2,7,5,19,13,0,defense
ESP-La Liga,2023,Girona,Daley Blind,NED,DF,33.0,1990.0,33.0,47,21,33,13,1,29,47,61.7,18,37,19,18,21,68,113,0,defense
ESP-La Liga,2023,Girona,David López,ESP,DF,33.0,1989.0,21.8,33,20,21,12,0,17,22,77.3,5,28,19,9,20,53,63,4,defense
ESP-La Liga,2023,Girona,Eric García,ESP,DF,22.0,2001.0,29.3,55,37,34,18,3,34,49,69.4,15,36,18,18,30,85,79,2,defense
ESP-La Liga,2023,Girona,Ibrahima Kebe,MLI,MF,22.0,2000.0,0.1,1,1,0,1,0,0,0,,0,1,0,1,1,2,0,0,defense
ESP-La Liga,2023,Girona,Iván Martín,ESP,MF,24.0,1999.0,30.3,44,25,22,15,7,22,57,38.6,35,25,3,22,21,65,14,0,defense
ESP-La Liga,2023,Girona,Jastin García,ESP,FW,19.0,2004.0,0.4,1,0,0,0,1,0,0,,0,0,0,0,0,1,1,0,defense
ESP-La Liga,2023,Girona,Jhon Solis,COL,MF,18.0,2004.0,4.3,10,8,4,5,1,4,12,33.3,8,8,3,5,8,18,7,1,defense
ESP-La Liga,2023,Girona,Juanpe,ESP,DF,32.0,1991.0,8.3,11,8,8,3,0,9,10,90.0,1,17,11,6,7,18,50,1,defense
ESP-La Liga,2023,Girona,Miguel Gutiérrez,ESP,DF,22.0,2001.0,33.7,29,18,11,14,4,13,35,37.1,22,27,11,16,22,51,66,2,defense
ESP-La Liga,2023,Girona,Pablo Torre,ESP,"MF,FW",20.0,2003.0,7.8,5,2,0,5,0,4,10,40.0,6,10,2,8,4,9,6,1,defense
ESP-La Liga,2023,Girona,Paulo Gazzaniga,ARG,GK,31.0,1992.0,38.0,2,2,2,0,0,2,4,50.0,2,0,0,0,0,2,12,1,defense
ESP-La Liga,2023,Girona,Portu,ESP,"MF,FW",31.0,1992.0,13.2,18,13,3,10,5,3,18,16.7,15,9,1,8,4,22,6,0,defense
ESP-La Liga,2023,Girona,Silvi Clúa,ESP,MF,18.0,2005.0,0.0,2,0,2,0,0,2,2,100.0,0,1,0,1,0,2,0,0,defense
ESP-La Liga,2023,Girona,Sávio,BRA,"FW,MF",19.0,2004.0,33.1,42,25,14,22,6,16,28,57.1,12,34,0,34,18,60,11,1,defense
ESP-La Liga,2023,Girona,Toni Villa,ESP,FW,28.0,1995.0,0.1,0,0,0,0,0,0,0,,0,0,0,0,0,0,0,0,defense
ESP-La Liga,2023,Girona,Valery Fernández,ESP,"MF,FW",23.0,1999.0,5.6,11,9,4,7,0,6,8,75.0,2,6,1,5,1,12,4,0,defense
ESP-La Liga,2023,Girona,Viktor Tsyhankov,UKR,"MF,FW",25.0,1997.0,22.8,29,20,11,13,5,14,26,53.8,12,18,1,17,12,41,24,0,defense
ESP-La Liga,2023,Girona,Yan Couto,BRA,"DF,FW",21.0,2002.0,24.9,45,34,25,14,6,20,40,50.0,20,14,2,12,10,55,31,1,defense
ESP-La Liga,2023,Girona,Yangel Herrera,VEN,MF,25.0,1998.0,23.4,64,37,28,30,6,30,56,53.6,26,30,8,22,24,88,45,1,defense
ESP-La Liga,2023,Granada,Adri Bosch,ESP,DF,22.0,2001.0,0.3,1,1,1,0,0,0,0,,0,0,0,0,0,1,1,0,defense
ESP-La Liga,2023,Granada,Alberto Perea,ESP,"MF,FW",32.0,1990.0,0.0,0,0,0,0,0,0,2,0.0,2,0,0,0,0,0,0,0,defense
ESP-La Liga,2023,Granada,Alberto Soro,ESP,MF,24.0,1999.0,0.1,0,0,0,0,0,0,0,,0,0,0,0,0,0,0,0,defense
ESP-La Liga,2023,Granada,André Ferreira,POR,GK,27.0,1996.0,14.9,0,0,0,0,0,0,1,0.0,1,0,0,0,0,0,9,2,defense
ESP-La Liga,2023,Granada,Antonio Puertas,ESP,"MF,FW",31.0,1992.0,8.1,12,8,6,5,1,6,15,40.0,9,5,0,5,6,18,4,0,defense
ESP-La Liga,2023,Granada,Augusto Batalla,ARG,GK,27.0,1996.0,17.0,0,0,0,0,0,0,1,0.0,1,0,0,0,0,0,10,2,defense
ESP-La Liga,2023,Granada,Brau,ESP,DF,21.0,2001.0,0.3,1,0,1,0,0,1,1,100.0,0,0,0,0,0,1,2,0,defense
ESP-La Liga,2023,Granada,Bruno Méndez,URU,DF,23.0,1999.0,14.8,36,17,19,12,5,21,37,56.8,16,24,6,18,26,62,45,0,defense
ESP-La Liga,2023,Granada,Bryan Zaragoza,ESP,"MF,FW",22.0,2001.0,18.2,18,9,8,6,4,8,23,34.8,15,9,0,9,3,21,3,0,defense
ESP-La Liga,2023,Granada,Carlos Neva,ESP,DF,27.0,1996.0,35.0,32,21,22,9,1,17,40,42.5,23,39,14,25,30,62,108,2,defense
ESP-La Liga,2023,Granada,Facundo Pellistri,URU,"MF,FW",21.0,2001.0,13.7,29,19,12,10,7,6,21,28.6,15,18,0,18,4,33,7,0,defense
ESP-La Liga,2023,Granada,Faitout Maouassa,FRA,"DF,MF",25.0,1998.0,2.5,8,5,6,1,1,4,5,80.0,1,6,0,6,1,9,3,0,defense
ESP-La Liga,2023,Granada,Famara Diedhiou,SEN,"FW,MF",30.0,1992.0,1.0,1,1,0,1,0,0,1,0.0,1,0,0,0,0,1,2,0,defense
ESP-La Liga,2023,Granada,Gerard Gumbau,ESP,MF,28.0,1994.0,29.7,55,34,21,30,4,23,62,37.1,39,24,5,19,25,80,30,2,defense
ESP-La Liga,2023,Granada,Gonzalo Villar,ESP,MF,25.0,1998.0,20.0,51,33,26,20,5,26,41,63.4,15,32,10,22,6,57,26,1,defense
ESP-La Liga,2023,Granada,Ignasi Miquel,ESP,DF,30.0,1992.0,33.2,47,30,39,6,2,23,40,57.5,17,32,16,16,45,92,132,4,defense
ESP-La Liga,2023,Granada,Jesús Vallejo,ESP,DF,26.0,1997.0,1.2,3,1,1,2,0,2,2,100.0,0,3,2,1,0,3,1,1,defense
ESP-La Liga,2023,Granada,José Callejón,ESP,"MF,FW",36.0,1987.0,8.9,13,6,10,3,0,8,22,36.4,14,7,1,6,5,18,10,0,defense
ESP-La Liga,2023,Granada,Kamil Jóźwiak,POL,MF,25.0,1998.0,6.3,13,10,4,6,3,9,17,52.9,8,4,0,4,2,15,6,0,defense
ESP-La Liga,2023,Granada,Kamil Piątkowski,POL,DF,23.0,2000.0,5.6,18,10,16,1,1,10,14,71.4,4,6,5,1,8,26,28,1,defense
ESP-La Liga,2023,Granada,Lucas Boyé,ARG,FW,27.0,1996.0,28.2,50,25,14,25,11,14,34,41.2,20,35,5,30,10,60,46,0,defense
ESP-La Liga,2023,Granada,Marc Martínez,ESP,GK,33.0,1990.0,3.0,0,0,0,0,0,0,1,0.0,1,0,0,0,0,0,1,0,defense
ESP-La Liga,2023,Granada,Martin Hongla,CMR,"MF,DF",25.0,1998.0,6.2,7,3,2,5,0,3,9,33.3,6,6,3,3,6,13,13,1,defense
ESP-La Liga,2023,Granada,Matias Arezo,URU,FW,20.0,2002.0,4.1,7,3,2,5,0,1,5,20.0,4,4,1,3,1,8,4,0,defense
ESP-La Liga,2023,Granada,Miguel Ángel Rubio,ESP,DF,25.0,1998.0,17.3,20,12,14,6,0,14,21,66.7,7,31,18,13,28,48,74,2,defense
ESP-La Liga,2023,Granada,Myrto Uzuni,ALB,FW,28.0,1995.0,27.2,18,14,8,7,3,6,27,22.2,21,19,3,16,4,22,7,0,defense
ESP-La Liga,2023,Granada,Njegoš Petrović,SRB,"MF,FW",24.0,1999.0,1.7,5,2,4,1,0,2,3,66.7,1,2,0,2,1,6,3,0,defense
ESP-La Liga,2023,Granada,Pablo Saenz,ESP,MF,22.0,2001.0,0.2,3,3,2,0,1,1,3,33.3,2,0,0,0,0,3,0,0,defense
ESP-La Liga,2023,Granada,Raúl Fernández,ESP,GK,35.0,1988.0,3.1,0,0,0,0,0,0,1,0.0,1,0,0,0,0,0,1,2,defense
ESP-La Liga,2023,Granada,Raúl Torrente,ESP,DF,21.0,2001.0,13.9,29,16,20,9,0,17,22,77.3,5,16,10,6,11,40,68,2,defense
ESP-La Liga,2023,Granada,Ricard Sánchez,ESP,DF,23.0,2000.0,25.5,29,18,15,8,6,12,24,50.0,12,32,4,28,13,42,64,0,defense
ESP-La Liga,2023,Granada,Samu Omorodion,ESP,FW,19.0,2004.0,0.9,1,1,0,1,0,1,1,100.0,0,0,0,0,0,1,0,0,defense
ESP-La Liga,2023,Granada,Sergio Rodelas,ESP,"FW,DF",18.0,2004.0,1.4,3,2,1,0,2,0,3,0.0,3,0,0,0,0,3,0,0,defense
ESP-La Liga,2023,Granada,Sergio Ruiz,ESP,MF,28.0,1994.0,27.7,83,46,43,36,4,38,84,45.2,46,24,6,18,28,111,43,1,defense
ESP-La Liga,2023,Granada,Shon Weissman,ISR,FW,27.0,1996.0,0.9,1,1,0,0,1,1,4,25.0,3,3,0,3,0,1,1,0,defense
ESP-La Liga,2023,Granada,Theo Corbeanu,CAN,"MF,FW",21.0,2002.0,2.0,5,2,2,3,0,1,3,33.3,2,3,0,3,3,8,2,0,defense
ESP-La Liga,2023,Granada,Víctor Díaz,ESP,"DF,MF",35.0,1988.0,1.8,5,3,2,3,0,1,3,33.3,2,1,0,1,1,6,8,0,defense
ESP-La Liga,2023,Granada,Wilson Manafá,POR,"DF,MF",29.0,1994.0,2.7,6,4,3,2,1,4,7,57.1,3,1,0,1,1,7,4,1,defense
ESP-La Liga,2023,Granada,Álvaro Carreras,ESP,"MF,FW",20.0,2003.0,5.3,13,8,8,4,1,5,11,45.5,6,5,1,4,7,20,9,1,defense
ESP-La Liga,2023,Granada,Óscar Melendo,ESP,"MF,FW",25.0,1997.0,12.5,14,6,4,10,0,4,12,33.3,8,13,0,13,5,19,4,1,defense
ESP-La Liga,2023,Las Palmas,Aarón Escandell,ESP,GK,27.0,1995.0,1.7,0,0,0,0,0,0,0,,0,0,0,0,0,0,1,1,defense
ESP-La Liga,2023,Las Palmas,Alberto Moleiro,ESP,"FW,MF",19.0,2003.0,20.0,15,6,4,7,4,6,30,20.0,24,11,0,11,7,22,10,0,defense
ESP-La Liga,2023,Las Palmas,Benito Ramírez,ESP,"FW,MF",28.0,1995.0,4.3,5,3,2,3,0,3,6,50.0,3,7,1,6,3,8,0,0,defense
ESP-La Liga,2023,Las Palmas,Cristian Herrera,ESP,"FW,MF",32.0,1991.0,1.8,1,1,0,1,0,1,2,50.0,1,1,0,1,0,1,2,0,defense
ESP-La Liga,2023,Las Palmas,Daley Sinkgraven,NED,DF,28.0,1995.0,4.2,11,5,6,5,0,2,8,25.0,6,5,3,2,6,17,9,0,defense
ESP-La Liga,2023,Las Palmas,Enzo Loiodice,FRA,MF,22.0,2000.0,19.9,62,35,15,34,13,20,42,47.6,22,20,2,18,12,74,16,1,defense
ESP-La Liga,2023,Las Palmas,Eric Curbelo,ESP,"DF,MF",29.0,1994.0,1.1,4,3,2,2,0,3,4,75.0,1,3,1,2,2,6,5,1,defense
ESP-La Liga,2023,Las Palmas,Fabio González,ESP,MF,26.0,1997.0,1.4,2,2,2,0,0,1,2,50.0,1,2,0,2,0,2,0,0,defense
ESP-La Liga,2023,Las Palmas,Iñaki González,ESP,MF,19.0,2004.0,0.1,1,0,1,0,0,0,0,,0,0,0,0,0,1,1,0,defense
ESP-La Liga,2023,Las Palmas,Javier Muñoz,ESP,MF,28.0,1995.0,29.3,42,23,14,22,6,16,44,36.4,28,40,4,36,20,62,29,1,defense
ESP-La Liga,2023,Las Palmas,Jonathan Viera,ESP,"MF,FW",33.0,1989.0,6.9,6,3,1,2,3,1,9,11.1,8,0,0,0,0,6,1,0,defense
ESP-La Liga,2023,Las Palmas,José Campaña,ESP,MF,30.0,1993.0,1.9,2,2,1,1,0,0,2,0.0,2,3,2,1,2,4,3,0,defense
ESP-La Liga,2023,Las Palmas,Juan Herzog,ESP,DF,20.0,2003.0,3.2,6,5,5,1,0,3,6,50.0,3,4,1,3,2,8,17,0,defense
ESP-La Liga,2023,Las Palmas,Julian Araujo,MEX,DF,21.0,2001.0,16.2,41,22,29,7,5,23,33,69.7,10,23,16,7,10,51,52,1,defense
ESP-La Liga,2023,Las Palmas,Kirian Rodríguez,ESP,MF,27.0,1996.0,35.7,52,32,22,25,5,24,67,35.8,43,39,3,36,28,80,23,1,defense
ESP-La Liga,2023,Las Palmas,Marc Cardona,ESP,FW,28.0,1995.0,8.2,9,8,3,4,2,1,12,8.3,11,5,0,5,2,11,7,0,defense
ESP-La Liga,2023,Las Palmas,Marvin,ESP,"FW,DF",23.0,2000.0,20.6,39,25,18,17,4,18,36,50.0,18,28,2,26,14,53,18,1,defense
ESP-La Liga,2023,Las Palmas,Mika Màrmol,ESP,DF,21.0,2002.0,35.3,70,42,44,24,2,35,53,66.0,18,39,19,20,44,114,147,2,defense
ESP-La Liga,2023,Las Palmas,Munir El Haddadi,MAR,FW,27.0,1995.0,27.2,40,27,18,17,5,17,38,44.7,21,27,1,26,11,51,16,0,defense
ESP-La Liga,2023,Las Palmas,Máximo Perrone,ARG,MF,20.0,2003.0,18.0,42,21,17,22,3,19,39,48.7,20,27,4,23,24,66,21,0,defense
ESP-La Liga,2023,Las Palmas,Omenuke Mfulu,COD,"MF,FW",29.0,1994.0,0.9,4,3,3,1,0,0,1,0.0,1,1,1,0,2,6,5,0,defense
ESP-La Liga,2023,Las Palmas,Pejiño,ESP,FW,27.0,1996.0,5.6,12,8,3,6,3,6,18,33.3,12,4,0,4,2,14,5,0,defense
ESP-La Liga,2023,Las Palmas,Sandro Ramírez,ESP,FW,28.0,1995.0,20.1,12,8,4,6,2,6,15,40.0,9,13,1,12,4,16,14,1,defense
ESP-La Liga,2023,Las Palmas,Saúl Coco,EQG,DF,24.0,1999.0,25.5,32,19,25,7,0,11,18,61.1,7,27,15,12,20,52,120,3,defense
ESP-La Liga,2023,Las Palmas,Sergi Cardona,ESP,DF,24.0,1999.0,31.3,90,55,52,29,9,55,96,57.3,41,45,7,38,46,136,102,0,defense
ESP-La Liga,2023,Las Palmas,Sory Kaba,GUI,FW,28.0,1995.0,8.0,2,0,0,2,0,0,5,0.0,5,6,0,6,0,2,9,0,defense
ESP-La Liga,2023,Las Palmas,Álex Suárez,ESP,DF,30.0,1993.0,28.5,53,36,33,15,5,31,37,83.8,6,33,14,19,18,71,84,0,defense
ESP-La Liga,2023,Las Palmas,Álvaro Lemos,ESP,DF,30.0,1993.0,2.8,4,1,1,3,0,0,2,0.0,2,3,1,2,2,6,4,0,defense
ESP-La Liga,2023,Las Palmas,Álvaro Vallés,ESP,GK,26.0,1997.0,36.3,3,2,3,0,0,3,8,37.5,5,0,0,0,0,3,40,1,defense
ESP-La Liga,2023,Mallorca,Abdón Prats,ESP,"FW,MF",30.0,1992.0,14.1,6,4,2,2,2,3,5,60.0,2,6,3,3,2,8,12,0,defense
ESP-La Liga,2023,Mallorca,Amath,SEN,"FW,MF",27.0,1996.0,4.4,9,6,7,2,0,2,10,20.0,8,2,0,2,3,12,6,0,defense
ESP-La Liga,2023,Mallorca,Antonio Raillo,ESP,DF,31.0,1991.0,24.4,30,23,18,12,0,17,23,73.9,6,44,30,14,37,67,104,2,defense
ESP-La Liga,2023,Mallorca,Antonio Sánchez,ESP,MF,26.0,1997.0,16.1,25,11,13,10,2,11,32,34.4,21,24,5,19,13,38,13,0,defense
ESP-La Liga,2023,Mallorca,Copete,ESP,DF,23.0,1999.0,14.8,45,27,27,17,1,30,43,69.8,13,12,6,6,32,77,47,1,defense
ESP-La Liga,2023,Mallorca,Cyle Larin,CAN,FW,28.0,1995.0,20.3,17,8,6,4,7,2,7,28.6,5,16,5,11,3,20,17,0,defense
ESP-La Liga,2023,Mallorca,Dani Rodríguez,ESP,MF,35.0,1988.0,29.1,47,24,21,20,6,21,45,46.7,24,34,5,29,15,62,21,0,defense
ESP-La Liga,2023,Mallorca,Dominik Greif,SVK,GK,26.0,1997.0,1.0,0,0,0,0,0,0,0,,0,0,0,0,0,0,0,0,defense
ESP-La Liga,2023,Mallorca,Giovanni González,URU,DF,28.0,1994.0,27.4,73,45,37,32,4,40,81,49.4,41,24,3,21,31,104,60,2,defense
ESP-La Liga,2023,Mallorca,Iván Cuéllar,ESP,GK,39.0,1984.0,1.0,0,0,0,0,0,0,0,,0,0,0,0,0,0,0,0,defense
ESP-La Liga,2023,Mallorca,Jaume Costa,ESP,DF,35.0,1988.0,18.7,38,22,23,10,5,18,29,62.1,11,14,4,10,16,54,35,0,defense
ESP-La Liga,2023,Mallorca,Javier Llabrés,ESP,"MF,FW",20.0,2002.0,2.7,3,1,1,1,1,1,2,50.0,1,1,0,1,3,6,4,0,defense
ESP-La Liga,2023,Mallorca,Manu Morlanes,ESP,MF,24.0,1999.0,17.9,50,29,23,26,1,23,53,43.4,30,13,1,12,20,70,21,0,defense
ESP-La Liga,2023,Mallorca,Martin Valjent,SVK,DF,27.0,1995.0,26.1,34,18,19,13,2,18,30,60.0,12,26,11,15,29,63,112,1,defense
ESP-La Liga,2023,Mallorca,Matija Nastasić,SRB,DF,30.0,1993.0,25.1,35,17,26,9,0,24,32,75.0,8,33,20,13,29,64,114,0,defense
ESP-La Liga,2023,Mallorca,Nacho Vidal,ESP,DF,28.0,1995.0,4.6,12,5,4,5,3,6,13,46.2,7,5,2,3,3,15,9,0,defense
ESP-La Liga,2023,Mallorca,Nemanja Radonjić,SRB,"MF,DF",27.0,1996.0,3.9,4,2,1,3,0,1,4,25.0,3,2,0,2,3,7,3,0,defense
ESP-La Liga,2023,Mallorca,Omar Mascarell,EQG,MF,30.0,1993.0,17.5,33,16,16,17,0,18,35,51.4,17,24,8,16,31,64,30,1,defense
ESP-La Liga,2023,Mallorca,Pablo Maffeo,ESP,DF,26.0,1997.0,16.2,35,22,18,13,4,23,40,57.5,17,12,2,10,10,45,23,0,defense
ESP-La Liga,2023,Mallorca,Predrag Rajković,SRB,GK,27.0,1995.0,36.0,2,1,2,0,0,2,2,100.0,0,0,0,0,0,2,14,0,defense
ESP-La Liga,2023,Mallorca,Samu Costa,POR,MF,22.0,2000.0,25.6,91,50,40,46,5,46,93,49.5,47,28,14,14,39,130,59,3,defense
ESP-La Liga,2023,Mallorca,Sergi Darder,ESP,MF,29.0,1993.0,24.0,39,26,13,21,5,12,31,38.7,19,20,4,16,16,55,16,0,defense
ESP-La Liga,2023,Mallorca,Siebe Van Der Heyden,BEL,DF,25.0,1998.0,3.2,9,2,7,2,0,4,6,66.7,2,1,1,0,7,16,12,0,defense
ESP-La Liga,2023,Mallorca,Toni Lato,ESP,DF,25.0,1997.0,17.2,38,23,19,13,6,16,27,59.3,11,17,3,14,17,55,27,0,defense
ESP-La Liga,2023,Mallorca,Vedat Muriqi,KVX,FW,29.0,1994.0,25.9,11,6,4,3,4,2,14,14.3,12,11,4,7,6,17,26,0,defense
ESP-La Liga,2023,Osasuna,Aimar Oroz,ESP,MF,21.0,2001.0,26.0,43,26,18,20,5,13,37,35.1,24,27,2,25,16,59,11,0,defense
ESP-La Liga,2023,Osasuna,Aitor Fernández,ESP,GK,32.0,1991.0,6.1,0,0,0,0,0,0,1,0.0,1,0,0,0,0,0,5,1,defense
ESP-La Liga,2023,Osasuna,Ante Budimir,CRO,FW,32.0,1991.0,27.1,21,15,2,11,8,5,14,35.7,9,19,5,14,5,26,18,0,defense
ESP-La Liga,2023,Osasuna,Asier Osambela,ESP,MF,19.0,2004.0,0.1,2,1,0,1,1,0,0,,0,0,0,0,0,2,0,0,defense
ESP-La Liga,2023,Osasuna,Catena,ESP,DF,28.0,1994.0,28.2,33,18,26,6,1,19,35,54.3,16,24,15,9,15,48,119,3,defense
ESP-La Liga,2023,Osasuna,Darko Brašanac,SRB,MF,31.0,1992.0,0.5,1,0,1,0,0,1,1,100.0,0,1,0,1,0,1,0,0,defense
ESP-La Liga,2023,Osasuna,David García,ESP,DF,29.0,1994.0,25.9,29,18,19,9,1,16,26,61.5,10,40,19,21,18,47,115,2,defense
ESP-La Liga,2023,Osasuna,Ezequiel Ávila,ARG,"FW,MF",29.0,1994.0,9.6,3,2,1,1,1,3,11,27.3,8,14,0,14,4,7,8,0,defense
ESP-La Liga,2023,Osasuna,Iker Muñoz,ESP,MF,20.0,2002.0,20.6,32,18,13,17,2,15,31,48.4,16,16,5,11,11,43,50,0,defense
ESP-La Liga,2023,Osasuna,Iñigo Arguibide,ESP,DF,18.0,2005.0,0.2,1,0,0,1,0,0,0,,0,0,0,0,0,1,1,0,defense
ESP-La Liga,2023,Osasuna,Jesús Areso,ESP,DF,24.0,1999.0,29.6,45,24,25,13,7,31,38,81.6,7,36,15,21,18,63,58,0,defense
ESP-La Liga,2023,Osasuna,Johan Mojica,COL,DF,30.0,1992.0,22.7,30,22,11,15,4,16,25,64.0,9,15,2,13,21,51,40,2,defense
ESP-La Liga,2023,Osasuna,Jon Moncayola,ESP,MF,25.0,1998.0,20.0,27,18,14,10,3,17,42,40.5,25,31,5,26,15,42,21,0,defense
ESP-La Liga,2023,Osasuna,Jorge Herrando,ESP,DF,22.0,2001.0,18.3,29,19,23,6,0,12,19,63.2,7,20,11,9,15,44,69,1,defense
ESP-La Liga,2023,Osasuna,Jorge Moreno,ESP,DF,22.0,2001.0,0.2,0,0,0,0,0,0,0,,0,1,0,1,0,0,3,0,defense
ESP-La Liga,2023,Osasuna,José Arnaiz,ESP,"FW,MF",28.0,1995.0,10.3,14,8,6,4,4,6,21,28.6,15,11,2,9,3,17,2,0,defense
ESP-La Liga,2023,Osasuna,Juan Cruz Armada,ESP,DF,31.0,1992.0,18.5,27,15,16,10,1,17,25,68.0,8,14,7,7,12,39,39,1,defense
ESP-La Liga,2023,Osasuna,Kike Barja,ESP,"FW,MF",26.0,1997.0,3.4,6,2,2,2,2,3,8,37.5,5,2,1,1,2,8,2,0,defense
ESP-La Liga,2023,Osasuna,Lucas Torró,ESP,MF,29.0,1994.0,19.9,25,15,11,8,6,11,28,39.3,17,10,2,8,33,58,37,0,defense
ESP-La Liga,2023,Osasuna,Max Svensson,ESP,FW,,,0.0,1,0,0,0,1,0,0,,0,0,0,0,0,1,0,0,defense
ESP-La Liga,2023,Osasuna,Moi Gómez,ESP,"MF,FW",29.0,1994.0,22.3,30,19,7,19,4,9,24,37.5,15,15,1,14,11,41,22,0,defense
ESP-La Liga,2023,Osasuna,Nacho Vidal,ESP,"DF,FW",28.0,1995.0,1.1,5,4,2,2,1,2,5,40.0,3,2,0,2,0,5,6,0,defense
ESP-La Liga,2023,Osasuna,Pablo Ibáñez,ESP,MF,24.0,1998.0,12.8,18,9,5,7,6,5,21,23.8,16,26,3,23,9,27,17,0,defense
ESP-La Liga,2023,Osasuna,Raúl,ESP,FW,22.0,2000.0,15.1,10,4,4,2,4,2,10,20.0,8,9,1,8,5,15,11,0,defense
ESP-La Liga,2023,Osasuna,Rubén García,ESP,"FW,MF",30.0,1993.0,17.2,32,18,8,17,7,13,33,39.4,20,23,3,20,12,44,23,0,defense
ESP-La Liga,2023,Osasuna,Rubén Peña,ESP,"DF,FW",32.0,1991.0,23.2,47,25,22,18,7,20,49,40.8,29,37,8,29,30,77,39,3,defense
ESP-La Liga,2023,Osasuna,Sergio Herrera,ESP,GK,30.0,1993.0,31.9,2,2,2,0,0,2,3,66.7,1,0,0,0,0,2,22,3,defense
ESP-La Liga,2023,Osasuna,Unai García,ESP,DF,31.0,1992.0,6.2,12,9,9,2,1,5,10,50.0,5,7,1,6,8,20,18,0,defense
ESP-La Liga,2023,Osasuna,Xabier Huarte Armendáriz,ESP,MF,22.0,2001.0,0.1,0,0,0,0,0,0,0,,0,0,0,0,0,0,0,0,defense
ESP-La Liga,2023,Rayo Vallecano,Abdul Mumin,GHA,DF,25.0,1998.0,18.8,19,10,13,4,2,8,10,80.0,2,27,19,8,22,41,82,1,defense
ESP-La Liga,2023,Rayo Vallecano,Alfonso Espino,URU,DF,31.0,1992.0,27.9,67,45,43,22,2,30,82,36.6,52,26,4,22,40,107,63,0,defense
ESP-La Liga,2023,Rayo Vallecano,Andrei Ratiu,ROU,"DF,MF",25.0,1998.0,7.0,12,4,6,5,1,8,15,53.3,7,4,1,3,0,12,12,0,defense
ESP-La Liga,2023,Rayo Vallecano,Aridane Hernández,ESP,DF,34.0,1989.0,18.8,10,8,5,4,1,4,11,36.4,7,19,14,5,14,24,98,1,defense
ESP-La Liga,2023,Rayo Vallecano,Bebé,CPV,"MF,FW",33.0,1990.0,2.4,2,2,1,1,0,1,5,20.0,4,1,0,1,0,2,0,0,defense
ESP-La Liga,2023,Rayo Vallecano,Crespo,POR,MF,26.0,1996.0,5.9,16,9,8,6,2,9,17,52.9,8,15,6,9,10,26,7,0,defense
ESP-La Liga,2023,Rayo Vallecano,Cárdenas,ESP,GK,26.0,1997.0,1.0,0,0,0,0,0,0,0,,0,0,0,0,0,0,1,0,defense
ESP-La Liga,2023,Rayo Vallecano,Diego Méndez,ESP,MF,19.0,2003.0,0.1,1,1,1,0,0,1,1,100.0,0,0,0,0,1,2,0,0,defense
ESP-La Liga,2023,Rayo Vallecano,Florian Lejeune,FRA,DF,32.0,1991.0,37.0,39,25,26,11,2,19,30,63.3,11,33,18,15,23,62,155,1,defense
ESP-La Liga,2023,Rayo Vallecano,Isaac Palazón Camacho,ESP,"MF,FW",28.0,1994.0,31.0,46,25,16,21,9,20,58,34.5,38,29,2,27,16,62,41,0,defense
ESP-La Liga,2023,Rayo Vallecano,Iván Balliu,ALB,DF,31.0,1992.0,31.9,44,31,20,24,0,22,39,56.4,17,27,11,16,29,73,66,1,defense
ESP-La Liga,2023,Rayo Vallecano,Jorge de Frutos,ESP,"FW,MF",26.0,1997.0,17.2,19,8,5,8,6,7,22,31.8,15,12,0,12,7,26,18,0,defense
ESP-La Liga,2023,Rayo Vallecano,José Pozo,ESP,MF,27.0,1996.0,0.2,1,1,0,1,0,1,1,100.0,0,1,0,1,0,1,0,0,defense
ESP-La Liga,2023,Rayo Vallecano,Kike Pérez,ESP,"MF,FW",26.0,1997.0,9.3,27,11,11,15,1,11,23,47.8,12,11,0,11,8,35,6,0,defense
ESP-La Liga,2023,Rayo Vallecano,Pathé Ciss,SEN,MF,29.0,1994.0,18.5,44,24,16,26,2,16,29,55.2,13,27,10,17,30,74,54,0,defense
ESP-La Liga,2023,Rayo Vallecano,Pep Chavarría,ESP,"DF,MF",25.0,1998.0,13.0,23,18,15,6,2,11,17,64.7,6,15,3,12,6,29,29,1,defense
ESP-La Liga,2023,Rayo Vallecano,Radamel Falcao,COL,"FW,DF",37.0,1986.0,4.5,7,5,1,5,1,1,3,33.3,2,2,0,2,3,10,4,0,defense
ESP-La Liga,2023,Rayo Vallecano,Randy Nteka,ANG,"FW,MF",25.0,1997.0,6.4,11,4,1,6,4,4,10,40.0,6,6,1,5,2,13,11,1,defense
ESP-La Liga,2023,Rayo Vallecano,Raúl de Tomás,ESP,FW,28.0,1994.0,14.1,9,5,4,3,2,3,6,50.0,3,3,0,3,1,10,8,0,defense
ESP-La Liga,2023,Rayo Vallecano,Salvi,ESP,MF,32.0,1991.0,0.3,0,0,0,0,0,0,4,0.0,4,0,0,0,1,1,0,0,defense
ESP-La Liga,2023,Rayo Vallecano,Sergio Camello,ESP,FW,22.0,2001.0,18.5,16,5,3,10,3,6,15,40.0,9,10,2,8,3,19,15,0,defense
ESP-La Liga,2023,Rayo Vallecano,Stole Dimitrievski,MKD,GK,29.0,1993.0,37.0,1,1,1,0,0,1,1,100.0,0,0,0,0,0,1,17,3,defense
ESP-La Liga,2023,Rayo Vallecano,Unai López,ESP,MF,27.0,1995.0,23.4,48,24,18,23,7,21,53,39.6,32,24,3,21,16,64,15,2,defense
ESP-La Liga,2023,Rayo Vallecano,Álvaro García,ESP,"FW,MF",30.0,1992.0,27.5,34,25,15,10,9,7,34,20.6,27,35,0,35,36,70,33,0,defense
ESP-La Liga,2023,Rayo Vallecano,Óscar Trejo,ARG,"FW,MF",35.0,1988.0,15.3,27,15,11,9,7,13,21,61.9,8,21,1,20,5,32,9,0,defense
ESP-La Liga,2023,Rayo Vallecano,Óscar Valentín,ESP,MF,28.0,1994.0,29.9,107,66,39,62,6,46,101,45.5,55,62,10,52,35,142,52,1,defense
ESP-La Liga,2023,Real Madrid,Andriy Lunin,UKR,GK,24.0,1999.0,21.0,0,0,0,0,0,0,1,0.0,1,0,0,0,0,0,15,1,defense
ESP-La Liga,2023,Real Madrid,Antonio Rüdiger,GER,DF,30.0,1993.0,30.1,26,15,18,4,4,16,20,80.0,4,27,20,7,11,37,89,0,defense
ESP-La Liga,2023,Real Madrid,Arda Güler,TUR,"FW,MF",18.0,2005.0,4.2,6,4,1,3,2,5,8,62.5,3,0,0,0,2,8,5,0,defense
ESP-La Liga,2023,Real Madrid,Aurélien Tchouaméni,FRA,"MF,DF",23.0,2000.0,22.1,38,23,19,17,2,9,18,50.0,9,21,13,8,28,66,52,1,defense
ESP-La Liga,2023,Real Madrid,Brahim Díaz,MAR,"FW,MF",23.0,1999.0,17.2,29,19,4,16,9,6,13,46.2,7,16,1,15,5,34,2,0,defense
ESP-La Liga,2023,Real Madrid,Dani Carvajal,ESP,DF,31.0,1992.0,24.1,47,32,28,15,4,23,42,54.8,19,28,9,19,22,69,54,4,defense
ESP-La Liga,2023,Real Madrid,Dani Ceballos,ESP,"MF,FW",26.0,1996.0,6.6,10,5,4,5,1,5,14,35.7,9,9,2,7,0,10,4,1,defense
ESP-La Liga,2023,Real Madrid,David Alaba,AUT,DF,31.0,1992.0,12.8,13,9,7,5,1,4,8,50.0,4,10,7,3,15,28,34,0,defense
ESP-La Liga,2023,Real Madrid,Eduardo Camavinga,FRA,"MF,DF",20.0,2002.0,20.2,76,47,39,29,8,23,39,59.0,16,36,8,28,29,105,29,1,defense
ESP-La Liga,2023,Real Madrid,Federico Valverde,URU,MF,25.0,1998.0,32.3,47,34,22,13,12,24,42,57.1,18,39,2,37,43,90,40,0,defense
ESP-La Liga,2023,Real Madrid,Ferland Mendy,FRA,DF,28.0,1995.0,19.1,15,10,12,2,1,11,14,78.6,3,12,2,10,13,28,26,1,defense
ESP-La Liga,2023,Real Madrid,Fran Garcia,ESP,DF,23.0,1999.0,15.5,25,17,11,12,2,13,31,41.9,18,16,3,13,19,44,28,1,defense
ESP-La Liga,2023,Real Madrid,Gonzalo García,ESP,"FW,MF",19.0,2004.0,0.2,0,0,0,0,0,0,1,0.0,1,1,1,0,0,0,1,0,defense
ESP-La Liga,2023,Real Madrid,Joselu,ESP,FW,33.0,1990.0,18.7,6,3,1,4,1,0,7,0.0,7,11,1,10,6,12,11,0,defense
ESP-La Liga,2023,Real Madrid,Jude Bellingham,ENG,MF,20.0,2003.0,25.7,42,34,14,18,10,12,36,33.3,24,55,5,50,21,63,17,0,defense
ESP-La Liga,2023,Real Madrid,Kepa Arrizabalaga,ESP,GK,28.0,1994.0,13.3,0,0,0,0,0,0,1,0.0,1,0,0,0,0,0,4,0,defense
ESP-La Liga,2023,Real Madrid,Lucas Vázquez,ESP,DF,32.0,1991.0,15.8,37,25,22,14,1,18,25,72.0,7,27,5,22,12,49,36,0,defense
ESP-La Liga,2023,Real Madrid,Luka Modrić,CRO,MF,37.0,1985.0,18.8,22,15,10,6,6,9,25,36.0,16,13,4,9,21,43,9,0,defense
ESP-La Liga,2023,Real Madrid,Mario Martín,ESP,MF,19.0,2004.0,0.2,5,1,0,2,3,3,4,75.0,1,2,1,1,0,5,0,0,defense
ESP-La Liga,2023,Real Madrid,Nacho,ESP,DF,33.0,1990.0,19.4,18,10,9,7,2,6,13,46.2,7,23,13,10,18,36,56,0,defense
ESP-La Liga,2023,Real Madrid,Nicolás Paz,ARG,"MF,FW",18.0,2004.0,0.3,0,0,0,0,0,0,0,,0,2,0,2,1,1,0,0,defense
ESP-La Liga,2023,Real Madrid,Rodrygo,BRA,FW,22.0,2001.0,26.4,16,15,2,9,5,5,19,26.3,14,14,0,14,8,24,6,0,defense
ESP-La Liga,2023,Real Madrid,Thibaut Courtois,BEL,GK,31.0,1992.0,3.7,1,0,1,0,0,0,0,,0,0,0,0,0,1,0,0,defense
ESP-La Liga,2023,Real Madrid,Toni Kroos,GER,MF,33.0,1990.0,23.6,53,34,19,25,9,24,59,40.7,35,22,4,18,17,70,11,1,defense
ESP-La Liga,2023,Real Madrid,Vinicius Júnior,BRA,FW,23.0,2000.0,20.7,18,13,5,5,8,3,12,25.0,9,13,0,13,1,19,3,2,defense
ESP-La Liga,2023,Real Madrid,Álvaro Rodríguez,URU,FW,19.0,2004.0,0.0,0,0,0,0,0,0,0,,0,0,0,0,0,0,1,0,defense
ESP-La Liga,2023,Real Madrid,Éder Militão,BRA,DF,25.0,1998.0,5.5,7,3,4,3,0,6,9,66.7,3,4,3,1,4,11,19,1,defense
ESP-La Liga,2023,Real Sociedad,Aihen Muñoz,ESP,DF,25.0,1997.0,12.5,36,21,20,10,6,24,35,68.6,11,16,8,8,9,45,33,0,defense
ESP-La Liga,2023,Real Sociedad,Alberto Dadie,ESP,MF,21.0,2002.0,0.3,2,1,2,0,0,0,0,,0,1,0,1,0,2,0,0,defense
ESP-La Liga,2023,Real Sociedad,Alex Sola,ESP,"DF,MF",24.0,1999.0,0.3,0,0,0,0,0,0,0,,0,0,0,0,1,1,2,0,defense
ESP-La Liga,2023,Real Sociedad,Ander Barrenetxea,ESP,"FW,MF",21.0,2001.0,15.9,32,21,7,16,9,10,26,38.5,16,18,1,17,6,38,5,0,defense
ESP-La Liga,2023,Real Sociedad,André Silva,POR,FW,27.0,1995.0,8.1,2,2,0,0,2,0,4,0.0,4,3,0,3,1,3,3,0,defense
ESP-La Liga,2023,Real Sociedad,Aritz Elustondo,ESP,DF,29.0,1994.0,9.0,11,7,5,4,2,6,14,42.9,8,12,10,2,7,18,26,0,defense
ESP-La Liga,2023,Real Sociedad,Arsen Zakharyan,RUS,"MF,FW",20.0,2003.0,13.6,22,15,8,11,3,9,22,40.9,13,16,0,16,4,26,10,0,defense
ESP-La Liga,2023,Real Sociedad,Beñat Turrientes,ESP,MF,21.0,2002.0,18.7,31,17,6,20,5,13,30,43.3,17,19,8,11,6,37,17,0,defense
ESP-La Liga,2023,Real Sociedad,Brais Méndez,ESP,"MF,FW",26.0,1997.0,26.8,42,28,13,20,9,15,43,34.9,28,23,4,19,12,54,21,0,defense
ESP-La Liga,2023,Real Sociedad,Carlos Fernández,ESP,FW,27.0,1996.0,4.5,11,7,3,6,2,0,2,0.0,2,4,0,4,0,11,5,0,defense
ESP-La Liga,2023,Real Sociedad,Hamari Traoré,MLI,DF,31.0,1992.0,25.5,44,19,24,17,3,25,43,58.1,18,27,8,19,24,68,59,2,defense
ESP-La Liga,2023,Real Sociedad,Igor Zubeldia,ESP,DF,26.0,1997.0,28.0,32,25,20,10,2,19,26,73.1,7,28,19,9,32,64,97,3,defense
ESP-La Liga,2023,Real Sociedad,Javi Galán,ESP,DF,28.0,1994.0,11.9,38,22,15,19,4,15,30,50.0,15,24,1,23,14,52,17,1,defense
ESP-La Liga,2023,Real Sociedad,Jon Aramburu,VEN,DF,21.0,2002.0,6.0,24,15,12,10,2,15,25,60.0,10,8,3,5,7,31,17,0,defense
ESP-La Liga,2023,Real Sociedad,Jon Magunazelaia,ESP,"FW,MF",23.0,2000.0,1.3,5,3,2,3,0,4,8,50.0,4,3,0,3,0,5,2,0,defense
ESP-La Liga,2023,Real Sociedad,Jon Martin,ESP,DF,17.0,2006.0,0.3,0,0,0,0,0,0,0,,0,0,0,0,0,0,3,0,defense
ESP-La Liga,2023,Real Sociedad,Jon Pacheco,ESP,DF,22.0,2001.0,17.0,25,15,21,4,0,14,22,63.6,8,17,6,11,10,35,53,1,defense
ESP-La Liga,2023,Real Sociedad,Kieran Tierney,SCO,DF,26.0,1997.0,13.8,37,24,16,18,3,18,27,66.7,9,22,8,14,10,47,45,0,defense
ESP-La Liga,2023,Real Sociedad,Martín Zubimendi,ESP,MF,24.0,1999.0,29.5,49,27,18,29,2,23,42,54.8,19,33,9,24,37,86,54,0,defense
ESP-La Liga,2023,Real Sociedad,Mikel Merino,ESP,MF,27.0,1996.0,27.6,77,43,25,34,18,22,48,45.8,26,36,11,25,16,93,55,3,defense
ESP-La Liga,2023,Real Sociedad,Mikel Oyarzabal,ESP,"FW,MF",26.0,1997.0,24.0,23,18,7,11,5,7,21,33.3,14,25,4,21,4,27,12,0,defense
ESP-La Liga,2023,Real Sociedad,Mohamed Ali Cho,FRA,"FW,MF",19.0,2004.0,2.8,4,3,3,1,0,2,7,28.6,5,6,0,6,1,5,1,0,defense
ESP-La Liga,2023,Real Sociedad,Olasagasti,ESP,MF,22.0,2000.0,4.0,16,13,4,7,5,5,8,62.5,3,2,0,2,3,19,5,1,defense
ESP-La Liga,2023,Real Sociedad,Robin Le Normand,ESP,DF,26.0,1996.0,27.4,31,22,16,15,0,17,30,56.7,13,26,15,11,28,59,96,1,defense
ESP-La Liga,2023,Real Sociedad,Sheraldo Becker,SUR,"FW,MF",28.0,1995.0,8.6,2,2,0,2,0,0,1,0.0,1,3,0,3,1,3,0,0,defense
ESP-La Liga,2023,Real Sociedad,Takefusa Kubo,JPN,"FW,MF",22.0,2001.0,23.9,26,17,15,6,5,9,23,39.1,14,21,2,19,11,37,8,1,defense
ESP-La Liga,2023,Real Sociedad,Umar Sadiq,NGA,FW,26.0,1997.0,12.0,15,10,2,8,5,4,8,50.0,4,9,0,9,0,15,10,0,defense
ESP-La Liga,2023,Real Sociedad,Unai Marrero,ESP,GK,21.0,2001.0,1.6,0,0,0,0,0,0,0,,0,0,0,0,0,0,0,0,defense
ESP-La Liga,2023,Real Sociedad,Urko González,ESP,MF,22.0,2001.0,1.7,4,1,0,3,1,2,2,100.0,0,1,0,1,1,5,6,0,defense
ESP-La Liga,2023,Real Sociedad,Álex Remiro,ESP,GK,28.0,1995.0,36.4,0,0,0,0,0,0,0,,0,0,0,0,0,0,24,2,defense
ESP-La Liga,2023,Real Sociedad,Álvaro Odriozola,ESP,DF,27.0,1995.0,4.4,9,7,7,1,1,5,5,100.0,0,2,1,1,8,17,7,0,defense
ESP-La Liga,2023,Sevilla,Adnan Januzaj,BEL,"FW,MF",28.0,1995.0,2.1,3,3,2,0,1,0,1,0.0,1,2,0,2,1,4,0,0,defense
ESP-La Liga,2023,Sevilla,Adrià Pedrosa,ESP,DF,25.0,1998.0,19.5,46,26,28,14,4,23,34,67.6,11,26,6,20,15,61,54,0,defense
ESP-La Liga,2023,Sevilla,Alejo Véliz,ARG,FW,19.0,2003.0,0.4,1,0,0,1,0,1,2,50.0,1,0,0,0,0,1,1,0,defense
ESP-La Liga,2023,Sevilla,Boubakary Soumaré,FRA,MF,24.0,1999.0,25.4,39,28,24,14,1,14,26,53.8,12,25,7,18,26,65,20,1,defense
ESP-La Liga,2023,Sevilla,Diego Iturralde,ESP,DF,20.0,2003.0,0.4,0,0,0,0,0,0,0,,0,1,1,0,0,0,2,0,defense
ESP-La Liga,2023,Sevilla,Djibril Sow,SUI,MF,26.0,1997.0,16.2,28,21,15,8,5,9,25,36.0,16,20,3,17,17,45,8,1,defense
ESP-La Liga,2023,Sevilla,Dodi Lukebakio,BEL,"FW,MF",25.0,1997.0,12.5,5,2,2,2,1,1,6,16.7,5,9,2,7,2,7,5,0,defense
ESP-La Liga,2023,Sevilla,Federico Gattoni,ARG,"DF,FW",24.0,1999.0,0.1,1,0,1,0,0,1,1,100.0,0,0,0,0,0,1,1,0,defense
ESP-La Liga,2023,Sevilla,Fernando,BRA,MF,36.0,1987.0,5.1,9,8,2,4,3,5,9,55.6,4,2,0,2,7,16,9,0,defense
ESP-La Liga,2023,Sevilla,Hannibal Mejbri,TUN,MF,20.0,2003.0,1.2,3,3,1,2,0,0,1,0.0,1,1,0,1,0,3,0,0,defense
ESP-La Liga,2023,Sevilla,Isaac Romero,ESP,FW,23.0,2000.0,11.5,6,3,2,2,2,5,9,55.6,4,12,0,12,0,6,11,0,defense
ESP-La Liga,2023,Sevilla,Ivan Rakitić,CRO,MF,35.0,1988.0,15.8,30,16,9,12,9,11,19,57.9,8,16,5,11,14,44,12,0,defense
ESP-La Liga,2023,Sevilla,Jesús Corona,MEX,"MF,DF",30.0,1993.0,0.2,0,0,0,0,0,0,0,,0,0,0,0,1,1,0,0,defense
ESP-La Liga,2023,Sevilla,Jesús Navas,ESP,DF,37.0,1985.0,22.3,37,27,21,14,2,22,40,55.0,18,15,7,8,22,59,48,0,defense
ESP-La Liga,2023,Sevilla,Joan Jordán,ESP,MF,29.0,1994.0,4.2,8,7,3,3,2,7,15,46.7,8,4,2,2,4,12,2,0,defense
ESP-La Liga,2023,Sevilla,Juanlu Sánchez,ESP,DF,19.0,2003.0,13.1,56,35,34,18,4,34,58,58.6,24,24,7,17,12,68,36,0,defense
ESP-La Liga,2023,Sevilla,Kike Salas,ESP,DF,21.0,2002.0,17.8,41,23,26,12,3,22,36,61.1,14,25,14,11,26,67,91,1,defense
ESP-La Liga,2023,Sevilla,Loïc Bade,FRA,DF,23.0,2000.0,25.3,65,41,53,12,0,30,49,61.2,19,23,15,8,38,103,116,2,defense
ESP-La Liga,2023,Sevilla,Lucas Ocampos,ARG,"FW,MF",29.0,1994.0,31.9,66,47,22,27,17,29,58,50.0,29,34,1,33,21,87,29,0,defense
ESP-La Liga,2023,Sevilla,Lucien Agoume,FRA,MF,21.0,2002.0,8.6,23,18,7,14,2,9,12,75.0,3,6,1,5,7,30,8,0,defense
ESP-La Liga,2023,Sevilla,Manu Bueno,ESP,MF,19.0,2004.0,1.3,4,2,4,0,0,3,3,100.0,0,3,0,3,0,4,1,0,defense
ESP-La Liga,2023,Sevilla,Marcos Acuña,ARG,DF,31.0,1991.0,14.4,33,21,20,12,1,9,14,64.3,5,12,2,10,4,37,25,0,defense
ESP-La Liga,2023,Sevilla,Marcão,BRA,DF,27.0,1996.0,3.9,9,6,5,4,0,6,10,60.0,4,8,6,2,4,13,11,1,defense
ESP-La Liga,2023,Sevilla,Mariano,DOM,"FW,MF",29.0,1993.0,2.7,1,1,0,1,0,0,1,0.0,1,1,0,1,0,1,2,0,defense
ESP-La Liga,2023,Sevilla,Marko Dmitrović,SRB,GK,31.0,1992.0,13.0,1,1,1,0,0,1,2,50.0,1,0,0,0,1,2,5,0,defense
ESP-La Liga,2023,Sevilla,Nemanja Gudelj,SRB,"DF,MF",31.0,1991.0,19.4,31,24,18,10,3,17,31,54.8,14,17,9,8,27,58,56,0,defense
ESP-La Liga,2023,Sevilla,Rafa Mir,ESP,"FW,MF",26.0,1997.0,4.3,2,2,1,1,0,1,2,50.0,1,2,0,2,1,3,1,0,defense
ESP-La Liga,2023,Sevilla,Sergio Ramos,ESP,DF,37.0,1986.0,28.0,45,30,32,11,2,27,40,67.5,13,35,30,5,41,86,156,0,defense
ESP-La Liga,2023,Sevilla,Suso,ESP,"MF,FW",29.0,1993.0,16.9,24,17,14,8,2,8,28,28.6,20,9,0,9,5,29,4,0,defense
ESP-La Liga,2023,Sevilla,Tanguy Nianzou,FRA,DF,21.0,2002.0,3.5,12,8,9,2,1,8,11,72.7,3,2,0,2,3,15,9,1,defense
ESP-La Liga,2023,Sevilla,Yassine Bounou,MAR,GK,32.0,1991.0,1.0,0,0,0,0,0,0,0,,0,0,0,0,0,0,0,0,defense
ESP-La Liga,2023,Sevilla,Youssef En-Nesyri,MAR,FW,26.0,1997.0,28.6,10,7,3,4,3,0,10,0.0,10,9,1,8,7,17,29,1,defense
ESP-La Liga,2023,Sevilla,Érik Lamela,ARG,"FW,MF",31.0,1992.0,5.1,21,14,4,10,7,10,15,66.7,5,12,0,12,1,22,5,0,defense
ESP-La Liga,2023,Sevilla,Óliver Torres,ESP,MF,28.0,1994.0,18.0,37,22,17,15,5,22,57,38.6,35,40,4,36,6,43,6,0,defense
ESP-La Liga,2023,Sevilla,Ørjan Nyland,NOR,GK,32.0,1990.0,24.0,0,0,0,0,0,0,1,0.0,1,0,0,0,0,0,9,1,defense
ESP-La Liga,2023,Valencia,Alberto Marí,ESP,FW,22.0,2001.0,3.1,4,2,0,1,3,1,1,100.0,0,3,0,3,0,4,5,0,defense
ESP-La Liga,2023,Valencia,Cenk Özkacar,TUR,DF,22.0,2000.0,17.8,26,15,22,4,0,15,23,65.2,8,18,7,11,18,44,84,1,defense
ESP-La Liga,2023,Valencia,Cristhian Mosquera,ESP,DF,19.0,2004.0,34.2,57,34,36,18,3,25,39,64.1,14,42,23,19,36,93,137,2,defense
ESP-La Liga,2023,Valencia,Cristian,ESP,GK,25.0,1998.0,0.6,0,0,0,0,0,0,0,,0,0,0,0,0,0,0,0,defense
ESP-La Liga,2023,Valencia,César Tárrega,ESP,DF,21.0,2002.0,0.1,0,0,0,0,0,0,0,,0,0,0,0,0,0,2,0,defense
ESP-La Liga,2023,Valencia,Diego López,ESP,"MF,FW",21.0,2002.0,29.5,37,25,14,16,7,13,56,23.2,43,23,1,22,20,57,12,0,defense
ESP-La Liga,2023,Valencia,Dimitri Foulquier,FRA,"DF,MF",30.0,1993.0,20.5,39,22,22,13,4,18,26,69.2,8,10,1,9,16,55,49,1,defense
ESP-La Liga,2023,Valencia,Domingos André Ribeiro Almeida,POR,"FW,MF",23.0,2000.0,10.7,25,15,9,12,4,9,19,47.4,10,13,1,12,6,31,5,0,defense
ESP-La Liga,2023,Valencia,Francisco Perez,ESP,"MF,FW",20.0,2002.0,22.8,30,17,10,14,6,15,44,34.1,29,19,0,19,14,44,5,0,defense
ESP-La Liga,2023,Valencia,Gabriel Paulista,BRA,DF,32.0,1990.0,15.5,10,7,8,2,0,6,11,54.5,5,15,7,8,24,34,78,0,defense
ESP-La Liga,2023,Valencia,Giorgi Mamardashvili,GEO,GK,22.0,2000.0,36.5,4,3,4,0,0,4,4,100.0,0,1,0,1,2,6,22,2,defense
ESP-La Liga,2023,Valencia,Hugo Duro,ESP,FW,23.0,1999.0,33.1,16,8,5,8,3,9,29,31.0,20,24,5,19,5,21,27,0,defense
ESP-La Liga,2023,Valencia,Hugo González,ESP,"MF,FW",20.0,2003.0,1.0,2,1,0,2,0,0,0,,0,0,0,0,0,2,0,0,defense
ESP-La Liga,2023,Valencia,Hugo Guillamón,ESP,MF,23.0,2000.0,14.6,24,15,7,14,3,11,17,64.7,6,8,3,5,12,36,25,2,defense
ESP-La Liga,2023,Valencia,Jaume Doménech,ESP,GK,32.0,1990.0,0.9,0,0,0,0,0,0,0,,0,0,0,0,0,0,0,0,defense
ESP-La Liga,2023,Valencia,Javier Guerra,ESP,MF,20.0,2003.0,27.8,54,24,25,22,7,22,58,37.9,36,27,7,20,18,72,44,0,defense
ESP-La Liga,2023,Valencia,Jesus Vazquez,ESP,"DF,MF",20.0,2003.0,8.0,24,12,13,8,3,10,16,62.5,6,17,4,13,3,27,24,0,defense
ESP-La Liga,2023,Valencia,José Luis García Vayá,ESP,MF,24.0,1998.0,36.7,78,53,36,36,6,37,71,52.1,34,41,10,31,49,127,71,0,defense
ESP-La Liga,2023,Valencia,José Luis Gayà,ESP,DF,28.0,1995.0,19.9,71,36,44,23,4,43,67,64.2,24,18,3,15,11,82,42,0,defense
ESP-La Liga,2023,Valencia,Mario Dominguez,ESP,FW,19.0,2004.0,0.3,0,0,0,0,0,0,0,,0,0,0,0,0,0,0,0,defense
ESP-La Liga,2023,Valencia,Mouctar Diakhaby,GUI,"DF,MF",26.0,1996.0,11.9,18,11,9,9,0,11,13,84.6,2,17,7,10,11,29,62,0,defense
ESP-La Liga,2023,Valencia,Pablo Gozalbez,ESP,"MF,FW",22.0,2001.0,1.1,1,0,0,0,1,1,6,16.7,5,0,0,0,1,2,2,0,defense
ESP-La Liga,2023,Valencia,Peter González,DOM,"MF,FW",21.0,2002.0,7.2,5,3,3,1,1,1,10,10.0,9,11,0,11,7,12,10,0,defense
ESP-La Liga,2023,Valencia,Roman Yaremchuk,UKR,FW,27.0,1995.0,10.3,5,2,1,2,2,3,6,50.0,3,4,0,4,1,6,9,0,defense
ESP-La Liga,2023,Valencia,Ruben Lendinez,ESP,DF,20.0,2003.0,0.1,2,2,0,2,0,1,1,100.0,0,0,0,0,0,2,1,0,defense
ESP-La Liga,2023,Valencia,Selim Amallah,MAR,"FW,MF",26.0,1996.0,6.7,17,12,7,7,3,3,9,33.3,6,13,0,13,11,28,6,0,defense
ESP-La Liga,2023,Valencia,Sergi Canós,ESP,"MF,FW",26.0,1997.0,13.7,23,13,7,11,5,10,24,41.7,14,14,2,12,11,34,9,0,defense
ESP-La Liga,2023,Valencia,Thierry Correia,POR,DF,24.0,1999.0,23.9,63,35,39,20,4,28,49,57.1,21,39,16,23,33,96,61,0,defense
ESP-La Liga,2023,Valencia,Yarek Gasiorowski,ESP,DF,18.0,2005.0,8.2,22,12,14,5,3,13,19,68.4,6,15,8,7,15,37,50,1,defense
ESP-La Liga,2023,Villarreal,Adrià Altimira,ESP,"DF,MF",22.0,2001.0,8.6,16,7,9,6,1,9,24,37.5,15,18,5,13,5,21,18,0,defense
ESP-La Liga,2023,Villarreal,Alberto Moreno,ESP,DF,31.0,1992.0,16.5,31,21,19,10,2,10,30,33.3,20,12,2,10,24,55,33,0,defense
ESP-La Liga,2023,Villarreal,Alex Baena,ESP,"MF,FW",22.0,2001.0,28.7,34,21,10,16,8,20,47,42.6,27,23,2,21,13,47,17,1,defense
ESP-La Liga,2023,Villarreal,Alexander Sørloth,NOR,FW,27.0,1995.0,27.7,6,3,1,2,3,2,6,33.3,4,9,4,5,0,6,26,0,defense
ESP-La Liga,2023,Villarreal,Alfonso Pedraza,ESP,DF,27.0,1996.0,12.4,25,9,18,5,2,9,17,52.9,8,16,7,9,13,38,19,0,defense
ESP-La Liga,2023,Villarreal,Aïssa Mandi,ALG,DF,31.0,1991.0,12.4,13,8,8,5,0,7,14,50.0,7,10,7,3,8,21,41,0,defense
ESP-La Liga,2023,Villarreal,Ben Brereton,CHI,"FW,MF",24.0,1999.0,3.0,2,2,1,0,1,0,2,0.0,2,0,0,0,0,2,0,0,defense
ESP-La Liga,2023,Villarreal,Bertrand Traoré,BFA,MF,27.0,1995.0,6.3,5,4,2,1,2,1,4,25.0,3,6,0,6,1,6,2,0,defense
ESP-La Liga,2023,Villarreal,Carlos Romero,ESP,DF,21.0,2001.0,2.9,11,5,8,1,2,7,12,58.3,5,3,0,3,1,12,11,0,defense
ESP-La Liga,2023,Villarreal,Daniel Parejo,ESP,MF,34.0,1989.0,28.7,43,30,16,21,6,20,46,43.5,26,25,9,16,21,64,29,3,defense
ESP-La Liga,2023,Villarreal,Denis Suárez,ESP,"MF,FW",29.0,1994.0,1.5,0,0,0,0,0,0,2,0.0,2,2,2,0,0,0,4,0,defense
ESP-La Liga,2023,Villarreal,Eric Bailly,CIV,DF,29.0,1994.0,9.3,5,3,4,1,0,2,2,100.0,0,8,8,0,9,14,38,2,defense
ESP-La Liga,2023,Villarreal,Filip Jørgensen,DEN,GK,21.0,2002.0,36.0,3,1,3,0,0,3,4,75.0,1,0,0,0,2,5,10,3,defense
ESP-La Liga,2023,Villarreal,Francis Coquelin,FRA,MF,32.0,1991.0,10.1,20,12,8,10,2,5,13,38.5,8,14,4,10,16,36,15,0,defense
ESP-La Liga,2023,Villarreal,Gerard Moreno,ESP,FW,31.0,1992.0,24.6,25,12,10,7,8,11,25,44.0,14,24,7,17,9,34,24,0,defense
ESP-La Liga,2023,Villarreal,Gonçalo Guedes,POR,"FW,MF",26.0,1996.0,10.6,6,4,1,2,3,2,7,28.6,5,8,0,8,2,8,3,0,defense
ESP-La Liga,2023,Villarreal,Ilias Akhomach,MAR,"MF,FW",19.0,2004.0,16.8,36,21,11,16,9,10,20,50.0,10,10,2,8,13,49,13,0,defense
ESP-La Liga,2023,Villarreal,Jorge Cuenca,ESP,DF,23.0,1999.0,21.8,42,29,26,10,6,19,30,63.3,11,26,15,11,21,63,114,0,defense
ESP-La Liga,2023,Villarreal,José Luis Morales,ESP,"FW,MF",36.0,1987.0,11.6,5,3,1,4,0,3,13,23.1,10,9,1,8,7,12,4,0,defense
ESP-La Liga,2023,Villarreal,Juan Foyth,ARG,DF,25.0,1998.0,11.8,26,15,18,8,0,12,27,44.4,15,17,4,13,12,38,44,0,defense
ESP-La Liga,2023,Villarreal,Kiko Femenía,ESP,DF,32.0,1991.0,17.6,35,25,19,13,3,19,34,55.9,15,21,6,15,31,66,45,0,defense
ESP-La Liga,2023,Villarreal,Manu Trigueros,ESP,MF,31.0,1991.0,3.4,7,5,6,1,0,4,10,40.0,6,1,1,0,3,10,9,0,defense
ESP-La Liga,2023,Villarreal,Matteo Gabbia,ITA,DF,23.0,1999.0,5.3,10,6,4,6,0,5,8,62.5,3,5,2,3,8,18,36,1,defense
ESP-La Liga,2023,Villarreal,Pascu,ESP,FW,20.0,2003.0,0.2,0,0,0,0,0,0,0,,0,0,0,0,0,0,0,0,defense
ESP-La Liga,2023,Villarreal,Pepe Reina,ESP,GK,40.0,1982.0,2.0,0,0,0,0,0,0,0,,0,0,0,0,0,0,1,0,defense
ESP-La Liga,2023,Villarreal,Ramón Terrats,ESP,"MF,DF",22.0,2000.0,8.7,17,13,8,8,1,7,15,46.7,8,11,1,10,3,20,9,0,defense
ESP-La Liga,2023,Villarreal,Raúl Albiol,ESP,DF,37.0,1985.0,22.6,25,14,15,9,1,18,27,66.7,9,31,24,7,16,41,102,0,defense
ESP-La Liga,2023,Villarreal,Santi Comesaña,ESP,MF,26.0,1996.0,18.4,44,26,15,21,8,19,38,50.0,19,33,9,24,22,66,27,1,defense
ESP-La Liga,2023,Villarreal,Stefan Lekovic,SRB,DF,19.0,2004.0,0.3,0,0,0,0,0,0,0,,0,1,1,0,0,0,1,0,defense
ESP-La Liga,2023,Villarreal,Yeremi Pino,ESP,"MF,FW",20.0,2002.0,5.3,25,18,12,10,3,9,18,50.0,9,11,1,10,5,30,5,0,defense
ESP-La Liga,2023,Villarreal,Yerson Mosquera,COL,DF,22.0,2001.0,13.7,27,13,18,7,2,12,15,80.0,3,12,2,10,17,44,65,0,defense
ESP-La Liga,2023,Villarreal,Étienne Capoue,FRA,MF,35.0,1988.0,16.2,32,18,17,12,3,15,22,68.2,7,20,4,16,22,54,24,1,defense
