league,season,team,player,nation,pos,age,born,90s,Tackles Tkl,Tackles TklW,Tackles Def 3rd,Tackles Mid 3rd,Tackles Att 3rd,Challenges Tkl,Challenges Att,Challenges Tkl%,Challenges Lost,Blocks Blocks,Blocks Sh,Blocks Pass,Int,Tkl+Int,Clr,Err,stat_type
ENG-Premier League,2022,Arsenal,Albert Sambi Lokonga,BEL,MF,22,1999,2.2,1,1,0,0,1,0,2,0.0,2,1,0,1,5,6,2,0,defense
ENG-Premier League,2022,Arsenal,Ben White,ENG,DF,24,1997,33.9,60,31,23,30,7,42,70,60.0,28,47,11,36,22,82,79,1,defense
ENG-Premier League,2022,Arsenal,Bukayo Saka,ENG,FW,20,2001,35.3,63,34,22,15,26,20,44,45.5,24,38,0,38,14,77,19,0,defense
ENG-Premier League,2022,Arsenal,Cédric Soares,POR,DF,30,1991,0.3,0,0,0,0,0,0,1,0.0,1,1,0,1,0,0,1,0,defense
ENG-Premier League,2022,Arsenal,Eddie Nketiah,ENG,FW,23,1999,12.1,13,9,6,2,5,2,10,20.0,8,7,1,6,1,14,7,0,defense
ENG-Premier League,2022,Arsenal,Emile Smith Rowe,ENG,"MF,FW",22,2000,1.9,1,1,1,0,0,1,3,33.3,2,1,0,1,0,1,2,0,defense
ENG-Premier League,2022,Arsenal,Ethan Nwaneri,ENG,FW,15,2007,0.0,0,0,0,0,0,0,0,,0,1,0,1,0,0,0,0,defense
ENG-Premier League,2022,Arsenal,Fabio Vieira,POR,"MF,FW",22,2000,5.7,6,4,3,0,3,3,5,60.0,2,5,0,5,4,10,2,0,defense
ENG-Premier League,2022,Arsenal,Gabriel Jesus,BRA,FW,25,1997,22.9,33,25,16,8,9,15,32,46.9,17,27,3,24,11,44,15,1,defense
ENG-Premier League,2022,Arsenal,Gabriel Magalhães,BRA,DF,24,1997,37.9,48,30,29,15,4,18,27,66.7,9,49,26,23,32,80,125,3,defense
ENG-Premier League,2022,Arsenal,Gabriel Martinelli,BRA,FW,21,2001,31.0,31,18,13,12,6,9,22,40.9,13,24,1,23,9,40,14,0,defense
ENG-Premier League,2022,Arsenal,Granit Xhaka,SUI,MF,29,1992,33.3,34,27,11,18,5,16,41,39.0,25,28,10,18,15,49,45,1,defense
ENG-Premier League,2022,Arsenal,Jakub Kiwior,POL,DF,22,2000,4.7,7,5,6,1,0,5,8,62.5,3,5,3,2,6,13,10,0,defense
ENG-Premier League,2022,Arsenal,Jorginho,ITA,MF,30,1991,9.5,18,13,6,10,2,5,24,20.8,19,7,2,5,9,27,8,0,defense
ENG-Premier League,2022,Arsenal,Kieran Tierney,SCO,DF,25,1997,8.8,20,11,9,9,2,12,16,75.0,4,8,2,6,11,31,25,0,defense
ENG-Premier League,2022,Arsenal,Leandro Trossard,BEL,FW,27,1994,10.3,12,7,4,2,6,6,18,33.3,12,18,0,18,6,18,3,1,defense
ENG-Premier League,2022,Arsenal,Marquinhos,BRA,MF,19,2003,0.0,0,0,0,0,0,0,0,,0,0,0,0,0,0,0,0,defense
ENG-Premier League,2022,Arsenal,Martin Ødegaard,NOR,MF,23,1998,34.7,36,23,12,14,10,14,47,29.8,33,20,5,15,6,42,12,1,defense
ENG-Premier League,2022,Arsenal,Mohamed Elneny,EGY,MF,30,1992,1.3,1,1,1,0,0,1,1,100.0,0,0,0,0,0,1,0,0,defense
ENG-Premier League,2022,Arsenal,Oleksandr Zinchenko,UKR,DF,25,1996,23.5,40,18,14,17,9,21,40,52.5,19,20,2,18,22,62,38,2,defense
ENG-Premier League,2022,Arsenal,Reiss Nelson,ENG,FW,22,1999,2.4,4,1,2,1,1,2,4,50.0,2,3,0,3,0,4,4,0,defense
ENG-Premier League,2022,Arsenal,Rob Holding,ENG,DF,26,1995,6.3,8,5,4,4,0,3,6,50.0,3,6,5,1,3,11,27,1,defense
ENG-Premier League,2022,Arsenal,Takehiro Tomiyasu,JPN,DF,23,1998,7.4,27,18,12,10,5,13,18,72.2,5,7,0,7,14,41,15,1,defense
ENG-Premier League,2022,Arsenal,Thomas Partey,GHA,MF,29,1993,27.6,70,40,20,35,15,25,52,48.1,27,26,5,21,28,98,41,1,defense
ENG-Premier League,2022,Arsenal,William Saliba,FRA,DF,21,2001,26.8,34,20,23,9,2,15,18,83.3,3,13,10,3,19,53,85,4,defense
ENG-Premier League,2022,Aston Villa,Ashley Young,ENG,DF,37,1985,22.6,50,27,34,15,1,37,50,74.0,13,25,11,14,21,71,65,0,defense
ENG-Premier League,2022,Aston Villa,Bertrand Traoré,BFA,"FW,MF",26,1995,2.6,1,1,1,0,0,1,4,25.0,3,5,0,5,2,3,0,0,defense
ENG-Premier League,2022,Aston Villa,Boubacar Kamara,FRA,MF,22,1999,19.7,58,25,25,23,10,27,56,48.2,29,38,12,26,19,77,24,3,defense
ENG-Premier League,2022,Aston Villa,Calum Chambers,ENG,"DF,MF",27,1995,3.9,9,6,7,2,0,6,8,75.0,2,5,4,1,7,16,10,1,defense
ENG-Premier League,2022,Aston Villa,Cameron Archer,ENG,"FW,MF",21,2001,0.5,0,0,0,0,0,0,0,,0,0,0,0,0,0,0,0,defense
ENG-Premier League,2022,Aston Villa,Danny Ings,ENG,FW,30,1992,9.2,10,5,1,6,3,1,6,16.7,5,12,1,11,1,11,11,0,defense
ENG-Premier League,2022,Aston Villa,Diego Carlos,BRA,DF,29,1993,2.3,1,0,0,1,0,0,1,0.0,1,2,2,0,1,2,2,0,defense
ENG-Premier League,2022,Aston Villa,Douglas Luiz,BRA,MF,24,1998,32.5,72,42,31,32,9,29,63,46.0,34,36,7,29,40,112,27,2,defense
ENG-Premier League,2022,Aston Villa,Emi Buendía,ARG,"MF,FW",25,1996,26.8,52,23,20,20,12,21,74,28.4,53,20,2,18,20,72,17,0,defense
ENG-Premier League,2022,Aston Villa,Emiliano Martínez,ARG,GK,29,1992,34.9,0,0,0,0,0,0,2,0.0,2,0,0,0,1,1,23,1,defense
ENG-Premier League,2022,Aston Villa,Ezri Konsa,ENG,DF,24,1997,36.9,42,20,25,15,2,18,26,69.2,8,41,23,18,26,68,120,3,defense
ENG-Premier League,2022,Aston Villa,Jacob Ramsey,ENG,"MF,FW",21,2001,29.3,69,39,23,35,11,32,69,46.4,37,48,8,40,23,92,34,0,defense
ENG-Premier League,2022,Aston Villa,Jan Bednarek,POL,DF,26,1996,1.1,3,3,0,3,0,1,1,100.0,0,3,1,2,2,5,5,0,defense
ENG-Premier League,2022,Aston Villa,John McGinn,SCO,"MF,FW",27,1994,29.9,66,36,27,29,10,34,71,47.9,37,43,4,39,24,90,19,0,defense
ENG-Premier League,2022,Aston Villa,Jáder Durán,COL,"FW,MF",18,2003,1.5,2,2,0,1,1,1,4,25.0,3,0,0,0,2,4,2,0,defense
ENG-Premier League,2022,Aston Villa,Leander Dendoncker,BEL,MF,27,1995,7.7,19,9,11,6,2,11,22,50.0,11,19,4,15,10,29,12,0,defense
ENG-Premier League,2022,Aston Villa,Leon Bailey,JAM,"FW,MF",24,1997,21.9,14,6,6,7,1,5,20,25.0,15,13,0,13,6,20,12,0,defense
ENG-Premier League,2022,Aston Villa,Lucas Digne,FRA,DF,29,1993,16.7,30,12,20,9,1,20,33,60.6,13,18,5,13,18,48,45,0,defense
ENG-Premier League,2022,Aston Villa,Ludwig Augustinsson,SWE,DF,28,1994,0.9,1,1,1,0,0,0,0,,0,0,0,0,0,1,1,0,defense
ENG-Premier League,2022,Aston Villa,Matty Cash,POL,DF,24,1997,20.2,55,32,36,15,4,26,37,70.3,11,20,5,15,26,81,43,0,defense
ENG-Premier League,2022,Aston Villa,Morgan Sanson,FRA,MF,27,1994,0.1,2,1,1,1,0,1,1,100.0,0,0,0,0,0,2,0,0,defense
ENG-Premier League,2022,Aston Villa,Ollie Watkins,ENG,FW,26,1995,34.7,19,13,3,13,3,10,27,37.0,17,21,4,17,10,29,39,0,defense
ENG-Premier League,2022,Aston Villa,Philippe Coutinho,BRA,"MF,FW",30,1992,8.8,19,14,8,8,3,9,15,60.0,6,11,1,10,4,23,2,0,defense
ENG-Premier League,2022,Aston Villa,Robin Olsen,SWE,GK,32,1990,3.1,0,0,0,0,0,0,2,0.0,2,0,0,0,0,0,1,0,defense
ENG-Premier League,2022,Aston Villa,Tyrone Mings,ENG,DF,29,1993,35.0,15,7,10,5,0,9,20,45.0,11,40,21,19,54,69,163,2,defense
ENG-Premier League,2022,Aston Villa,Álex Moreno,ESP,DF,29,1993,14.8,23,14,15,5,3,13,36,36.1,23,18,3,15,7,30,37,2,defense
ENG-Premier League,2022,Bournemouth,Adam Smith,ENG,DF,31,1991,32.7,49,29,27,19,3,29,60,48.3,31,30,13,17,25,74,81,1,defense
ENG-Premier League,2022,Bournemouth,Antoine Semenyo,GHA,"FW,MF",22,2000,2.9,1,0,0,0,1,1,6,16.7,5,10,1,9,2,3,4,0,defense
ENG-Premier League,2022,Bournemouth,Ben Pearson,ENG,MF,27,1995,3.2,7,3,3,3,1,1,3,33.3,2,4,0,4,2,9,6,0,defense
ENG-Premier League,2022,Bournemouth,Chris Mepham,WAL,DF,24,1997,24.4,45,22,37,8,0,19,30,63.3,11,40,27,13,30,75,152,0,defense
ENG-Premier League,2022,Bournemouth,Dango Ouattara,BFA,"MF,FW",20,2002,13.8,28,15,20,6,2,13,32,40.6,19,20,3,17,13,41,29,1,defense
ENG-Premier League,2022,Bournemouth,David Brooks,WAL,"FW,MF",25,1997,1.9,1,0,1,0,0,0,1,0.0,1,2,0,2,2,3,5,0,defense
ENG-Premier League,2022,Bournemouth,Dominic Solanke,ENG,"FW,MF",24,1997,31.8,15,9,8,3,4,5,22,22.7,17,26,7,19,6,21,46,0,defense
ENG-Premier League,2022,Bournemouth,Emiliano Marcondes,DEN,MF,27,1995,0.1,0,0,0,0,0,0,0,,0,0,0,0,0,0,1,0,defense
ENG-Premier League,2022,Bournemouth,Hamed Junior Traorè,CIV,"FW,MF",22,2000,4.7,17,11,5,9,3,6,18,33.3,12,9,0,9,2,19,1,0,defense
ENG-Premier League,2022,Bournemouth,Illia Zabarnyi,UKR,DF,19,2002,3.3,4,2,4,0,0,3,7,42.9,4,7,2,5,3,7,14,0,defense
ENG-Premier League,2022,Bournemouth,Jack Stacey,ENG,DF,26,1996,3.3,5,4,3,1,1,2,5,40.0,3,3,1,2,5,10,15,0,defense
ENG-Premier League,2022,Bournemouth,Jack Stephens,ENG,DF,28,1994,13.0,15,11,10,4,1,6,10,60.0,4,23,16,7,16,31,53,0,defense
ENG-Premier League,2022,Bournemouth,Jaidon Anthony,ENG,"MF,FW",22,1999,14.0,30,17,15,9,6,8,24,33.3,16,30,3,27,10,40,19,0,defense
ENG-Premier League,2022,Bournemouth,Jamal Lowe,JAM,"MF,FW",28,1994,0.1,0,0,0,0,0,0,0,,0,0,0,0,0,0,0,0,defense
ENG-Premier League,2022,Bournemouth,Jefferson Lerma,COL,MF,27,1994,36.1,50,30,23,23,4,20,45,44.4,25,32,15,17,47,97,91,2,defense
ENG-Premier League,2022,Bournemouth,Joe Rothwell,ENG,MF,27,1995,11.3,20,13,7,12,1,7,21,33.3,14,14,3,11,9,29,7,0,defense
ENG-Premier League,2022,Bournemouth,Jordan Zemura,ZIM,DF,22,1999,16.2,39,24,24,14,1,23,44,52.3,21,31,9,22,16,55,32,0,defense
ENG-Premier League,2022,Bournemouth,Junior Stanislas,ENG,MF,32,1989,0.7,0,0,0,0,0,0,0,,0,2,1,1,0,0,0,0,defense
ENG-Premier League,2022,Bournemouth,Kieffer Moore,WAL,FW,29,1992,14.2,14,11,2,9,3,5,16,31.3,11,12,5,7,1,15,26,0,defense
ENG-Premier League,2022,Bournemouth,Lewis Cook,ENG,MF,25,1997,19.1,37,22,10,22,5,18,44,40.9,26,29,10,19,23,60,31,0,defense
ENG-Premier League,2022,Bournemouth,Lloyd Kelly,ENG,DF,23,1998,22.7,33,18,23,9,1,13,19,68.4,6,26,15,11,26,59,101,1,defense
ENG-Premier League,2022,Bournemouth,Marcos Senesi,ARG,DF,25,1997,27.7,50,35,28,22,0,23,44,52.3,21,38,20,18,43,93,146,2,defense
ENG-Premier League,2022,Bournemouth,Marcus Tavernier,ENG,"MF,FW",23,1999,19.4,33,22,19,11,3,11,33,33.3,22,25,4,21,9,42,23,0,defense
ENG-Premier League,2022,Bournemouth,Mark Travers,IRL,GK,23,1999,11.5,0,0,0,0,0,0,0,,0,1,0,1,0,0,6,0,defense
ENG-Premier League,2022,Bournemouth,Matías Viña,URU,DF,24,1997,5.1,19,11,9,8,2,14,30,46.7,16,13,1,12,4,23,22,0,defense
ENG-Premier League,2022,Bournemouth,Neto,BRA,GK,33,1989,26.5,3,1,3,0,0,3,3,100.0,0,0,0,0,0,3,10,3,defense
ENG-Premier League,2022,Bournemouth,Owen Bevan,WAL,DF,18,2003,0.1,0,0,0,0,0,0,0,,0,0,0,0,0,0,0,0,defense
ENG-Premier League,2022,Bournemouth,Philip Billing,DEN,"MF,FW",26,1996,30.7,63,36,21,33,9,11,42,26.2,31,48,8,40,31,94,58,1,defense
ENG-Premier League,2022,Bournemouth,Ryan Christie,SCO,"MF,FW",27,1995,20.4,34,22,10,23,1,14,50,28.0,36,16,4,12,26,60,20,0,defense
ENG-Premier League,2022,Bournemouth,Ryan Fredericks,ENG,DF,29,1992,5.9,3,2,2,0,1,1,4,25.0,3,7,2,5,1,4,27,0,defense
ENG-Premier League,2022,Bournemouth,Siriki Dembélé,CIV,"FW,MF",25,1996,1.2,3,1,2,1,0,0,1,0.0,1,1,0,1,1,4,1,0,defense
ENG-Premier League,2022,Brentford,Aaron Hickey,SCO,DF,20,2002,21.3,38,26,27,11,0,18,32,56.3,14,18,7,11,17,55,32,1,defense
ENG-Premier League,2022,Brentford,Ben Mee,ENG,DF,32,1989,36.3,45,24,28,13,4,20,37,54.1,17,54,42,12,48,93,122,2,defense
ENG-Premier League,2022,Brentford,Bryan Mbeumo,CMR,FW,22,1999,32.3,26,18,5,13,8,8,42,19.0,34,24,1,23,13,39,21,0,defense
ENG-Premier League,2022,Brentford,Christian Nørgaard,DEN,MF,28,1994,19.6,52,30,21,29,2,18,48,37.5,30,32,9,23,34,86,41,2,defense
ENG-Premier League,2022,Brentford,David Raya,ESP,GK,26,1995,38.0,0,0,0,0,0,0,2,0.0,2,1,0,1,1,1,10,3,defense
ENG-Premier League,2022,Brentford,Ethan Pinnock,JAM,DF,29,1993,30.0,52,28,33,12,7,18,24,75.0,6,41,31,10,35,87,215,2,defense
ENG-Premier League,2022,Brentford,Frank Onyeka,NGA,MF,24,1998,9.4,19,14,11,7,1,10,24,41.7,14,16,3,13,10,29,16,0,defense
ENG-Premier League,2022,Brentford,Halil Dervişoğlu,TUR,MF,22,1999,0.1,0,0,0,0,0,0,1,0.0,1,0,0,0,0,0,0,0,defense
ENG-Premier League,2022,Brentford,Ivan Toney,ENG,FW,26,1996,32.8,23,13,4,9,10,7,23,30.4,16,24,9,15,14,37,36,0,defense
ENG-Premier League,2022,Brentford,Josh Dasilva,ENG,MF,23,1998,15.4,18,9,6,6,6,6,15,40.0,9,22,6,16,5,23,7,1,defense
ENG-Premier League,2022,Brentford,Keane Lewis-Potter,ENG,"FW,MF",21,2001,3.6,1,0,0,1,0,0,0,,0,5,1,4,0,1,2,0,defense
ENG-Premier League,2022,Brentford,Kevin Schade,GER,FW,20,2001,8.1,12,8,7,2,3,5,10,50.0,5,7,0,7,4,16,6,0,defense
ENG-Premier League,2022,Brentford,Kristoffer Ajer,NOR,DF,24,1998,8.5,11,8,5,4,2,9,16,56.3,7,6,5,1,7,18,22,0,defense
ENG-Premier League,2022,Brentford,Mads Bech Sørensen,DEN,"DF,MF",23,1999,0.2,0,0,0,0,0,0,0,,0,0,0,0,1,1,1,0,defense
ENG-Premier League,2022,Brentford,Mads Roerslev,DEN,DF,23,1999,12.3,22,12,19,3,0,16,33,48.5,17,14,5,9,9,31,38,0,defense
ENG-Premier League,2022,Brentford,Mathias Jensen,DEN,MF,26,1996,31.1,71,36,29,30,12,34,97,35.1,63,54,5,49,32,103,24,1,defense
ENG-Premier League,2022,Brentford,Mathias Jørgensen,DEN,DF,32,1990,12.3,17,8,9,8,0,9,21,42.9,12,19,12,7,16,33,39,1,defense
ENG-Premier League,2022,Brentford,Mikkel Damsgaard,DEN,"MF,FW",22,2000,11.0,31,21,13,13,5,15,42,35.7,27,20,2,18,10,41,14,0,defense
ENG-Premier League,2022,Brentford,Pontus Jansson,SWE,DF,31,1991,8.0,5,3,4,1,0,3,5,60.0,2,13,9,4,9,14,38,0,defense
ENG-Premier League,2022,Brentford,Rico Henry,ENG,DF,25,1997,36.0,57,31,20,28,9,22,41,53.7,19,29,8,21,30,87,84,1,defense
ENG-Premier League,2022,Brentford,Saman Ghoddos,IRN,"MF,FW",28,1993,1.5,2,1,0,1,1,1,3,33.3,2,5,1,4,4,6,2,0,defense
ENG-Premier League,2022,Brentford,Sergi Canós,ESP,"FW,DF",25,1997,0.9,0,0,0,0,0,0,2,0.0,2,3,1,2,0,0,1,0,defense
ENG-Premier League,2022,Brentford,Shandon Baptiste,GRN,MF,24,1998,6.9,15,9,6,6,3,7,17,41.2,10,10,2,8,7,22,10,0,defense
ENG-Premier League,2022,Brentford,Vitaly Janelt,GER,"MF,DF",24,1998,24.5,54,27,20,24,10,21,49,42.9,28,29,9,20,29,83,26,0,defense
ENG-Premier League,2022,Brentford,Yoane Wissa,COD,FW,25,1996,17.8,17,12,4,7,6,6,13,46.2,7,10,0,10,6,23,15,0,defense
ENG-Premier League,2022,Brighton,Adam Lallana,ENG,"MF,FW",34,1988,8.0,9,4,6,2,1,0,7,0.0,7,6,0,6,2,11,1,0,defense
ENG-Premier League,2022,Brighton,Adam Webster,ENG,DF,27,1995,22.1,22,12,10,9,3,11,19,57.9,8,30,19,11,19,41,55,4,defense
ENG-Premier League,2022,Brighton,Alexis Mac Allister,ARG,MF,23,1998,32.1,70,39,22,40,8,34,71,47.9,37,26,2,24,22,92,10,1,defense
ENG-Premier League,2022,Brighton,Andrew Moran,IRL,FW,18,2003,0.1,0,0,0,0,0,0,0,,0,1,0,1,0,0,0,0,defense
ENG-Premier League,2022,Brighton,Billy Gilmour,SCO,MF,21,2001,5.6,5,2,2,2,1,2,8,25.0,6,5,2,3,6,11,5,0,defense
ENG-Premier League,2022,Brighton,Cameron Peupion,AUS,MF,19,2002,0.1,0,0,0,0,0,0,0,,0,0,0,0,0,0,0,0,defense
ENG-Premier League,2022,Brighton,Danny Welbeck,ENG,FW,31,1990,20.6,15,7,0,7,8,4,11,36.4,7,24,2,22,5,20,20,0,defense
ENG-Premier League,2022,Brighton,Deniz Undav,GER,"FW,MF",26,1996,7.0,7,4,2,2,3,2,8,25.0,6,4,1,3,0,7,1,0,defense
ENG-Premier League,2022,Brighton,Enock Mwepu,ZAM,"FW,MF",24,1998,2.4,10,5,1,6,3,3,4,75.0,1,3,1,2,1,11,1,0,defense
ENG-Premier League,2022,Brighton,Evan Ferguson,IRL,FW,17,2004,10.6,6,3,1,3,2,1,7,14.3,6,11,1,10,2,8,6,0,defense
ENG-Premier League,2022,Brighton,Facundo Buonanotte,ARG,"FW,MF",17,2004,6.3,2,1,1,1,0,1,22,4.5,21,5,2,3,4,6,3,0,defense
ENG-Premier League,2022,Brighton,Jack Hinshelwood,ENG,FW,17,2005,0.0,1,0,1,0,0,0,0,,0,0,0,0,0,1,0,0,defense
ENG-Premier League,2022,Brighton,Jan Paul van Hecke,NED,DF,22,2000,3.3,8,6,3,4,1,5,5,100.0,0,8,5,3,6,14,9,0,defense
ENG-Premier League,2022,Brighton,Jason Steele,ENG,GK,31,1990,15.0,0,0,0,0,0,0,1,0.0,1,0,0,0,0,0,6,1,defense
ENG-Premier League,2022,Brighton,Jeremy Sarmiento,ECU,MF,20,2002,2.0,6,3,4,1,1,2,5,40.0,3,2,0,2,1,7,0,0,defense
ENG-Premier League,2022,Brighton,Joël Veltman,NED,DF,30,1992,24.3,62,32,44,14,4,37,57,64.9,20,27,8,19,19,81,51,0,defense
ENG-Premier League,2022,Brighton,Julio Enciso,PAR,"FW,MF",18,2004,9.0,13,4,3,6,4,8,13,61.5,5,9,0,9,4,17,2,0,defense
ENG-Premier League,2022,Brighton,Kaoru Mitoma,JPN,"FW,MF",25,1997,25.8,44,27,15,16,13,20,41,48.8,21,25,0,25,17,61,10,0,defense
ENG-Premier League,2022,Brighton,Leandro Trossard,BEL,"FW,MF",27,1994,14.6,10,6,7,1,2,1,8,12.5,7,17,0,17,6,16,1,0,defense
ENG-Premier League,2022,Brighton,Levi Colwill,ENG,DF,19,2003,13.6,8,7,4,4,0,4,9,44.4,5,5,3,2,15,23,37,1,defense
ENG-Premier League,2022,Brighton,Lewis Dunk,ENG,DF,30,1991,36.0,30,19,19,9,2,18,41,43.9,23,37,27,10,34,64,81,1,defense
ENG-Premier League,2022,Brighton,Moisés Caicedo,ECU,MF,20,2001,34.9,100,50,41,47,12,40,68,58.8,28,43,7,36,56,156,31,3,defense
ENG-Premier League,2022,Brighton,Odeluga Offiah,ENG,DF,19,2002,0.3,1,1,1,0,0,0,2,0.0,2,0,0,0,0,1,1,0,defense
ENG-Premier League,2022,Brighton,Pascal Groß,GER,"MF,DF",31,1991,36.0,59,38,23,27,9,25,55,45.5,30,32,10,22,13,72,21,1,defense
ENG-Premier League,2022,Brighton,Pervis Estupiñán,ECU,DF,24,1998,29.7,61,31,36,19,6,35,60,58.3,25,30,8,22,37,98,37,1,defense
ENG-Premier League,2022,Brighton,Robert Sánchez,ESP,GK,24,1997,23.0,1,0,1,0,0,0,0,,0,0,0,0,3,4,9,2,defense
ENG-Premier League,2022,Brighton,Solly March,ENG,"FW,DF",28,1994,30.2,53,31,16,17,20,8,28,28.6,20,34,3,31,24,77,32,0,defense
ENG-Premier League,2022,Brighton,Tariq Lamptey,GHA,DF,21,2000,5.0,11,6,6,4,1,5,7,71.4,2,7,3,4,7,18,2,0,defense
ENG-Premier League,2022,Brighton,Yasin Ayari,SWE,MF,18,2003,0.7,2,2,1,1,0,0,4,0.0,4,1,0,1,0,2,0,0,defense
ENG-Premier League,2022,Chelsea,Armando Broja,ALB,FW,20,2001,3.3,4,1,0,3,1,1,1,100.0,0,10,1,9,1,5,1,0,defense
ENG-Premier League,2022,Chelsea,Ben Chilwell,ENG,"DF,MF",25,1996,15.6,21,17,12,8,1,13,25,52.0,12,21,2,19,18,39,26,0,defense
ENG-Premier League,2022,Chelsea,Benoît Badiashile,FRA,DF,21,2001,10.1,14,8,10,4,0,9,14,64.3,5,5,2,3,16,30,34,1,defense
ENG-Premier League,2022,Chelsea,Carney Chukwuemeka,ENG,"MF,FW",18,2003,3.9,13,7,7,6,0,3,5,60.0,2,7,0,7,6,19,1,0,defense
ENG-Premier League,2022,Chelsea,Christian Pulisic,USA,"FW,DF",23,1998,9.1,11,6,3,6,2,3,5,60.0,2,8,1,7,4,15,4,0,defense
ENG-Premier League,2022,Chelsea,Conor Gallagher,ENG,MF,22,2000,18.0,46,33,17,19,10,10,37,27.0,27,41,10,31,23,69,18,1,defense
ENG-Premier League,2022,Chelsea,César Azpilicueta,ESP,DF,32,1989,17.0,43,25,23,15,5,22,37,59.5,15,26,5,21,19,62,54,1,defense
ENG-Premier League,2022,Chelsea,David Datro Fofana,CIV,FW,19,2002,0.8,3,1,1,1,1,1,1,100.0,0,1,0,1,0,3,0,0,defense
ENG-Premier League,2022,Chelsea,Denis Zakaria,SUI,MF,25,1996,4.6,9,5,5,2,2,2,8,25.0,6,4,1,3,3,12,10,0,defense
ENG-Premier League,2022,Chelsea,Edouard Mendy,SEN,GK,30,1992,9.5,0,0,0,0,0,0,0,,0,0,0,0,0,0,3,3,defense
ENG-Premier League,2022,Chelsea,Enzo Fernández,ARG,MF,21,2001,17.2,45,27,25,17,3,21,56,37.5,35,32,2,30,16,61,12,1,defense
ENG-Premier League,2022,Chelsea,Hakim Ziyech,MAR,"FW,MF",29,1993,7.3,20,12,12,5,3,4,9,44.4,5,8,0,8,5,25,5,1,defense
ENG-Premier League,2022,Chelsea,Jorginho,ITA,MF,30,1991,14.2,42,23,22,14,6,22,46,47.8,24,18,3,15,21,63,7,0,defense
ENG-Premier League,2022,Chelsea,João Félix,POR,"FW,MF",22,1999,10.5,14,7,5,6,3,4,12,33.3,8,3,0,3,1,15,1,1,defense
ENG-Premier League,2022,Chelsea,Kai Havertz,GER,"FW,MF",23,1999,28.5,34,16,4,20,10,10,30,33.3,20,28,0,28,7,41,41,0,defense
ENG-Premier League,2022,Chelsea,Kalidou Koulibaly,SEN,DF,31,1991,20.0,45,31,34,8,3,26,40,65.0,14,30,13,17,29,74,77,0,defense
ENG-Premier League,2022,Chelsea,Kepa Arrizabalaga,ESP,GK,27,1994,28.5,2,2,2,0,0,2,3,66.7,1,0,0,0,1,3,16,2,defense
ENG-Premier League,2022,Chelsea,Lewis Hall,ENG,DF,17,2004,7.3,23,12,19,4,0,15,22,68.2,7,8,0,8,11,34,11,1,defense
ENG-Premier League,2022,Chelsea,Marc Cucurella,ESP,DF,24,1998,18.6,66,33,40,15,11,30,60,50.0,30,28,8,20,16,82,48,1,defense
ENG-Premier League,2022,Chelsea,Mason Mount,ENG,"MF,FW",23,1999,18.3,33,19,6,16,11,14,27,51.9,13,24,6,18,8,41,9,0,defense
ENG-Premier League,2022,Chelsea,Mateo Kovačić,CRO,MF,28,1994,19.0,36,24,16,14,6,14,36,38.9,22,10,1,9,19,55,16,0,defense
ENG-Premier League,2022,Chelsea,Mykhailo Mudryk,UKR,"FW,MF",21,2001,7.3,11,9,2,4,5,4,13,30.8,9,7,1,6,0,11,3,0,defense
ENG-Premier League,2022,Chelsea,N'Golo Kanté,FRA,MF,31,1991,5.8,16,10,4,10,2,4,8,50.0,4,11,0,11,6,22,2,0,defense
ENG-Premier League,2022,Chelsea,Noni Madueke,ENG,FW,20,2002,7.1,12,8,5,4,3,6,13,46.2,7,13,2,11,4,16,7,0,defense
ENG-Premier League,2022,Chelsea,Omari Hutchinson,ENG,FW,18,2003,0.3,0,0,0,0,0,0,0,,0,0,0,0,1,1,0,0,defense
ENG-Premier League,2022,Chelsea,Pierre-Emerick Aubameyang,GAB,FW,33,1989,6.2,1,0,1,0,0,0,1,0.0,1,2,0,2,2,3,4,2,defense
ENG-Premier League,2022,Chelsea,Raheem Sterling,ENG,"FW,MF",27,1994,21.0,18,10,5,4,9,8,14,57.1,6,17,0,17,2,20,5,0,defense
ENG-Premier League,2022,Chelsea,Reece James,ENG,"DF,MF",22,1999,13.8,31,20,10,18,3,15,19,78.9,4,17,2,15,12,43,23,0,defense
ENG-Premier League,2022,Chelsea,Ruben Loftus-Cheek,ENG,"MF,DF",26,1996,17.1,25,14,8,14,3,12,22,54.5,10,15,2,13,12,37,23,0,defense
ENG-Premier League,2022,Chelsea,Thiago Silva,BRA,DF,37,1984,26.1,41,27,24,17,0,21,31,67.7,10,38,29,9,34,75,111,3,defense
ENG-Premier League,2022,Chelsea,Trevoh Chalobah,ENG,DF,23,1999,17.9,31,20,22,6,3,24,35,68.6,11,17,7,10,24,55,56,1,defense
ENG-Premier League,2022,Chelsea,Wesley Fofana,FRA,DF,21,2000,13.1,30,18,19,7,4,13,26,50.0,13,17,10,7,20,50,33,2,defense
ENG-Premier League,2022,Crystal Palace,Albert Sambi Lokonga,BEL,MF,22,1999,6.0,13,10,7,4,2,8,12,66.7,4,8,3,5,7,20,10,0,defense
ENG-Premier League,2022,Crystal Palace,Cheick Doucouré,MLI,MF,22,2000,30.8,77,46,40,33,4,29,52,55.8,23,47,13,34,56,133,48,0,defense
ENG-Premier League,2022,Crystal Palace,Chris Richards,USA,DF,22,2000,5.0,9,6,8,1,0,5,7,71.4,2,10,1,9,8,17,31,0,defense
ENG-Premier League,2022,Crystal Palace,David Ozoh,ENG,FW,17,2005,0.0,0,0,0,0,0,0,0,,0,0,0,0,0,0,0,0,defense
ENG-Premier League,2022,Crystal Palace,Eberechi Eze,ENG,"MF,FW",24,1998,29.3,42,24,17,18,7,18,38,47.4,20,22,0,22,13,55,10,0,defense
ENG-Premier League,2022,Crystal Palace,James McArthur,SCO,MF,34,1987,0.6,1,1,1,0,0,1,1,100.0,0,2,1,1,1,2,2,0,defense
ENG-Premier League,2022,Crystal Palace,James Tomkins,ENG,DF,33,1989,3.8,4,2,2,1,1,1,3,33.3,2,3,2,1,5,9,19,0,defense
ENG-Premier League,2022,Crystal Palace,Jaïro Riedewald,NED,"DF,MF",25,1996,0.7,2,1,2,0,0,0,1,0.0,1,2,0,2,0,2,4,0,defense
ENG-Premier League,2022,Crystal Palace,Jean-Philippe Mateta,FRA,FW,25,1997,8.6,7,1,2,4,1,1,3,33.3,2,3,1,2,3,10,18,0,defense
ENG-Premier League,2022,Crystal Palace,Jeffrey Schlupp,GHA,"MF,FW",29,1992,28.1,66,46,28,29,9,22,43,51.2,21,39,8,31,23,89,38,0,defense
ENG-Premier League,2022,Crystal Palace,Joachim Andersen,DEN,DF,26,1996,30.9,42,22,30,12,0,16,32,50.0,16,28,13,15,24,66,188,1,defense
ENG-Premier League,2022,Crystal Palace,Joel Ward,ENG,DF,32,1989,25.1,50,36,30,11,9,30,41,73.2,11,32,16,16,25,75,80,1,defense
ENG-Premier League,2022,Crystal Palace,Jordan Ayew,GHA,"FW,MF",30,1991,30.2,66,41,23,20,23,21,53,39.6,32,35,4,31,15,81,31,0,defense
ENG-Premier League,2022,Crystal Palace,Joseph Whitworth,ENG,GK,18,2004,2.0,0,0,0,0,0,0,0,,0,0,0,0,0,0,1,0,defense
ENG-Premier League,2022,Crystal Palace,Luka Milivojević,SRB,MF,31,1991,5.7,13,7,7,4,2,7,10,70.0,3,13,4,9,12,25,10,1,defense
ENG-Premier League,2022,Crystal Palace,Malcolm Ebiowei,ENG,"MF,FW",18,2003,0.4,1,1,1,0,0,0,1,0.0,1,2,0,2,0,1,0,0,defense
ENG-Premier League,2022,Crystal Palace,Marc Guéhi,ENG,DF,22,2000,37.0,52,27,39,11,2,26,42,61.9,16,45,24,21,45,97,134,3,defense
ENG-Premier League,2022,Crystal Palace,Michael Olise,FRA,"FW,MF",20,2001,30.5,58,34,28,26,4,25,60,41.7,35,46,1,45,26,84,17,0,defense
ENG-Premier League,2022,Crystal Palace,Naouirou Ahamada,FRA,"MF,FW",20,2002,1.0,3,2,3,0,0,1,3,33.3,2,2,0,2,0,3,0,0,defense
ENG-Premier League,2022,Crystal Palace,Nathaniel Clyne,ENG,DF,31,1991,18.2,27,16,13,9,5,14,23,60.9,9,22,4,18,19,46,34,0,defense
ENG-Premier League,2022,Crystal Palace,Odsonne Édouard,FRA,FW,24,1998,20.0,25,13,7,12,6,7,13,53.8,6,17,5,12,3,28,22,0,defense
ENG-Premier League,2022,Crystal Palace,Sam Johnstone,ENG,GK,29,1993,9.0,0,0,0,0,0,0,0,,0,0,0,0,0,0,5,0,defense
ENG-Premier League,2022,Crystal Palace,Tyrick Mitchell,ENG,DF,22,1999,32.1,71,49,43,23,5,30,53,56.6,23,48,11,37,42,113,78,0,defense
ENG-Premier League,2022,Crystal Palace,Vicente Guaita,ESP,GK,35,1987,27.0,0,0,0,0,0,0,0,,0,0,0,0,0,0,9,1,defense
ENG-Premier League,2022,Crystal Palace,Wilfried Zaha,CIV,"FW,MF",29,1992,25.4,32,20,12,12,8,8,21,38.1,13,21,1,20,16,48,9,0,defense
ENG-Premier League,2022,Crystal Palace,Will Hughes,ENG,MF,27,1995,9.4,29,16,11,16,2,11,20,55.0,9,16,7,9,16,45,9,0,defense
ENG-Premier League,2022,Everton,Abdoulaye Doucouré,MLI,MF,29,1993,17.0,31,20,9,15,7,12,37,32.4,25,26,3,23,13,44,11,0,defense
ENG-Premier League,2022,Everton,Alex Iwobi,NGA,"MF,FW",26,1996,37.5,69,37,37,28,4,33,65,50.8,32,41,2,39,25,94,29,0,defense
ENG-Premier League,2022,Everton,Amadou Onana,BEL,MF,20,2001,27.6,72,43,24,42,6,30,42,71.4,12,25,6,19,37,109,39,0,defense
ENG-Premier League,2022,Everton,Anthony Gordon,ENG,FW,21,2001,12.2,34,22,17,10,7,8,24,33.3,16,19,0,19,4,38,11,0,defense
ENG-Premier League,2022,Everton,Asmir Begović,BIH,GK,35,1987,1.0,0,0,0,0,0,0,0,,0,0,0,0,0,0,1,0,defense
ENG-Premier League,2022,Everton,Ben Godfrey,ENG,DF,24,1998,8.9,20,11,13,5,2,11,29,37.9,18,12,6,6,8,28,33,1,defense
ENG-Premier League,2022,Everton,Conor Coady,ENG,DF,29,1993,23.3,14,9,8,6,0,7,15,46.7,8,21,17,4,14,28,88,3,defense
ENG-Premier League,2022,Everton,Dele Alli,ENG,MF,26,1996,0.4,0,0,0,0,0,0,0,,0,0,0,0,0,0,0,0,defense
ENG-Premier League,2022,Everton,Demarai Gray,JAM,"FW,MF",26,1996,27.9,33,24,9,14,10,17,31,54.8,14,23,3,20,13,46,18,0,defense
ENG-Premier League,2022,Everton,Dominic Calvert-Lewin,ENG,FW,25,1997,12.9,4,2,1,0,3,1,5,20.0,4,5,1,4,3,7,18,0,defense
ENG-Premier League,2022,Everton,Dwight McNeil,ENG,"FW,MF",22,1999,27.8,64,41,35,14,15,27,65,41.5,38,46,7,39,31,95,41,0,defense
ENG-Premier League,2022,Everton,Ellis Simms,ENG,FW,21,2001,2.5,0,0,0,0,0,0,0,,0,0,0,0,0,0,1,0,defense
ENG-Premier League,2022,Everton,Idrissa Gana Gueye,SEN,MF,32,1989,28.6,97,57,49,35,13,31,62,50.0,31,50,12,38,56,153,34,3,defense
ENG-Premier League,2022,Everton,Isaac Price,NIR,MF,18,2003,0.4,0,0,0,0,0,0,1,0.0,1,1,1,0,0,0,0,0,defense
ENG-Premier League,2022,Everton,James Garner,ENG,"MF,DF",21,2001,8.9,16,13,4,8,4,9,19,47.4,10,9,1,8,12,28,13,0,defense
ENG-Premier League,2022,Everton,James Tarkowski,ENG,DF,29,1992,38.0,51,26,36,13,2,20,39,51.3,19,99,78,21,51,102,201,3,defense
ENG-Premier League,2022,Everton,Jordan Pickford,ENG,GK,28,1994,37.0,0,0,0,0,0,0,1,0.0,1,0,0,0,4,4,15,3,defense
ENG-Premier League,2022,Everton,Mason Holgate,ENG,DF,25,1996,5.6,11,7,8,3,0,3,11,27.3,8,7,3,4,7,18,28,0,defense
ENG-Premier League,2022,Everton,Michael Keane,ENG,DF,29,1993,10.9,7,4,5,2,0,5,8,62.5,3,12,7,5,14,21,55,1,defense
ENG-Premier League,2022,Everton,Nathan Patterson,SCO,"DF,MF",20,2001,14.2,49,24,32,13,4,29,54,53.7,25,24,4,20,15,64,45,0,defense
ENG-Premier League,2022,Everton,Neal Maupay,FRA,FW,25,1996,12.4,11,5,3,4,4,2,4,50.0,2,8,0,8,5,16,0,0,defense
ENG-Premier League,2022,Everton,Rúben Vinagre,POR,"DF,MF",23,1999,0.3,2,2,1,1,0,1,2,50.0,1,0,0,0,0,2,1,0,defense
ENG-Premier League,2022,Everton,Salomón Rondón,VEN,FW,32,1989,1.2,0,0,0,0,0,0,0,,0,1,1,0,0,0,0,0,defense
ENG-Premier League,2022,Everton,Séamus Coleman,IRL,DF,33,1988,18.4,35,26,21,10,4,19,29,65.5,10,14,7,7,22,57,58,2,defense
ENG-Premier League,2022,Everton,Thomas Cannon,IRL,FW,19,2002,0.3,0,0,0,0,0,0,0,,0,0,0,0,0,0,0,0,defense
ENG-Premier League,2022,Everton,Tom Davies,ENG,MF,24,1998,6.0,15,9,5,9,1,7,14,50.0,7,10,1,9,4,19,7,1,defense
ENG-Premier League,2022,Everton,Vitaliy Mykolenko,UKR,DF,23,1999,29.5,58,34,36,19,3,28,51,54.9,23,50,16,34,46,104,99,0,defense
ENG-Premier League,2022,Everton,Yerry Mina,COL,DF,27,1994,6.6,15,8,9,6,0,9,11,81.8,2,7,4,3,6,21,28,0,defense
ENG-Premier League,2022,Fulham,Aleksandar Mitrović,SRB,FW,27,1994,22.3,14,7,8,4,2,5,12,41.7,7,22,5,17,3,17,20,1,defense
ENG-Premier League,2022,Fulham,Andreas Pereira,BRA,MF,26,1996,29.9,18,9,3,6,9,8,34,23.5,26,21,3,18,6,24,8,0,defense
ENG-Premier League,2022,Fulham,Antonee Robinson,USA,DF,24,1997,34.3,62,38,43,15,4,44,65,67.7,21,49,13,36,53,115,83,3,defense
ENG-Premier League,2022,Fulham,Bernd Leno,GER,GK,30,1992,36.0,0,0,0,0,0,0,3,0.0,3,0,0,0,0,0,18,1,defense
ENG-Premier League,2022,Fulham,Bobby Reid,JAM,"FW,DF",29,1993,27.5,42,24,14,14,14,16,36,44.4,20,25,3,22,20,62,28,1,defense
ENG-Premier League,2022,Fulham,Carlos Vinícius,BRA,FW,27,1995,12.3,4,1,0,2,2,0,4,0.0,4,7,0,7,0,4,10,0,defense
ENG-Premier League,2022,Fulham,Cédric Soares,POR,DF,30,1991,2.2,8,5,4,3,1,3,3,100.0,0,3,1,2,1,9,5,0,defense
ENG-Premier League,2022,Fulham,Daniel James,WAL,FW,24,1997,6.9,10,6,4,5,1,4,9,44.4,5,5,1,4,1,11,5,0,defense
ENG-Premier League,2022,Fulham,Harrison Reed,ENG,MF,27,1995,31.8,44,27,17,21,6,16,51,31.4,35,54,12,42,19,63,36,0,defense
ENG-Premier League,2022,Fulham,Harry Wilson,WAL,FW,25,1997,12.2,21,13,9,9,3,8,18,44.4,10,17,2,15,6,27,14,0,defense
ENG-Premier League,2022,Fulham,Issa Diop,FRA,DF,25,1997,22.4,28,19,18,9,1,17,32,53.1,15,24,17,7,35,63,86,0,defense
ENG-Premier League,2022,Fulham,Jay Stansfield,ENG,FW,19,2002,1.0,0,0,0,0,0,0,2,0.0,2,4,1,3,1,1,1,0,defense
ENG-Premier League,2022,Fulham,Josh Onomah,ENG,MF,25,1997,0.2,1,0,1,0,0,0,0,,0,1,0,1,0,1,0,0,defense
ENG-Premier League,2022,Fulham,João Palhinha,POR,MF,27,1995,34.5,148,83,59,65,24,71,135,52.6,64,48,5,43,46,194,61,2,defense
ENG-Premier League,2022,Fulham,Kenny Tete,NED,DF,26,1995,28.5,83,46,41,29,13,38,51,74.5,13,48,17,31,52,135,81,1,defense
ENG-Premier League,2022,Fulham,Kevin Mbabu,SUI,"DF,FW",27,1995,1.6,3,2,2,1,0,1,3,33.3,2,2,0,2,3,6,3,0,defense
ENG-Premier League,2022,Fulham,Layvin Kurzawa,FRA,DF,29,1992,1.5,3,2,1,1,1,3,3,100.0,0,1,1,0,2,5,4,0,defense
ENG-Premier League,2022,Fulham,Luke Harris,WAL,"MF,FW",17,2005,0.1,0,0,0,0,0,0,0,,0,0,0,0,0,0,0,0,defense
ENG-Premier League,2022,Fulham,Manor Solomon,ISR,FW,23,1999,6.4,20,12,12,6,2,9,16,56.3,7,8,0,8,5,25,3,0,defense
ENG-Premier League,2022,Fulham,Marek Rodák,SVK,GK,25,1996,2.0,0,0,0,0,0,0,0,,0,0,0,0,0,0,1,1,defense
ENG-Premier League,2022,Fulham,Nathaniel Chalobah,ENG,MF,27,1994,0.1,1,1,1,0,0,1,1,100.0,0,0,0,0,0,1,2,0,defense
ENG-Premier League,2022,Fulham,Neeskens Kebano,COD,FW,30,1992,8.5,17,9,8,6,3,9,18,50.0,9,14,0,14,1,18,8,0,defense
ENG-Premier League,2022,Fulham,Saša Lukić,SRB,MF,25,1996,4.6,8,3,1,4,3,3,7,42.9,4,6,2,4,5,13,3,0,defense
ENG-Premier League,2022,Fulham,Shane Duffy,IRL,"DF,FW",30,1992,0.2,0,0,0,0,0,0,0,,0,0,0,0,0,0,0,1,defense
ENG-Premier League,2022,Fulham,Tim Ream,USA,DF,34,1987,32.2,30,16,15,12,3,13,26,50.0,13,45,24,21,41,71,116,3,defense
ENG-Premier League,2022,Fulham,Tom Cairney,SCO,MF,31,1991,11.0,17,6,4,8,5,7,10,70.0,3,18,3,15,5,22,3,0,defense
ENG-Premier League,2022,Fulham,Tosin Adarabioyo,ENG,DF,24,1997,23.2,30,13,22,6,2,16,23,69.6,7,20,15,5,26,56,140,1,defense
ENG-Premier League,2022,Fulham,Tyrese Francois,AUS,FW,22,2000,0.0,0,0,0,0,0,0,1,0.0,1,0,0,0,0,0,1,0,defense
ENG-Premier League,2022,Fulham,Willian,BRA,FW,33,1988,23.6,13,8,8,3,2,7,25,28.0,18,13,0,13,9,22,9,0,defense
ENG-Premier League,2022,Leeds United,Adam Forshaw,ENG,MF,30,1991,5.3,12,9,5,7,0,7,17,41.2,10,9,1,8,4,16,2,0,defense
ENG-Premier League,2022,Leeds United,Brenden Aaronson,USA,"MF,FW",21,2000,26.4,45,18,16,22,7,15,46,32.6,31,43,3,40,5,50,6,1,defense
ENG-Premier League,2022,Leeds United,Cody Drameh,ENG,DF,20,2001,0.8,5,4,0,4,1,2,3,66.7,1,0,0,0,1,6,1,0,defense
ENG-Premier League,2022,Leeds United,Crysencio Summerville,NED,FW,20,2001,15.8,30,20,14,14,2,11,23,47.8,12,20,2,18,13,43,11,0,defense
ENG-Premier League,2022,Leeds United,Daniel James,WAL,FW,24,1997,2.2,6,2,1,3,2,3,6,50.0,3,4,0,4,2,8,2,0,defense
ENG-Premier League,2022,Leeds United,Darko Gyabi,ENG,FW,18,2004,0.1,2,2,1,1,0,0,0,,0,2,0,2,0,2,0,0,defense
ENG-Premier League,2022,Leeds United,Diego Llorente,ESP,DF,28,1993,7.2,13,10,8,5,0,4,8,50.0,4,6,2,4,15,28,24,2,defense
ENG-Premier League,2022,Leeds United,Georginio Rutter,FRA,"FW,MF",20,2002,3.0,10,9,5,3,2,5,8,62.5,3,5,0,5,3,13,3,0,defense
ENG-Premier League,2022,Leeds United,Illan Meslier,FRA,GK,22,2000,34.0,2,1,2,0,0,2,4,50.0,2,0,0,0,1,3,30,3,defense
ENG-Premier League,2022,Leeds United,Jack Harrison,ENG,"FW,MF",25,1996,30.1,41,17,5,15,21,12,52,23.1,40,47,2,45,22,63,25,0,defense
ENG-Premier League,2022,Leeds United,Joe Gelhardt,ENG,FW,20,2002,2.4,6,2,1,3,2,3,5,60.0,2,5,0,5,0,6,4,0,defense
ENG-Premier League,2022,Leeds United,Joel Robles,ESP,GK,32,1990,4.0,0,0,0,0,0,0,1,0.0,1,0,0,0,0,0,2,1,defense
ENG-Premier League,2022,Leeds United,Junior Firpo,DOM,DF,25,1996,15.2,47,25,27,15,5,24,46,52.2,22,23,7,16,24,71,40,0,defense
ENG-Premier League,2022,Leeds United,Liam Cooper,SCO,DF,30,1991,15.8,38,23,27,9,2,23,36,63.9,13,16,8,8,34,72,57,3,defense
ENG-Premier League,2022,Leeds United,Luis Sinisterra,COL,FW,23,1999,9.6,21,14,8,9,4,11,19,57.9,8,11,1,10,8,29,2,0,defense
ENG-Premier League,2022,Leeds United,Luke Ayling,ENG,DF,30,1991,22.8,66,37,42,15,9,42,85,49.4,43,34,11,23,26,92,52,2,defense
ENG-Premier League,2022,Leeds United,Marc Roca,ESP,MF,25,1996,25.7,66,40,27,34,5,20,66,30.3,46,34,10,24,23,89,24,2,defense
ENG-Premier League,2022,Leeds United,Mateo Joseph,ESP,"FW,MF",18,2003,0.3,0,0,0,0,0,0,0,,0,1,0,1,0,0,1,0,defense
ENG-Premier League,2022,Leeds United,Mateusz Klich,POL,"MF,FW",32,1990,3.1,12,8,3,4,5,7,13,53.8,6,4,0,4,0,12,1,0,defense
ENG-Premier League,2022,Leeds United,Maximilian Wöber,AUT,DF,24,1998,14.1,25,18,9,15,1,16,24,66.7,8,32,14,18,27,52,67,1,defense
ENG-Premier League,2022,Leeds United,Pascal Struijk,NED,DF,22,1999,24.4,84,57,43,31,10,49,77,63.6,28,32,12,20,32,116,70,1,defense
ENG-Premier League,2022,Leeds United,Patrick Bamford,ENG,FW,28,1993,16.8,9,6,0,6,3,4,20,20.0,16,12,5,7,5,14,13,0,defense
ENG-Premier League,2022,Leeds United,Rasmus Kristensen,DEN,DF,25,1997,21.8,62,35,35,21,6,42,76,55.3,34,32,14,18,35,97,61,0,defense
ENG-Premier League,2022,Leeds United,Robin Koch,GER,DF,26,1996,35.3,53,30,32,16,5,24,56,42.9,32,44,21,23,43,96,152,1,defense
ENG-Premier League,2022,Leeds United,Rodrigo,ESP,"FW,MF",31,1991,21.5,24,10,2,15,7,8,20,40.0,12,16,4,12,6,30,21,1,defense
ENG-Premier League,2022,Leeds United,Sam Greenwood,ENG,"MF,FW",20,2002,4.7,15,7,7,8,0,8,21,38.1,13,10,2,8,1,16,1,0,defense
ENG-Premier League,2022,Leeds United,Tyler Adams,USA,MF,23,1999,24.0,89,46,44,35,10,50,79,63.3,29,48,8,40,35,124,29,0,defense
ENG-Premier League,2022,Leeds United,Weston McKennie,USA,MF,23,1998,16.0,30,13,5,18,7,10,29,34.5,19,22,3,19,22,52,26,0,defense
ENG-Premier League,2022,Leeds United,Wilfried Gnonto,ITA,"FW,MF",18,2003,15.0,27,17,7,15,5,10,30,33.3,20,24,1,23,5,32,7,0,defense
ENG-Premier League,2022,Leicester City,Ayoze Pérez,ESP,"MF,FW",29,1993,4.2,11,8,5,4,2,8,19,42.1,11,6,0,6,2,13,3,0,defense
ENG-Premier League,2022,Leicester City,Boubakary Soumaré,FRA,MF,23,1999,18.1,57,34,29,26,2,23,44,52.3,21,15,4,11,33,90,27,1,defense
ENG-Premier League,2022,Leicester City,Daniel Amartey,GHA,DF,27,1994,17.9,19,8,13,5,1,12,14,85.7,2,24,17,7,8,27,71,0,defense
ENG-Premier League,2022,Leicester City,Daniel Iversen,DEN,GK,25,1997,12.0,0,0,0,0,0,0,0,,0,0,0,0,0,0,6,1,defense
ENG-Premier League,2022,Leicester City,Danny Ward,WAL,GK,29,1993,26.0,1,1,1,0,0,1,3,33.3,2,0,0,0,0,1,14,2,defense
ENG-Premier League,2022,Leicester City,Dennis Praet,BEL,"MF,FW",28,1994,7.2,12,9,5,6,1,6,11,54.5,5,12,2,10,5,17,6,0,defense
ENG-Premier League,2022,Leicester City,Harry Souttar,AUS,DF,23,1998,11.0,15,9,10,5,0,7,18,38.9,11,16,12,4,12,27,45,0,defense
ENG-Premier League,2022,Leicester City,Harvey Barnes,ENG,"FW,MF",24,1997,30.1,26,14,8,14,4,14,42,33.3,28,32,1,31,8,34,12,0,defense
ENG-Premier League,2022,Leicester City,James Justin,ENG,DF,24,1998,13.9,20,18,7,12,1,9,18,50.0,9,24,6,18,15,35,47,0,defense
ENG-Premier League,2022,Leicester City,James Maddison,ENG,"MF,FW",25,1996,27.6,51,26,25,19,7,19,50,38.0,31,19,1,18,13,64,6,1,defense
ENG-Premier League,2022,Leicester City,Jamie Vardy,ENG,FW,35,1987,20.6,9,5,4,2,3,1,8,12.5,7,17,3,14,2,11,30,0,defense
ENG-Premier League,2022,Leicester City,Jonny Evans,NIR,DF,34,1988,11.7,13,5,12,1,0,7,11,63.6,4,15,11,4,18,31,51,0,defense
ENG-Premier League,2022,Leicester City,Kelechi Iheanacho,NGA,"FW,MF",25,1996,12.5,7,2,0,3,4,3,10,30.0,7,9,1,8,0,7,8,0,defense
ENG-Premier League,2022,Leicester City,Kiernan Dewsbury-Hall,ENG,MF,23,1998,25.6,53,29,14,34,5,19,47,40.4,28,55,13,42,28,81,21,0,defense
ENG-Premier League,2022,Leicester City,Lewis Brunt,ENG,DF,21,2000,0.3,0,0,0,0,0,0,0,,0,0,0,0,0,0,2,0,defense
ENG-Premier League,2022,Leicester City,Luke Thomas,ENG,DF,21,2001,11.9,23,19,15,5,3,15,32,46.9,17,20,4,16,27,50,35,0,defense
ENG-Premier League,2022,Leicester City,Marc Albrighton,ENG,"FW,MF",32,1989,2.6,4,1,0,2,2,1,8,12.5,7,6,2,4,1,5,5,0,defense
ENG-Premier League,2022,Leicester City,Nampalys Mendy,SEN,MF,30,1992,8.4,13,9,7,6,0,8,15,53.3,7,20,4,16,13,26,2,0,defense
ENG-Premier League,2022,Leicester City,Patson Daka,ZAM,FW,23,1998,13.2,14,8,6,8,0,3,13,23.1,10,14,2,12,7,21,7,0,defense
ENG-Premier League,2022,Leicester City,Ricardo Pereira,POR,"DF,MF",28,1993,5.0,11,7,8,3,0,7,17,41.2,10,8,2,6,4,15,20,0,defense
ENG-Premier League,2022,Leicester City,Tetê,BRA,FW,22,2000,8.2,14,8,5,7,2,6,21,28.6,15,9,0,9,2,16,3,0,defense
ENG-Premier League,2022,Leicester City,Timothy Castagne,BEL,DF,26,1995,36.2,87,44,53,27,7,41,84,48.8,43,50,13,37,43,130,110,0,defense
ENG-Premier League,2022,Leicester City,Victor Bernth Kristiansen,DEN,DF,19,2002,9.9,38,23,18,16,4,22,30,73.3,8,16,4,12,3,41,26,1,defense
ENG-Premier League,2022,Leicester City,Wesley Fofana,FRA,DF,21,2000,2.0,4,2,1,2,1,1,3,33.3,2,1,1,0,9,13,5,0,defense
ENG-Premier League,2022,Leicester City,Wilfred Ndidi,NGA,MF,25,1996,18.7,61,42,34,24,3,17,43,39.5,26,32,14,18,38,99,48,3,defense
ENG-Premier League,2022,Leicester City,Wout Faes,BEL,DF,24,1998,31.0,56,33,28,26,2,28,44,63.6,16,53,37,16,41,97,113,2,defense
ENG-Premier League,2022,Leicester City,Youri Tielemans,BEL,MF,25,1997,26.0,66,39,27,30,9,23,62,37.1,39,35,8,27,28,94,24,1,defense
ENG-Premier League,2022,Leicester City,Çağlar Söyüncü,TUR,DF,26,1996,5.9,14,9,10,4,0,7,10,70.0,3,9,8,1,7,21,30,0,defense
ENG-Premier League,2022,Liverpool,Alex Oxlade-Chamberlain,ENG,"FW,MF",28,1993,3.7,5,4,1,2,2,1,5,20.0,4,5,2,3,1,6,4,0,defense
ENG-Premier League,2022,Liverpool,Alisson,BRA,GK,29,1992,37.0,0,0,0,0,0,0,3,0.0,3,3,0,3,0,0,20,0,defense
ENG-Premier League,2022,Liverpool,Andrew Robertson,SCO,DF,28,1994,28.7,38,21,12,16,10,21,41,51.2,20,32,5,27,18,56,50,3,defense
ENG-Premier League,2022,Liverpool,Ben Doak,SCO,FW,16,2005,0.3,3,2,1,2,0,1,1,100.0,0,1,0,1,0,3,0,0,defense
ENG-Premier League,2022,Liverpool,Bobby Clark,ENG,MF,17,2005,0.1,0,0,0,0,0,0,0,,0,2,0,2,0,0,0,0,defense
ENG-Premier League,2022,Liverpool,Caoimhín Kelleher,IRL,GK,23,1998,1.0,0,0,0,0,0,0,0,,0,0,0,0,0,0,0,0,defense
ENG-Premier League,2022,Liverpool,Cody Gakpo,NED,"FW,MF",23,1999,16.2,26,15,4,13,9,13,38,34.2,25,13,1,12,4,30,2,0,defense
ENG-Premier League,2022,Liverpool,Curtis Jones,ENG,MF,21,2001,11.5,34,17,8,12,14,18,31,58.1,13,12,2,10,3,37,9,0,defense
ENG-Premier League,2022,Liverpool,Darwin Núñez,URU,FW,23,1999,18.8,11,5,2,4,5,4,17,23.5,13,10,0,10,3,14,13,0,defense
ENG-Premier League,2022,Liverpool,Diogo Jota,POR,FW,25,1996,12.6,23,15,8,8,7,12,37,32.4,25,5,0,5,3,26,11,0,defense
ENG-Premier League,2022,Liverpool,Fabinho,BRA,MF,28,1993,29.7,65,38,18,40,7,24,62,38.7,38,38,11,27,37,102,40,0,defense
ENG-Premier League,2022,Liverpool,Fabio Carvalho,POR,"MF,FW",19,2002,3.9,8,8,3,3,2,3,6,50.0,3,6,0,6,6,14,0,0,defense
ENG-Premier League,2022,Liverpool,Harvey Elliott,ENG,"MF,FW",19,2003,17.9,27,18,6,12,9,9,37,24.3,28,26,1,25,15,42,8,0,defense
ENG-Premier League,2022,Liverpool,Ibrahima Konaté,FRA,DF,23,1999,17.2,38,26,25,13,0,16,27,59.3,11,12,5,7,26,64,61,4,defense
ENG-Premier League,2022,Liverpool,James Milner,ENG,"MF,DF",36,1986,10.1,26,16,11,11,4,15,34,44.1,19,14,2,12,12,38,15,0,defense
ENG-Premier League,2022,Liverpool,Joe Gomez,ENG,DF,25,1997,16.3,28,21,15,11,2,11,19,57.9,8,17,11,6,24,52,51,2,defense
ENG-Premier League,2022,Liverpool,Jordan Henderson,ENG,MF,32,1990,23.0,32,23,10,18,4,15,36,41.7,21,21,3,18,21,53,16,1,defense
ENG-Premier League,2022,Liverpool,Joël Matip,CMR,DF,30,1991,12.1,14,8,12,2,0,11,23,47.8,12,8,3,5,21,35,45,3,defense
ENG-Premier League,2022,Liverpool,Kostas Tsimikas,GRE,DF,26,1996,8.6,14,9,10,2,2,10,16,62.5,6,8,1,7,12,26,15,0,defense
ENG-Premier League,2022,Liverpool,Luis Díaz,COL,FW,25,1997,11.1,17,11,4,8,5,8,15,53.3,7,8,0,8,6,23,2,0,defense
ENG-Premier League,2022,Liverpool,Mohamed Salah,EGY,FW,30,1992,36.6,21,12,4,5,12,10,26,38.5,16,21,0,21,6,27,4,0,defense
ENG-Premier League,2022,Liverpool,Naby Keïta,GUI,MF,27,1995,3.3,5,4,2,3,0,1,4,25.0,3,1,0,1,2,7,3,0,defense
ENG-Premier League,2022,Liverpool,Nathaniel Phillips,ENG,DF,25,1997,0.7,2,1,0,2,0,2,2,100.0,0,0,0,0,2,4,1,0,defense
ENG-Premier League,2022,Liverpool,Roberto Firmino,BRA,"FW,MF",30,1991,13.5,17,12,2,12,3,4,22,18.2,18,16,1,15,7,24,2,0,defense
ENG-Premier League,2022,Liverpool,Stefan Bajcetic,ESP,MF,17,2004,5.8,9,6,5,3,1,8,27,29.6,19,7,0,7,9,18,4,0,defense
ENG-Premier League,2022,Liverpool,Thiago Alcántara,ESP,MF,31,1991,13.9,43,24,20,21,2,14,23,60.9,9,15,3,12,21,64,13,2,defense
ENG-Premier League,2022,Liverpool,Trent Alexander-Arnold,ENG,DF,23,1998,32.5,57,40,32,16,9,42,80,52.5,38,25,7,18,43,100,41,2,defense
ENG-Premier League,2022,Liverpool,Virgil van Dijk,NED,DF,31,1991,31.5,27,14,13,11,3,8,19,42.1,11,24,16,8,31,58,138,3,defense
ENG-Premier League,2022,Manchester City,Aymeric Laporte,ESP,DF,28,1994,11.0,11,8,6,4,1,7,11,63.6,4,10,4,6,3,14,30,1,defense
ENG-Premier League,2022,Manchester City,Bernardo Silva,POR,"MF,FW",27,1994,24.5,44,23,11,25,8,18,45,40.0,27,23,6,17,16,60,6,0,defense
ENG-Premier League,2022,Manchester City,Cole Palmer,ENG,"MF,FW",20,2002,4.1,5,1,0,3,2,3,5,60.0,2,2,1,1,1,6,2,0,defense
ENG-Premier League,2022,Manchester City,Ederson,BRA,GK,28,1993,35.0,3,1,3,0,0,1,2,50.0,1,0,0,0,1,4,10,2,defense
ENG-Premier League,2022,Manchester City,Erling Haaland,NOR,FW,22,2000,30.8,3,2,0,2,1,1,5,20.0,4,12,4,8,3,6,14,0,defense
ENG-Premier League,2022,Manchester City,Jack Grealish,ENG,FW,26,1995,22.8,25,16,10,12,3,13,23,56.5,10,17,3,14,7,32,9,0,defense
ENG-Premier League,2022,Manchester City,John Stones,ENG,"DF,MF",28,1994,20.5,23,13,11,8,4,7,10,70.0,3,17,10,7,9,32,40,0,defense
ENG-Premier League,2022,Manchester City,João Cancelo,POR,DF,28,1994,14.2,29,21,16,9,4,17,24,70.8,7,7,1,6,19,48,9,1,defense
ENG-Premier League,2022,Manchester City,Julián Álvarez,ARG,"FW,MF",22,2000,16.3,26,16,3,13,10,9,30,30.0,21,13,0,13,2,28,6,0,defense
ENG-Premier League,2022,Manchester City,Kalvin Phillips,ENG,MF,26,1995,3.3,6,4,3,3,0,2,10,20.0,8,7,3,4,5,11,10,0,defense
ENG-Premier League,2022,Manchester City,Kevin De Bruyne,BEL,MF,31,1991,26.9,28,12,3,12,13,14,39,35.9,25,27,2,25,9,37,10,0,defense
ENG-Premier League,2022,Manchester City,Kyle Walker,ENG,DF,32,1990,21.8,13,9,8,5,0,4,24,16.7,20,12,2,10,18,31,22,0,defense
ENG-Premier League,2022,Manchester City,Manuel Akanji,SUI,DF,27,1995,25.4,36,25,15,18,3,23,36,63.9,13,27,9,18,16,52,33,1,defense
ENG-Premier League,2022,Manchester City,Máximo Perrone,ARG,MF,19,2003,0.2,0,0,0,0,0,0,0,,0,1,0,1,0,0,0,0,defense
ENG-Premier League,2022,Manchester City,Nathan Aké,NED,DF,27,1995,20.8,26,12,15,9,2,11,15,73.3,4,20,10,10,20,46,48,0,defense
ENG-Premier League,2022,Manchester City,Phil Foden,ENG,FW,22,2000,20.5,16,10,9,5,2,8,19,42.1,11,25,2,23,5,21,12,0,defense
ENG-Premier League,2022,Manchester City,Rico Lewis,ENG,"DF,MF",17,2004,10.0,16,9,9,5,2,6,11,54.5,5,8,4,4,6,22,13,1,defense
ENG-Premier League,2022,Manchester City,Riyad Mahrez,ALG,"FW,MF",31,1991,21.3,30,14,8,13,9,13,39,33.3,26,27,1,26,9,39,5,0,defense
ENG-Premier League,2022,Manchester City,Rodri,ESP,MF,26,1996,32.3,67,41,28,28,11,26,53,49.1,27,40,14,26,33,100,43,1,defense
ENG-Premier League,2022,Manchester City,Rúben Dias,POR,DF,25,1997,22.2,21,13,10,10,1,11,18,61.1,7,21,13,8,18,39,56,1,defense
ENG-Premier League,2022,Manchester City,Sergio Gómez,ESP,"DF,MF",21,2000,3.9,9,4,6,1,2,5,8,62.5,3,5,3,2,2,11,9,1,defense
ENG-Premier League,2022,Manchester City,Shea Charles,NIR,DF,18,2003,0.3,4,0,4,0,0,1,1,100.0,0,0,0,0,1,5,2,0,defense
ENG-Premier League,2022,Manchester City,Stefan Ortega,GER,GK,29,1992,3.0,0,0,0,0,0,0,0,,0,0,0,0,0,0,0,0,defense
ENG-Premier League,2022,Manchester City,İlkay Gündoğan,GER,MF,31,1990,26.1,30,18,7,13,10,12,34,35.3,22,18,3,15,20,50,13,0,defense
ENG-Premier League,2022,Manchester Utd,Aaron Wan-Bissaka,ENG,DF,24,1997,15.9,40,25,20,17,3,23,25,92.0,2,24,8,16,22,62,41,0,defense
ENG-Premier League,2022,Manchester Utd,Alejandro Garnacho,ARG,"FW,MF",18,2004,6.3,5,2,2,0,3,1,11,9.1,10,5,0,5,5,10,3,0,defense
ENG-Premier League,2022,Manchester Utd,Anthony Elanga,SWE,FW,20,2002,4.7,3,0,0,2,1,1,2,50.0,1,4,0,4,2,5,4,0,defense
ENG-Premier League,2022,Manchester Utd,Anthony Martial,FRA,FW,26,1995,10.9,5,3,0,2,3,1,4,25.0,3,11,2,9,1,6,4,0,defense
ENG-Premier League,2022,Manchester Utd,Antony,BRA,FW,22,2000,20.0,22,9,9,9,4,8,28,28.6,20,18,0,18,11,33,6,0,defense
ENG-Premier League,2022,Manchester Utd,Bruno Fernandes,POR,"MF,FW",27,1994,36.8,68,42,24,25,19,30,71,42.3,41,37,5,32,25,93,40,1,defense
ENG-Premier League,2022,Manchester Utd,Casemiro,BRA,MF,30,1992,23.6,88,46,43,35,10,47,92,51.1,45,49,11,38,34,122,64,0,defense
ENG-Premier League,2022,Manchester Utd,Christian Eriksen,DEN,MF,30,1992,22.8,22,18,10,7,5,10,33,30.3,23,23,9,14,11,33,20,1,defense
ENG-Premier League,2022,Manchester Utd,Cristiano Ronaldo,POR,FW,37,1985,5.8,2,2,1,0,1,1,2,50.0,1,0,0,0,1,3,9,0,defense
ENG-Premier League,2022,Manchester Utd,David de Gea,ESP,GK,31,1990,38.0,0,0,0,0,0,0,1,0.0,1,0,0,0,1,1,15,3,defense
ENG-Premier League,2022,Manchester Utd,Diogo Dalot,POR,DF,23,1999,23.9,54,41,40,13,1,33,45,73.3,12,25,7,18,37,91,55,2,defense
ENG-Premier League,2022,Manchester Utd,Donny van de Beek,NED,MF,25,1997,1.9,0,0,0,0,0,0,1,0.0,1,2,1,1,1,1,1,0,defense
ENG-Premier League,2022,Manchester Utd,Facundo Pellistri,URU,"FW,MF",20,2001,0.7,1,1,0,1,0,0,0,,0,0,0,0,0,1,3,0,defense
ENG-Premier League,2022,Manchester Utd,Fred,BRA,MF,29,1993,13.9,47,30,24,20,3,15,38,39.5,23,38,2,36,19,66,19,0,defense
ENG-Premier League,2022,Manchester Utd,Harry Maguire,ENG,DF,29,1993,8.5,8,6,6,1,1,4,5,80.0,1,18,11,7,13,21,41,0,defense
ENG-Premier League,2022,Manchester Utd,Jadon Sancho,ENG,"FW,MF",22,2000,18.7,16,10,7,5,4,8,28,28.6,20,25,2,23,7,23,6,0,defense
ENG-Premier League,2022,Manchester Utd,Kobbie Mainoo,ENG,MF,17,2005,0.1,0,0,0,0,0,0,0,,0,1,1,0,0,0,0,0,defense
ENG-Premier League,2022,Manchester Utd,Lisandro Martínez,ARG,DF,24,1998,23.5,54,28,33,18,3,30,43,69.8,13,51,27,24,33,87,103,0,defense
ENG-Premier League,2022,Manchester Utd,Luke Shaw,ENG,DF,27,1995,28.4,55,36,31,22,2,32,46,69.6,14,51,17,34,36,91,55,2,defense
ENG-Premier League,2022,Manchester Utd,Marcel Sabitzer,AUT,MF,28,1994,7.0,12,8,3,8,1,2,11,18.2,9,6,2,4,8,20,11,0,defense
ENG-Premier League,2022,Manchester Utd,Marcus Rashford,ENG,FW,24,1997,32.0,20,10,7,8,5,9,24,37.5,15,31,4,27,7,27,14,0,defense
ENG-Premier League,2022,Manchester Utd,Raphaël Varane,FRA,DF,29,1993,21.2,24,9,18,6,0,7,17,41.2,10,24,17,7,11,35,91,0,defense
ENG-Premier League,2022,Manchester Utd,Scott McTominay,SCO,MF,25,1996,12.9,32,19,16,10,6,13,22,59.1,9,15,6,9,14,46,45,1,defense
ENG-Premier League,2022,Manchester Utd,Tyrell Malacia,NED,DF,22,1999,15.5,46,33,33,12,1,14,25,56.0,11,13,3,10,25,71,49,0,defense
ENG-Premier League,2022,Manchester Utd,Victor Lindelöf,SWE,DF,28,1994,15.2,22,17,10,9,3,9,17,52.9,8,18,9,9,21,43,63,1,defense
ENG-Premier League,2022,Manchester Utd,Wout Weghorst,NED,"FW,MF",29,1992,8.9,11,5,6,1,4,2,9,22.2,7,7,2,5,7,18,9,0,defense
ENG-Premier League,2022,Newcastle Utd,Alexander Isak,SWE,FW,22,1999,16.9,18,8,4,7,7,10,28,35.7,18,21,2,19,4,22,8,0,defense
ENG-Premier League,2022,Newcastle Utd,Allan Saint-Maximin,FRA,FW,25,1997,12.4,10,3,3,6,1,2,11,18.2,9,4,0,4,5,15,2,0,defense
ENG-Premier League,2022,Newcastle Utd,Anthony Gordon,ENG,"FW,MF",21,2001,5.4,14,12,5,7,2,9,20,45.0,11,9,1,8,2,16,1,1,defense
ENG-Premier League,2022,Newcastle Utd,Bruno Guimarães,BRA,MF,24,1997,30.3,78,40,27,46,5,38,65,58.5,27,28,4,24,36,114,22,1,defense
ENG-Premier League,2022,Newcastle Utd,Callum Wilson,ENG,FW,30,1992,20.9,9,3,0,8,1,0,3,0.0,3,8,0,8,1,10,5,0,defense
ENG-Premier League,2022,Newcastle Utd,Chris Wood,NZL,FW,30,1991,5.0,5,4,0,3,2,3,5,60.0,2,2,2,0,1,6,7,0,defense
ENG-Premier League,2022,Newcastle Utd,Dan Burn,ENG,DF,30,1992,34.6,60,38,29,23,8,34,67,50.7,33,42,16,26,32,92,120,2,defense
ENG-Premier League,2022,Newcastle Utd,Elliot Anderson,ENG,"MF,FW",19,2002,4.6,11,5,5,3,3,6,12,50.0,6,11,2,9,6,17,2,0,defense
ENG-Premier League,2022,Newcastle Utd,Emil Krafth,SWE,DF,27,1994,0.0,0,0,0,0,0,0,0,,0,0,0,0,0,0,0,0,defense
ENG-Premier League,2022,Newcastle Utd,Fabian Schär,SUI,DF,30,1991,35.6,47,22,31,13,3,24,39,61.5,15,34,19,15,52,99,139,0,defense
ENG-Premier League,2022,Newcastle Utd,Jacob Murphy,ENG,FW,27,1995,13.9,15,7,3,8,4,8,20,40.0,12,17,0,17,7,22,3,0,defense
ENG-Premier League,2022,Newcastle Utd,Jamaal Lascelles,ENG,DF,28,1993,2.4,1,0,1,0,0,1,1,100.0,0,3,2,1,0,1,17,0,defense
ENG-Premier League,2022,Newcastle Utd,Jamal Lewis,NIR,"DF,FW",24,1998,0.1,0,0,0,0,0,0,0,,0,0,0,0,0,0,0,0,defense
ENG-Premier League,2022,Newcastle Utd,Javier Manquillo,ESP,DF,28,1994,0.4,3,2,2,1,0,2,2,100.0,0,1,0,1,1,4,1,0,defense
ENG-Premier League,2022,Newcastle Utd,Joe Willock,ENG,MF,22,1999,28.4,51,30,13,26,12,25,58,43.1,33,54,8,46,25,76,17,0,defense
ENG-Premier League,2022,Newcastle Utd,Joelinton,BRA,"MF,FW",25,1996,29.6,70,49,36,26,8,26,62,41.9,36,52,7,45,48,118,39,0,defense
ENG-Premier League,2022,Newcastle Utd,Jonjo Shelvey,ENG,MF,30,1992,0.4,1,0,1,0,0,0,1,0.0,1,1,0,1,0,1,0,0,defense
ENG-Premier League,2022,Newcastle Utd,Kieran Trippier,ENG,DF,31,1990,37.1,71,49,36,27,8,46,90,51.1,44,45,15,30,43,114,84,2,defense
ENG-Premier League,2022,Newcastle Utd,Lewis Miley,ENG,MF,16,2006,0.2,0,0,0,0,0,0,0,,0,1,0,1,0,0,0,0,defense
ENG-Premier League,2022,Newcastle Utd,Martin Dúbravka,SVK,GK,33,1989,1.7,0,0,0,0,0,0,1,0.0,1,0,0,0,0,0,1,0,defense
ENG-Premier League,2022,Newcastle Utd,Matt Ritchie,SCO,"FW,MF",32,1989,0.4,1,1,0,1,0,1,3,33.3,2,0,0,0,1,2,0,0,defense
ENG-Premier League,2022,Newcastle Utd,Matt Targett,ENG,DF,26,1995,6.8,13,10,8,3,2,9,24,37.5,15,8,3,5,9,22,16,0,defense
ENG-Premier League,2022,Newcastle Utd,Miguel Almirón,PAR,FW,28,1994,27.7,46,30,16,19,11,18,42,42.9,24,25,2,23,10,56,17,0,defense
ENG-Premier League,2022,Newcastle Utd,Nick Pope,ENG,GK,30,1992,36.2,1,0,1,0,0,1,3,33.3,2,0,0,0,0,1,27,2,defense
ENG-Premier League,2022,Newcastle Utd,Ryan Fraser,SCO,FW,28,1994,3.5,2,2,0,0,2,2,5,40.0,3,3,1,2,0,2,3,0,defense
ENG-Premier League,2022,Newcastle Utd,Sean Longstaff,ENG,MF,24,1997,28.0,42,21,16,20,6,20,52,38.5,32,35,8,27,16,58,23,0,defense
ENG-Premier League,2022,Newcastle Utd,Sven Botman,NED,DF,22,2000,34.7,38,24,31,7,0,22,28,78.6,6,44,24,20,34,72,126,2,defense
ENG-Premier League,2022,Nott'ham Forest,Alex Mighten,ENG,FW,20,2002,0.1,0,0,0,0,0,0,1,0.0,1,0,0,0,0,0,0,0,defense
ENG-Premier League,2022,Nott'ham Forest,André Ayew,GHA,"FW,MF",32,1989,3.5,5,3,0,4,1,2,4,50.0,2,6,1,5,0,5,7,0,defense
ENG-Premier League,2022,Nott'ham Forest,Brennan Johnson,WAL,"FW,MF",21,2001,32.6,34,20,18,8,8,8,29,27.6,21,30,1,29,5,39,7,1,defense
ENG-Premier League,2022,Nott'ham Forest,Cafú,POR,MF,29,1993,0.1,0,0,0,0,0,0,0,,0,0,0,0,0,0,1,0,defense
ENG-Premier League,2022,Nott'ham Forest,Cheikhou Kouyaté,SEN,MF,32,1989,9.8,29,21,18,8,3,9,13,69.2,4,14,2,12,10,39,24,0,defense
ENG-Premier League,2022,Nott'ham Forest,Chris Wood,NZL,FW,30,1991,4.1,0,0,0,0,0,0,1,0.0,1,2,1,1,1,1,2,0,defense
ENG-Premier League,2022,Nott'ham Forest,Danilo,BRA,MF,21,2001,10.8,18,7,7,9,2,6,25,24.0,19,26,6,20,9,27,19,0,defense
ENG-Premier League,2022,Nott'ham Forest,Dean Henderson,ENG,GK,25,1997,18.0,0,0,0,0,0,0,0,,0,0,0,0,0,0,12,1,defense
ENG-Premier League,2022,Nott'ham Forest,Emmanuel Dennis,NGA,"FW,MF",24,1997,8.0,17,11,5,5,7,8,18,44.4,10,13,1,12,2,19,6,0,defense
ENG-Premier League,2022,Nott'ham Forest,Felipe,BRA,DF,33,1989,15.8,42,23,29,13,0,24,41,58.5,17,34,13,21,36,78,90,0,defense
ENG-Premier League,2022,Nott'ham Forest,Giulian Biancone,FRA,DF,22,2000,0.2,2,1,2,0,0,1,1,100.0,0,0,0,0,1,3,0,0,defense
ENG-Premier League,2022,Nott'ham Forest,Gustavo Scarpa,BRA,"MF,FW",28,1994,2.0,5,2,3,1,1,2,5,40.0,3,4,0,4,0,5,3,0,defense
ENG-Premier League,2022,Nott'ham Forest,Harry Toffolo,ENG,DF,26,1995,10.4,17,8,10,4,3,10,14,71.4,4,16,8,8,10,27,33,0,defense
ENG-Premier League,2022,Nott'ham Forest,Jack Colback,ENG,MF,32,1989,5.5,18,13,12,6,0,5,8,62.5,3,3,0,3,3,21,9,0,defense
ENG-Premier League,2022,Nott'ham Forest,Jesse Lingard,ENG,"FW,MF",29,1992,10.3,4,4,2,2,0,1,7,14.3,6,11,0,11,5,9,4,0,defense
ENG-Premier League,2022,Nott'ham Forest,Joe Worrall,ENG,DF,25,1997,24.7,53,25,39,12,2,25,35,71.4,10,33,23,10,26,79,111,1,defense
ENG-Premier League,2022,Nott'ham Forest,Jonjo Shelvey,ENG,MF,30,1992,6.0,2,1,0,1,1,1,9,11.1,8,7,2,5,5,7,10,1,defense
ENG-Premier League,2022,Nott'ham Forest,Keylor Navas,CRC,GK,35,1986,17.0,0,0,0,0,0,0,0,,0,0,0,0,1,1,11,2,defense
ENG-Premier League,2022,Nott'ham Forest,Lewis O'Brien,ENG,MF,23,1998,6.5,16,9,4,11,1,6,12,50.0,6,13,2,11,5,21,9,0,defense
ENG-Premier League,2022,Nott'ham Forest,Morgan Gibbs-White,ENG,"MF,FW",22,2000,33.0,26,14,7,7,12,11,33,33.3,22,23,4,19,14,40,15,0,defense
ENG-Premier League,2022,Nott'ham Forest,Moussa Niakhate,SEN,DF,26,1996,12.9,18,9,15,3,0,11,22,50.0,11,18,8,10,19,37,60,0,defense
ENG-Premier League,2022,Nott'ham Forest,Neco Williams,WAL,DF,21,2001,20.9,72,47,49,17,6,38,71,53.5,33,33,8,25,33,105,48,0,defense
ENG-Premier League,2022,Nott'ham Forest,Orel Mangala,BEL,MF,24,1998,17.2,28,20,16,10,2,12,29,41.4,17,21,7,14,23,51,15,0,defense
ENG-Premier League,2022,Nott'ham Forest,Remo Freuler,SUI,MF,30,1992,24.0,43,23,23,15,5,19,43,44.2,24,36,9,27,29,72,45,0,defense
ENG-Premier League,2022,Nott'ham Forest,Renan Lodi,BRA,DF,24,1998,24.6,52,39,38,8,6,33,66,50.0,33,25,6,19,33,85,74,0,defense
ENG-Premier League,2022,Nott'ham Forest,Ryan Yates,ENG,MF,24,1997,20.4,38,19,19,16,3,14,22,63.6,8,26,8,18,10,48,44,0,defense
ENG-Premier League,2022,Nott'ham Forest,Sam Surridge,ENG,FW,24,1998,3.6,5,0,1,3,1,1,4,25.0,3,5,2,3,0,5,7,0,defense
ENG-Premier League,2022,Nott'ham Forest,Scott McKenna,SCO,DF,25,1996,17.5,12,7,7,3,2,6,10,60.0,4,20,14,6,12,24,85,1,defense
ENG-Premier League,2022,Nott'ham Forest,Serge Aurier,CIV,DF,29,1992,21.6,64,41,41,18,5,23,33,69.7,10,34,11,23,29,93,75,0,defense
ENG-Premier League,2022,Nott'ham Forest,Steve Cook,ENG,DF,31,1991,10.6,8,4,4,4,0,5,7,71.4,2,16,11,5,12,20,51,0,defense
ENG-Premier League,2022,Nott'ham Forest,Taiwo Awoniyi,NGA,FW,24,1997,15.6,17,10,2,10,5,6,12,50.0,6,18,4,14,4,21,20,0,defense
ENG-Premier League,2022,Nott'ham Forest,Wayne Hennessey,WAL,GK,35,1987,3.0,1,0,1,0,0,1,1,100.0,0,0,0,0,0,1,2,0,defense
ENG-Premier League,2022,Nott'ham Forest,Willy Boly,CIV,DF,31,1991,7.6,13,6,8,3,2,8,13,61.5,5,13,4,9,12,25,45,0,defense
ENG-Premier League,2022,Southampton,Adam Armstrong,ENG,"FW,MF",25,1997,14.8,14,9,6,5,3,3,10,30.0,7,15,3,12,5,19,6,0,defense
ENG-Premier League,2022,Southampton,Ainsley Maitland-Niles,ENG,"DF,MF",24,1997,15.6,45,24,23,18,4,28,44,63.6,16,28,7,21,22,67,45,1,defense
ENG-Premier League,2022,Southampton,Alex McCarthy,ENG,GK,32,1989,6.0,0,0,0,0,0,0,1,0.0,1,0,0,0,1,1,3,1,defense
ENG-Premier League,2022,Southampton,Armel Bella Kotchap,GER,DF,20,2001,20.9,37,17,28,9,0,15,20,75.0,5,29,12,17,44,81,110,0,defense
ENG-Premier League,2022,Southampton,Carlos Alcaraz,ARG,"MF,FW",19,2002,11.4,10,5,2,7,1,6,22,27.3,16,14,5,9,1,11,11,0,defense
ENG-Premier League,2022,Southampton,Che Adams,SCO,FW,26,1996,22.1,17,13,7,8,2,7,12,58.3,5,13,4,9,4,21,22,0,defense
ENG-Premier League,2022,Southampton,Dominic Ballard,ENG,"FW,MF",17,2005,0.3,0,0,0,0,0,0,0,,0,0,0,0,1,1,0,0,defense
ENG-Premier League,2022,Southampton,Duje Ćaleta-Car,CRO,DF,25,1996,10.5,14,10,9,4,1,6,9,66.7,3,15,11,4,15,29,65,1,defense
ENG-Premier League,2022,Southampton,Gavin Bazunu,IRL,GK,20,2002,32.0,1,0,1,0,0,1,1,100.0,0,0,0,0,1,2,24,2,defense
ENG-Premier League,2022,Southampton,Ibrahima Diallo,FRA,MF,23,1999,9.1,25,15,14,10,1,8,14,57.1,6,11,1,10,6,31,11,0,defense
ENG-Premier League,2022,Southampton,Jack Stephens,ENG,DF,28,1994,0.5,2,2,2,0,0,1,1,100.0,0,1,1,0,1,3,2,0,defense
ENG-Premier League,2022,Southampton,James Bree,ENG,DF,24,1997,4.1,5,3,4,1,0,3,4,75.0,1,3,1,2,6,11,11,0,defense
ENG-Premier League,2022,Southampton,James Ward-Prowse,ENG,MF,27,1994,37.5,65,37,31,27,7,21,61,34.4,40,30,10,20,55,120,48,0,defense
ENG-Premier League,2022,Southampton,Jan Bednarek,POL,DF,26,1996,18.6,27,21,20,7,0,12,16,75.0,4,38,27,11,49,76,87,0,defense
ENG-Premier League,2022,Southampton,Joe Aribo,NGA,"MF,FW",26,1996,13.6,31,20,15,12,4,11,20,55.0,9,14,1,13,10,41,11,0,defense
ENG-Premier League,2022,Southampton,Juan Larios,ESP,DF,18,2004,1.7,7,6,6,1,0,5,5,100.0,0,2,0,2,3,10,4,0,defense
ENG-Premier League,2022,Southampton,Kamaldeen Sulemana,GHA,"FW,MF",20,2002,10.7,15,9,4,7,4,4,14,28.6,10,16,0,16,6,21,6,0,defense
ENG-Premier League,2022,Southampton,Kami Doyle,ENG,MF,16,2005,0.1,0,0,0,0,0,0,0,,0,0,0,0,0,0,0,0,defense
ENG-Premier League,2022,Southampton,Kyle Walker-Peters,ENG,DF,25,1997,29.4,61,32,34,24,3,22,43,51.2,21,47,8,39,27,88,52,0,defense
ENG-Premier League,2022,Southampton,Lyanco,BRA,DF,25,1997,13.1,24,16,15,9,0,12,18,66.7,6,30,25,5,20,44,65,2,defense
ENG-Premier League,2022,Southampton,Mislav Oršić,CRO,MF,29,1992,0.1,1,1,1,0,0,0,0,,0,0,0,0,0,1,0,0,defense
ENG-Premier League,2022,Southampton,Mohamed Elyounoussi,NOR,"MF,FW",27,1994,24.1,46,28,22,20,4,19,44,43.2,25,40,3,37,27,73,37,0,defense
ENG-Premier League,2022,Southampton,Mohammed Salisu,GHA,DF,23,1999,21.9,52,29,34,16,2,24,34,70.6,10,56,25,31,30,82,122,1,defense
ENG-Premier League,2022,Southampton,Moussa Djenepo,MLI,"DF,FW",24,1998,7.9,19,11,13,5,1,11,27,40.7,16,19,2,17,11,30,7,0,defense
ENG-Premier League,2022,Southampton,Nathan Redmond,ENG,DF,28,1994,0.0,0,0,0,0,0,0,0,,0,0,0,0,0,0,0,0,defense
ENG-Premier League,2022,Southampton,Oriol Romeu,ESP,MF,30,1991,0.8,1,0,0,1,0,0,0,,0,1,0,1,1,2,1,0,defense
ENG-Premier League,2022,Southampton,Paul Onuachu,NGA,FW,28,1994,4.5,3,2,1,1,1,1,3,33.3,2,4,1,3,0,3,4,0,defense
ENG-Premier League,2022,Southampton,Romain Perraud,FRA,DF,24,1997,20.4,54,33,23,23,8,28,52,53.8,24,24,6,18,20,74,42,0,defense
ENG-Premier League,2022,Southampton,Roméo Lavia,BEL,MF,18,2004,24.7,60,35,27,29,4,21,53,39.6,32,47,11,36,33,93,23,1,defense
ENG-Premier League,2022,Southampton,Samuel Amo-Ameyaw,ENG,MF,16,2006,0.0,0,0,0,0,0,0,1,0.0,1,0,0,0,0,0,0,0,defense
ENG-Premier League,2022,Southampton,Samuel Edozie,ENG,"FW,MF",19,2003,6.3,17,10,6,10,1,3,8,37.5,5,7,0,7,6,23,6,0,defense
ENG-Premier League,2022,Southampton,Sekou Mara,FRA,"FW,MF",20,2002,6.2,14,10,5,8,1,3,9,33.3,6,11,0,11,1,15,5,0,defense
ENG-Premier League,2022,Southampton,Stuart Armstrong,SCO,"MF,FW",30,1992,15.6,32,21,15,13,4,14,39,35.9,25,18,0,18,10,42,9,2,defense
ENG-Premier League,2022,Southampton,Theo Walcott,ENG,"FW,MF",33,1989,12.5,13,6,8,4,1,8,27,29.6,19,8,1,7,9,22,7,0,defense
ENG-Premier League,2022,Southampton,Valentino Livramento,ENG,"DF,FW",19,2002,0.3,2,1,2,0,0,0,0,,0,0,0,0,2,4,3,0,defense
ENG-Premier League,2022,Southampton,Yan Valery,TUN,DF,23,1999,0.5,0,0,0,0,0,0,0,,0,1,0,1,0,0,3,0,defense
ENG-Premier League,2022,Tottenham,Arnaut Danjuma,NED,"FW,MF",25,1997,1.9,2,0,1,1,0,0,0,,0,1,0,1,0,2,0,0,defense
ENG-Premier League,2022,Tottenham,Ben Davies,WAL,DF,29,1993,25.4,28,11,13,13,2,14,26,53.8,12,17,8,9,18,46,72,0,defense
ENG-Premier League,2022,Tottenham,Bryan Gil,ESP,"MF,FW",21,2001,1.6,3,1,3,0,0,0,3,0.0,3,3,0,3,1,4,1,0,defense
ENG-Premier League,2022,Tottenham,Clément Lenglet,FRA,DF,27,1995,22.4,38,23,18,15,5,16,34,47.1,18,26,11,15,18,56,68,2,defense
ENG-Premier League,2022,Tottenham,Cristian Romero,ARG,DF,24,1998,26.3,68,36,42,24,2,29,46,63.0,17,40,18,22,44,112,102,3,defense
ENG-Premier League,2022,Tottenham,Davinson Sánchez,COL,DF,26,1996,9.5,24,11,17,6,1,14,20,70.0,6,16,10,6,12,36,41,0,defense
ENG-Premier League,2022,Tottenham,Dejan Kulusevski,SWE,"MF,FW",22,2000,23.0,38,15,23,7,8,16,44,36.4,28,19,0,19,13,51,7,0,defense
ENG-Premier League,2022,Tottenham,Djed Spence,ENG,"FW,DF",21,2000,0.1,0,0,0,0,0,0,0,,0,0,0,0,0,0,0,0,defense
ENG-Premier League,2022,Tottenham,Emerson,BRA,DF,23,1999,19.3,54,33,38,12,4,27,40,67.5,13,17,3,14,18,72,75,0,defense
ENG-Premier League,2022,Tottenham,Eric Dier,ENG,DF,28,1994,31.3,30,19,16,12,2,9,19,47.4,10,41,24,17,35,65,112,2,defense
ENG-Premier League,2022,Tottenham,Fraser Forster,ENG,GK,34,1988,13.5,1,0,1,0,0,0,0,,0,1,0,1,0,1,3,1,defense
ENG-Premier League,2022,Tottenham,George Abbott,ENG,MF,16,2005,0.0,0,0,0,0,0,0,0,,0,0,0,0,1,1,0,0,defense
ENG-Premier League,2022,Tottenham,Harry Kane,ENG,FW,29,1993,37.8,15,12,1,6,8,7,21,33.3,14,27,7,20,2,17,18,0,defense
ENG-Premier League,2022,Tottenham,Harvey White,ENG,MF,20,2001,0.1,0,0,0,0,0,0,1,0.0,1,0,0,0,0,0,0,0,defense
ENG-Premier League,2022,Tottenham,Hugo Lloris,FRA,GK,35,1986,24.5,1,1,1,0,0,1,3,33.3,2,0,0,0,1,2,13,5,defense
ENG-Premier League,2022,Tottenham,Ivan Perišić,CRO,"DF,MF",33,1989,23.4,42,24,25,10,7,27,47,57.4,20,29,7,22,22,64,49,1,defense
ENG-Premier League,2022,Tottenham,Japhet Tanganga,ENG,DF,23,1999,1.6,3,2,3,0,0,1,5,20.0,4,1,0,1,2,5,8,0,defense
ENG-Premier League,2022,Tottenham,Lucas Moura,BRA,"MF,DF",29,1992,1.7,8,5,1,3,4,1,4,25.0,3,0,0,0,2,10,1,1,defense
ENG-Premier League,2022,Tottenham,Matt Doherty,IRL,"DF,MF",30,1992,7.4,16,10,12,3,1,8,10,80.0,2,11,6,5,8,24,14,1,defense
ENG-Premier League,2022,Tottenham,Matthew Craig,SCO,MF,19,2003,0.2,4,1,2,2,0,0,0,,0,0,0,0,0,4,0,0,defense
ENG-Premier League,2022,Tottenham,Oliver Skipp,ENG,MF,21,2000,16.6,34,17,18,15,1,16,33,48.5,17,17,8,9,17,51,19,1,defense
ENG-Premier League,2022,Tottenham,Pape Matar Sarr,SEN,"MF,FW",19,2002,2.4,7,6,4,2,1,4,8,50.0,4,3,2,1,6,13,6,0,defense
ENG-Premier League,2022,Tottenham,Pedro Porro,ESP,"DF,MF",22,1999,12.6,25,16,8,15,2,14,39,35.9,25,25,2,23,15,40,24,1,defense
ENG-Premier League,2022,Tottenham,Pierre Højbjerg,DEN,MF,26,1995,34.8,56,30,28,22,6,26,67,38.8,41,46,17,29,49,105,64,1,defense
ENG-Premier League,2022,Tottenham,Richarlison,BRA,"MF,FW",25,1997,11.2,21,16,13,5,3,12,27,44.4,15,14,1,13,5,26,10,0,defense
ENG-Premier League,2022,Tottenham,Rodrigo Bentancur,URU,MF,25,1997,16.7,45,28,15,21,9,16,28,57.1,12,28,15,13,20,65,22,0,defense
ENG-Premier League,2022,Tottenham,Ryan Sessegnon,ENG,DF,22,2000,9.0,16,11,9,7,0,6,12,50.0,6,8,1,7,6,22,17,1,defense
ENG-Premier League,2022,Tottenham,Son Heung-min,KOR,"MF,FW",30,1992,32.1,24,12,7,8,9,9,30,30.0,21,23,2,21,13,37,6,0,defense
ENG-Premier League,2022,Tottenham,Yves Bissouma,MLI,MF,25,1996,11.2,16,13,6,6,4,2,7,28.6,5,15,6,9,12,28,10,0,defense
ENG-Premier League,2022,West Ham,Aaron Cresswell,ENG,DF,32,1989,24.8,21,11,12,7,2,12,31,38.7,19,21,11,10,27,48,56,0,defense
ENG-Premier League,2022,West Ham,Alphonse Areola,FRA,GK,29,1993,3.4,0,0,0,0,0,0,0,,0,0,0,0,0,0,0,0,defense
ENG-Premier League,2022,West Ham,Angelo Ogbonna,ITA,DF,34,1988,13.7,11,4,7,4,0,5,10,50.0,5,11,7,4,17,28,74,1,defense
ENG-Premier League,2022,West Ham,Ben Johnson,ENG,DF,22,2000,9.6,20,14,12,4,4,12,18,66.7,6,12,4,8,9,29,28,1,defense
ENG-Premier League,2022,West Ham,Conor Coventry,IRL,"MF,FW",22,2000,0.0,0,0,0,0,0,0,0,,0,0,0,0,0,0,0,0,defense
ENG-Premier League,2022,West Ham,Craig Dawson,ENG,DF,32,1990,8.0,11,7,9,2,0,5,7,71.4,2,9,6,3,6,17,26,0,defense
ENG-Premier League,2022,West Ham,Danny Ings,ENG,FW,30,1992,8.6,9,8,0,4,5,5,14,35.7,9,8,2,6,3,12,5,0,defense
ENG-Premier League,2022,West Ham,Declan Rice,ENG,MF,23,1999,36.4,79,38,44,31,4,31,50,62.0,19,45,15,30,63,142,58,0,defense
ENG-Premier League,2022,West Ham,Divin Mubama,ENG,FW,17,2004,0.4,1,1,1,0,0,0,0,,0,0,0,0,0,1,0,0,defense
ENG-Premier League,2022,West Ham,Emerson Palmieri,ITA,DF,27,1994,14.7,26,14,9,15,2,12,24,50.0,12,17,4,13,15,41,36,0,defense
ENG-Premier League,2022,West Ham,Flynn Downes,ENG,MF,23,1999,8.5,16,9,4,10,2,6,12,50.0,6,15,2,13,7,23,6,0,defense
ENG-Premier League,2022,West Ham,Gianluca Scamacca,ITA,FW,23,1999,10.3,10,5,1,3,6,2,2,100.0,0,3,0,3,4,14,5,0,defense
ENG-Premier League,2022,West Ham,Jarrod Bowen,ENG,"FW,MF",25,1996,35.9,39,16,14,11,14,16,58,27.6,42,47,9,38,36,75,25,0,defense
ENG-Premier League,2022,West Ham,Kurt Zouma,FRA,DF,27,1994,22.1,9,4,4,5,0,5,8,62.5,3,17,14,3,30,39,120,1,defense
ENG-Premier League,2022,West Ham,Lucas Paquetá,BRA,MF,24,1997,23.9,71,53,23,36,12,27,68,39.7,41,41,4,37,16,87,31,0,defense
ENG-Premier League,2022,West Ham,Manuel Lanzini,ARG,"MF,FW",29,1993,2.8,2,2,1,1,0,2,6,33.3,4,2,0,2,2,4,0,0,defense
ENG-Premier League,2022,West Ham,Maxwel Cornet,CIV,FW,25,1996,2.7,7,3,5,0,2,4,6,66.7,2,6,0,6,2,9,3,0,defense
ENG-Premier League,2022,West Ham,Michail Antonio,JAM,FW,32,1990,20.3,14,7,1,8,5,3,12,25.0,9,13,5,8,5,19,9,0,defense
ENG-Premier League,2022,West Ham,Nayef Aguerd,MAR,DF,26,1996,17.7,27,18,18,8,1,13,20,65.0,7,26,24,2,18,45,79,2,defense
ENG-Premier League,2022,West Ham,Pablo Fornals,ESP,"FW,MF",26,1996,16.7,30,15,9,12,9,13,34,38.2,21,16,2,14,14,44,9,0,defense
ENG-Premier League,2022,West Ham,Saïd Benrahma,ALG,"FW,MF",26,1995,23.0,25,15,11,7,7,11,27,40.7,16,23,1,22,9,34,13,0,defense
ENG-Premier League,2022,West Ham,Thilo Kehrer,GER,DF,25,1996,24.8,43,24,25,14,4,21,45,46.7,24,16,6,10,34,77,76,1,defense
ENG-Premier League,2022,West Ham,Tomáš Souček,CZE,MF,27,1995,31.3,77,37,41,29,7,28,58,48.3,30,42,17,25,53,130,71,3,defense
ENG-Premier League,2022,West Ham,Vladimír Coufal,CZE,DF,29,1992,23.7,58,31,37,15,6,36,51,70.6,15,24,6,18,38,96,70,0,defense
ENG-Premier League,2022,West Ham,Łukasz Fabiański,POL,GK,37,1985,34.6,2,0,2,0,0,1,2,50.0,1,1,0,1,0,2,10,1,defense
ENG-Premier League,2022,Wolves,Adama Traoré,ESP,"FW,MF",26,1996,16.6,14,7,7,4,3,4,9,44.4,5,8,1,7,3,17,17,0,defense
ENG-Premier League,2022,Wolves,Boubacar Traoré,MLI,MF,20,2001,4.6,12,5,4,5,3,3,7,42.9,4,4,2,2,7,19,1,0,defense
ENG-Premier League,2022,Wolves,Chem Campbell,WAL,"FW,MF",19,2002,0.8,2,1,1,1,0,0,1,0.0,1,2,0,2,1,3,0,0,defense
ENG-Premier League,2022,Wolves,Connor Ronan,IRL,MF,24,1998,0.0,0,0,0,0,0,0,0,,0,0,0,0,0,0,0,0,defense
ENG-Premier League,2022,Wolves,Craig Dawson,ENG,DF,32,1990,15.7,9,6,6,3,0,4,7,57.1,3,31,23,8,12,21,74,2,defense
ENG-Premier League,2022,Wolves,Daniel Bentley,ENG,GK,29,1993,2.0,1,1,1,0,0,1,1,100.0,0,0,0,0,0,1,0,1,defense
ENG-Premier League,2022,Wolves,Daniel Podence,POR,"FW,MF",26,1995,19.7,27,17,13,9,5,6,32,18.8,26,19,0,19,7,34,6,0,defense
ENG-Premier League,2022,Wolves,Dexter Lembikisa,JAM,DF,18,2003,0.3,0,0,0,0,0,0,0,,0,0,0,0,0,0,0,0,defense
ENG-Premier League,2022,Wolves,Diego Costa,ESP,FW,33,1988,13.8,3,1,3,0,0,2,9,22.2,7,6,1,5,2,5,17,0,defense
ENG-Premier League,2022,Wolves,Gonçalo Guedes,POR,"FW,MF",25,1996,7.9,8,6,4,3,1,5,8,62.5,3,4,0,4,1,9,2,0,defense
ENG-Premier League,2022,Wolves,Hugo Bueno,ESP,DF,19,2002,14.6,33,16,23,6,4,17,33,51.5,16,14,1,13,10,43,36,0,defense
ENG-Premier League,2022,Wolves,Hwang Hee-chan,KOR,"FW,MF",26,1996,12.6,20,9,7,8,5,6,20,30.0,14,18,2,16,5,25,5,0,defense
ENG-Premier League,2022,Wolves,Jonny Castro,ESP,DF,28,1994,14.0,33,15,22,10,1,17,38,44.7,21,26,5,21,14,47,28,2,defense
ENG-Premier League,2022,Wolves,Joseph Hodge,IRL,MF,19,2002,1.9,5,2,1,3,1,3,4,75.0,1,5,0,5,0,5,2,1,defense
ENG-Premier League,2022,Wolves,José Sá,POR,GK,29,1993,36.0,1,0,1,0,0,1,1,100.0,0,0,0,0,0,1,10,6,defense
ENG-Premier League,2022,Wolves,João Gomes,BRA,MF,21,2001,7.3,29,13,14,14,1,13,23,56.5,10,12,3,9,4,33,11,0,defense
ENG-Premier League,2022,Wolves,João Moutinho,POR,MF,35,1986,19.8,51,30,24,21,6,19,46,41.3,27,22,6,16,18,69,20,0,defense
ENG-Premier League,2022,Wolves,Leander Dendoncker,BEL,MF,27,1995,2.4,4,2,0,3,1,2,3,66.7,1,2,0,2,9,13,4,0,defense
ENG-Premier League,2022,Wolves,Mario Lemina,GAB,MF,28,1993,14.4,38,24,22,13,3,20,38,52.6,18,26,8,18,14,52,24,1,defense
ENG-Premier League,2022,Wolves,Matheus Cunha,BRA,FW,23,1999,10.7,7,4,0,5,2,2,10,20.0,8,15,3,12,9,16,11,0,defense
ENG-Premier League,2022,Wolves,Matheus Nunes,POR,MF,23,1998,27.4,67,43,36,22,9,28,61,45.9,33,35,4,31,16,83,35,2,defense
ENG-Premier League,2022,Wolves,Max Kilman,ENG,DF,25,1997,36.7,36,20,26,9,1,16,30,53.3,14,70,42,28,19,55,164,1,defense
ENG-Premier League,2022,Wolves,Morgan Gibbs-White,ENG,"FW,MF",22,2000,2.0,3,1,3,0,0,2,4,50.0,2,2,0,2,1,4,3,0,defense
ENG-Premier League,2022,Wolves,Nathan Collins,IRL,DF,21,2001,20.2,27,15,19,8,0,15,24,62.5,9,35,28,7,21,48,84,0,defense
ENG-Premier League,2022,Wolves,Nélson Semedo,POR,DF,28,1993,29.2,71,42,48,19,4,33,64,51.6,31,42,15,27,29,100,83,2,defense
ENG-Premier League,2022,Wolves,Pablo Sarabia,ESP,"FW,MF",30,1992,8.5,12,6,4,5,3,6,15,40.0,9,7,0,7,2,14,4,0,defense
ENG-Premier League,2022,Wolves,Pedro Neto,POR,"FW,MF",22,2000,10.7,11,6,4,2,5,7,17,41.2,10,5,1,4,4,15,4,0,defense
ENG-Premier League,2022,Wolves,Rayan Aït-Nouri,ALG,DF,21,2001,12.0,33,20,25,7,1,9,16,56.3,7,3,0,3,9,42,28,0,defense
ENG-Premier League,2022,Wolves,Raúl Jiménez,MEX,FW,31,1991,9.4,9,6,3,5,1,3,6,50.0,3,9,0,9,0,9,8,0,defense
ENG-Premier League,2022,Wolves,Rúben Neves,POR,MF,25,1997,33.5,79,43,31,33,15,32,76,42.1,44,59,22,37,50,129,85,1,defense
ENG-Premier League,2022,Wolves,Sasa Kalajdzic,AUT,FW,25,1997,0.5,0,0,0,0,0,0,0,,0,0,0,0,1,1,0,0,defense
ENG-Premier League,2022,Wolves,Toti Gomes,POR,DF,23,1999,10.9,15,9,11,4,0,9,13,69.2,4,16,8,8,11,26,51,0,defense
