league,season,team,player,nation,pos,age,born,90s,Tackles Tkl,Tackles TklW,Tackles Def 3rd,Tackles Mid 3rd,Tackles Att 3rd,Challenges Tkl,Challenges Att,Challenges Tkl%,Challenges Lost,Blocks Blocks,Blocks Sh,Blocks Pass,Int,Tkl+Int,Clr,Err,stat_type
FRA-Ligue 1,2024,Angers,Bamba Dieng,SEN,FW,25-019,2000.0,5.9,4,1,1,2,1,0,2,0.0,2,2,0,2,0,4,3,0,defense
FRA-Ligue 1,2024,Angers,Carlens Arcus,HAI,DF,28-287,1996.0,18.8,43,29,27,13,3,26,44,59.1,18,20,3,17,24,67,66,2,defense
FRA-Ligue 1,2024,Angers,Cédric Hountondji,BEN,DF,31-082,1994.0,3.0,6,4,4,2,0,3,7,42.9,4,3,3,0,4,10,14,0,defense
FRA-Ligue 1,2024,Angers,Emmanuel Biumla,FRA,DF,19-338,2005.0,14.6,19,12,14,5,0,12,18,66.7,6,18,8,10,8,27,83,1,defense
FRA-Ligue 1,2024,Angers,Esteban Lepaul,FRA,FW,24-358,2000.0,12.2,6,3,0,3,3,2,11,18.2,9,12,2,10,2,8,8,0,defense
FRA-Ligue 1,2024,Angers,Farid El Melali,ALG,FW,27-341,1997.0,18.7,26,14,14,6,6,11,30,36.7,19,16,1,15,13,39,12,1,defense
FRA-Ligue 1,2024,Angers,Florent Hanin,ALG,DF,35-066,1990.0,24.1,52,40,32,13,7,29,53,54.7,24,26,9,17,42,94,83,2,defense
FRA-Ligue 1,2024,Angers,Haris Belkebla,ALG,MF,31-073,1994.0,19.9,56,38,38,15,3,26,45,57.8,19,30,9,21,35,91,46,1,defense
FRA-Ligue 1,2024,Angers,Himad Abdelli,ALG,"MF,FW",25-145,1999.0,25.7,39,27,8,18,13,13,38,34.2,25,19,1,18,20,59,21,1,defense
FRA-Ligue 1,2024,Angers,Ibrahima Niane,SEN,FW,26-031,1999.0,10.0,6,3,3,2,1,3,3,100.0,0,5,1,4,2,8,4,2,defense
FRA-Ligue 1,2024,Angers,Jacques Ekomie,GAB,DF,21-235,2003.0,4.6,14,9,6,6,2,4,7,57.1,3,11,1,10,3,17,11,0,defense
FRA-Ligue 1,2024,Angers,Jean-Eudes Aholou,CIV,MF,31-022,1994.0,21.0,53,34,25,19,9,21,45,46.7,24,32,14,18,33,86,31,0,defense
FRA-Ligue 1,2024,Angers,Jim Allevinah,GAB,FW,30-043,1995.0,16.8,15,9,5,7,3,3,21,14.3,18,9,0,9,10,25,16,0,defense
FRA-Ligue 1,2024,Angers,Jordan Lefort,FRA,DF,31-245,1993.0,28.0,47,29,38,8,1,29,42,69.0,13,46,29,17,27,74,171,1,defense
FRA-Ligue 1,2024,Angers,Justin-Noël Kalumba,FRA,"FW,MF",20-107,2004.0,0.3,0,0,0,0,0,0,0,,0,0,0,0,1,1,1,0,defense
FRA-Ligue 1,2024,Angers,Lilian Raolisoa,FRA,"DF,FW",24-299,2000.0,10.0,31,19,20,9,2,13,28,46.4,15,8,2,6,10,41,36,0,defense
FRA-Ligue 1,2024,Angers,Lois Diony,FRA,FW,32-112,1992.0,0.2,0,0,0,0,0,0,0,,0,0,0,0,0,0,0,0,defense
FRA-Ligue 1,2024,Angers,Marius Courcoul,FRA,"DF,MF",18-100,2007.0,0.5,1,0,1,0,0,0,1,0.0,1,1,0,1,0,1,1,0,defense
FRA-Ligue 1,2024,Angers,Pierrick Capelle,FRA,MF,37-361,1987.0,5.4,24,17,10,9,5,9,18,50.0,9,4,1,3,11,35,5,1,defense
FRA-Ligue 1,2024,Angers,Sidiki Cherif,FRA,FW,18-117,2006.0,3.6,5,5,1,3,1,3,4,75.0,1,4,1,3,0,5,0,1,defense
FRA-Ligue 1,2024,Angers,Yahia Fofana,CIV,GK,24-233,2000.0,28.0,0,0,0,0,0,0,2,0.0,2,0,0,0,1,1,20,2,defense
FRA-Ligue 1,2024,Angers,Yassin Belkhdim,FRA,MF,23-056,2002.0,12.1,43,22,21,16,6,21,46,45.7,25,19,6,13,16,59,29,1,defense
FRA-Ligue 1,2024,Angers,Zinedine Ferhat,ALG,"FW,MF",32-041,1993.0,7.9,6,4,1,3,2,3,11,27.3,8,8,0,8,8,14,11,0,defense
FRA-Ligue 1,2024,Angers,Zinédine Ould Khaled,FRA,MF,25-087,2000.0,1.1,3,2,2,1,0,0,3,0.0,3,3,0,3,0,3,4,0,defense
FRA-Ligue 1,2024,Auxerre,Ado Onaiwu,JPN,"MF,FW",29-154,1995.0,7.9,6,5,1,5,0,2,7,28.6,5,4,0,4,2,8,10,0,defense
FRA-Ligue 1,2024,Auxerre,Aristide Zossou,CIV,MF,19-301,2005.0,0.2,0,0,0,0,0,0,0,,0,0,0,0,0,0,0,0,defense
FRA-Ligue 1,2024,Auxerre,Assane Dioussé,SEN,MF,27-203,1997.0,3.4,10,3,6,4,0,3,6,50.0,3,2,1,1,8,18,8,0,defense
FRA-Ligue 1,2024,Auxerre,Ben Viadere,FRA,MF,19-221,2005.0,0.1,0,0,0,0,0,0,0,,0,0,0,0,0,0,0,0,defense
FRA-Ligue 1,2024,Auxerre,Clément Akpa,CIV,DF,23-138,2001.0,22.4,51,33,33,12,6,29,42,69.0,13,36,13,23,33,84,118,2,defense
FRA-Ligue 1,2024,Auxerre,Donovan Léon,GUF,GK,32-159,1992.0,26.0,0,0,0,0,0,0,2,0.0,2,2,0,2,0,0,20,1,defense
FRA-Ligue 1,2024,Auxerre,Elisha Owusu,GHA,MF,27-155,1997.0,24.3,71,39,27,39,5,31,46,67.4,15,33,9,24,41,112,34,1,defense
FRA-Ligue 1,2024,Auxerre,Eros Maddy,NED,DF,24-065,2001.0,0.1,0,0,0,0,0,0,0,,0,0,0,0,0,0,0,0,defense
FRA-Ligue 1,2024,Auxerre,Florian Ayé,FRA,"FW,MF",28-082,1997.0,5.2,2,2,0,0,2,0,2,0.0,2,5,0,5,4,6,6,0,defense
FRA-Ligue 1,2024,Auxerre,Fredrik Oppegard,NOR,DF,22-247,2002.0,1.7,4,3,2,1,1,3,7,42.9,4,2,1,1,1,5,6,0,defense
FRA-Ligue 1,2024,Auxerre,Gabriel Osho,NGA,DF,26-240,1998.0,17.4,22,14,16,3,3,12,19,63.2,7,30,17,13,12,34,79,0,defense
FRA-Ligue 1,2024,Auxerre,Gaëtan Perrin,FRA,"MF,FW",28-308,1996.0,24.0,48,26,22,12,14,21,45,46.7,24,10,0,10,12,60,4,0,defense
FRA-Ligue 1,2024,Auxerre,Gideon Mensah,GHA,DF,26-267,1998.0,20.6,56,36,27,20,9,26,53,49.1,27,22,4,18,40,96,69,0,defense
FRA-Ligue 1,2024,Auxerre,Hamed Junior Traorè,CIV,MF,25-054,2000.0,21.7,41,20,11,17,13,16,53,30.2,37,14,0,14,6,47,11,0,defense
FRA-Ligue 1,2024,Auxerre,Han-Noah Massengo,FRA,MF,23-278,2001.0,6.9,12,7,5,4,3,6,8,75.0,2,6,2,4,9,21,6,1,defense
FRA-Ligue 1,2024,Auxerre,Jubal,BRA,DF,31-225,1993.0,24.4,53,34,43,9,1,25,36,69.4,11,55,30,25,19,72,168,1,defense
FRA-Ligue 1,2024,Auxerre,Ki-Jana Hoever,NED,DF,23-083,2002.0,19.8,47,34,25,14,8,27,49,55.1,22,29,3,26,18,65,58,0,defense
FRA-Ligue 1,2024,Auxerre,Kévin Danois,FRA,MF,20-287,2004.0,15.3,48,29,20,21,7,20,46,43.5,26,16,3,13,19,67,20,0,defense
FRA-Ligue 1,2024,Auxerre,Lassine Sinayoko,MLI,"FW,MF",25-124,1999.0,19.8,26,16,7,11,8,11,20,55.0,9,14,2,12,9,35,32,0,defense
FRA-Ligue 1,2024,Auxerre,Lasso Coulibaly,GHA,"FW,MF",22-174,2002.0,0.4,0,0,0,0,0,0,0,,0,0,0,0,0,0,0,0,defense
FRA-Ligue 1,2024,Auxerre,Loïc N'Gatta,FRA,DF,21-121,2003.0,0.1,1,1,0,1,0,1,2,50.0,1,1,0,1,0,1,1,0,defense
FRA-Ligue 1,2024,Auxerre,Paul Joly,FRA,DF,24-308,2000.0,8.8,41,27,27,13,1,21,37,56.8,16,13,0,13,23,64,27,5,defense
FRA-Ligue 1,2024,Auxerre,Rayan Raveloson,MAD,"MF,DF",28-085,1997.0,8.0,6,5,2,4,0,5,15,33.3,10,8,7,1,5,11,22,0,defense
FRA-Ligue 1,2024,Auxerre,Rudy Matondo,FRA,MF,17-029,2008.0,0.0,0,0,0,0,0,0,0,,0,0,0,0,0,0,0,0,defense
FRA-Ligue 1,2024,Auxerre,Sinaly Diomande,CIV,DF,24-002,2001.0,15.6,28,13,14,13,1,19,28,67.9,9,32,17,15,22,50,74,2,defense
FRA-Ligue 1,2024,Auxerre,Theo Bair,CAN,FW,25-227,1999.0,9.2,4,3,1,2,1,0,2,0.0,2,6,2,4,3,7,8,0,defense
FRA-Ligue 1,2024,Auxerre,Théo De Percin,MTQ,GK,24-068,2001.0,2.0,0,0,0,0,0,0,1,0.0,1,0,0,0,0,0,3,0,defense
FRA-Ligue 1,2024,Auxerre,Théo Pellenard,FRA,DF,31-038,1994.0,0.5,3,2,2,1,0,1,3,33.3,2,1,0,1,0,3,3,0,defense
FRA-Ligue 1,2024,Auxerre,Yoann Cissé,FRA,MF,20-119,2004.0,0.0,0,0,0,0,0,0,0,,0,0,0,0,0,0,0,0,defense
FRA-Ligue 1,2024,Brest,Abdallah Sima,SEN,"FW,MF",23-298,2001.0,10.8,9,8,1,3,5,4,9,44.4,5,5,0,5,1,10,9,0,defense
FRA-Ligue 1,2024,Brest,Abdoulaye Niakhate Ndiaye,SEN,DF,23-001,2002.0,14.5,36,25,26,10,0,18,28,64.3,10,20,12,8,7,43,116,1,defense
FRA-Ligue 1,2024,Brest,Axel Camblan,FRA,"MF,FW",21-224,2003.0,0.3,1,1,0,0,1,1,2,50.0,1,1,0,1,0,1,0,0,defense
FRA-Ligue 1,2024,Brest,Brendan Chardonnet,FRA,DF,30-110,1994.0,22.8,36,27,22,11,3,20,33,60.6,13,41,25,16,25,61,148,2,defense
FRA-Ligue 1,2024,Brest,Edimilson Fernandes,SUI,MF,28-361,1996.0,9.3,8,6,2,6,0,6,10,60.0,4,11,4,7,17,25,24,1,defense
FRA-Ligue 1,2024,Brest,Grégoire Coudert,FRA,GK,26-008,1999.0,1.0,0,0,0,0,0,0,0,,0,0,0,0,0,0,1,0,defense
FRA-Ligue 1,2024,Brest,Hamidou Makalou,MLI,FW,18-270,2006.0,0.2,0,0,0,0,0,0,0,,0,0,0,0,0,0,0,0,defense
FRA-Ligue 1,2024,Brest,Hianga Mananga Mbock,FRA,MF,25-104,1999.0,0.2,0,0,0,0,0,0,0,,0,0,0,0,1,1,0,0,defense
FRA-Ligue 1,2024,Brest,Hugo Magnetti,FRA,MF,26-316,1998.0,21.2,40,26,15,22,3,18,40,45.0,22,16,3,13,14,54,31,0,defense
FRA-Ligue 1,2024,Brest,Ibrahim Salah,MAR,FW,23-224,2001.0,4.0,4,2,1,1,2,1,6,16.7,5,2,0,2,2,6,0,0,defense
FRA-Ligue 1,2024,Brest,Jonas Martin,FRA,MF,35-002,1990.0,5.1,11,5,8,2,1,5,10,50.0,5,3,0,3,6,17,11,1,defense
FRA-Ligue 1,2024,Brest,Jordan Amavi,FRA,DF,31-033,1994.0,8.8,24,17,10,11,3,15,21,71.4,6,10,2,8,7,31,18,0,defense
FRA-Ligue 1,2024,Brest,Julien Le Cardinal,FRA,DF,27-251,1997.0,13.8,23,13,12,8,3,8,13,61.5,5,17,14,3,26,49,66,0,defense
FRA-Ligue 1,2024,Brest,Justin Bourgault,FRA,DF,19-209,2005.0,1.4,2,1,1,1,0,0,0,,0,0,0,0,0,2,1,0,defense
FRA-Ligue 1,2024,Brest,Jérémy Le Douaron,FRA,FW,26-355,1998.0,1.1,1,0,0,0,1,0,1,0.0,1,1,0,1,0,1,0,0,defense
FRA-Ligue 1,2024,Brest,Kamory Doumbia,MLI,MF,22-052,2003.0,11.6,30,21,12,14,4,10,25,40.0,15,13,1,12,23,53,12,1,defense
FRA-Ligue 1,2024,Brest,Kenny Lala,MAD,DF,33-190,1991.0,24.8,60,37,34,21,5,33,50,66.0,17,24,9,15,21,81,62,0,defense
FRA-Ligue 1,2024,Brest,Luc Zogbé,CIV,DF,20-018,2005.0,7.1,32,18,17,11,4,18,26,69.2,8,11,2,9,14,46,22,1,defense
FRA-Ligue 1,2024,Brest,Ludovic Ajorque,FRA,FW,31-045,1994.0,22.5,21,16,3,8,10,6,25,24.0,19,18,5,13,4,25,19,0,defense
FRA-Ligue 1,2024,Brest,Mahdi Camara,FRA,"MF,FW",26-285,1998.0,23.9,66,37,13,36,17,22,39,56.4,17,35,4,31,25,91,27,0,defense
FRA-Ligue 1,2024,Brest,Mama Samba Baldé,GNB,FW,29-156,1995.0,11.8,10,6,3,3,4,2,11,18.2,9,6,0,6,5,15,14,0,defense
FRA-Ligue 1,2024,Brest,Marco Bizot,NED,GK,34-032,1991.0,27.0,2,1,2,0,0,1,1,100.0,0,0,0,0,0,2,23,0,defense
FRA-Ligue 1,2024,Brest,Massadio Haïdara,MLI,DF,32-130,1992.0,13.7,16,11,10,6,0,7,17,41.2,10,9,1,8,17,33,60,0,defense
FRA-Ligue 1,2024,Brest,Mathias Pereira Lage,POR,"FW,MF",28-132,1996.0,12.2,28,18,13,9,6,13,28,46.4,15,13,1,12,15,43,16,2,defense
FRA-Ligue 1,2024,Brest,Pierre Lees-Melou,FRA,MF,31-321,1993.0,12.1,34,23,14,13,7,19,33,57.6,14,8,2,6,8,42,18,0,defense
FRA-Ligue 1,2024,Brest,Romain Del Castillo,FRA,FW,29-013,1996.0,11.8,27,19,9,10,8,17,29,58.6,12,15,0,15,6,33,3,0,defense
FRA-Ligue 1,2024,Brest,Romain Faivre,FRA,"MF,FW",26-271,1998.0,9.9,13,10,4,5,4,5,10,50.0,5,8,0,8,4,17,3,1,defense
FRA-Ligue 1,2024,Brest,Soumaïla Coulibaly,FRA,DF,21-179,2003.0,4.9,4,2,2,2,0,1,1,100.0,0,7,2,5,5,9,26,0,defense
FRA-Ligue 1,2024,Brest,Sérigné Diop,SEN,FW,19-334,2005.0,0.0,1,0,0,1,0,0,0,,0,1,0,1,0,1,0,0,defense
FRA-Ligue 1,2024,Le Havre,Abdoulaye Touré,GUI,MF,31-039,1994.0,19.8,54,29,30,17,7,30,48,62.5,18,26,15,11,26,80,33,3,defense
FRA-Ligue 1,2024,Le Havre,Alois Confais,FRA,MF,28-216,1996.0,0.0,0,0,0,0,0,0,0,,0,0,0,0,0,0,0,0,defense
FRA-Ligue 1,2024,Le Havre,André Ayew,GHA,FW,35-115,1989.0,12.7,15,9,3,6,6,7,11,63.6,4,8,2,6,2,17,19,1,defense
FRA-Ligue 1,2024,Le Havre,Antoine Joujou,FRA,"MF,FW",22-030,2003.0,10.3,16,11,10,4,2,9,15,60.0,6,15,3,12,8,24,19,0,defense
FRA-Ligue 1,2024,Le Havre,Arouna Sangante,SEN,DF,22-364,2002.0,10.4,18,13,10,8,0,9,13,69.2,4,10,5,5,18,36,48,1,defense
FRA-Ligue 1,2024,Le Havre,Arthur Desmas,FRA,GK,31-004,1994.0,18.0,0,0,0,0,0,0,1,0.0,1,0,0,0,0,0,9,1,defense
FRA-Ligue 1,2024,Le Havre,Christopher Operi,CIV,"DF,FW",27-347,1997.0,13.0,13,9,6,2,5,7,12,58.3,5,20,6,14,14,27,30,0,defense
FRA-Ligue 1,2024,Le Havre,Daler Kuzyaev,RUS,MF,32-086,1993.0,6.3,13,8,7,4,2,2,9,22.2,7,7,4,3,9,22,8,0,defense
FRA-Ligue 1,2024,Le Havre,Elysée Logbo,FRA,FW,20-340,2004.0,0.3,0,0,0,0,0,0,0,,0,0,0,0,0,0,0,0,defense
FRA-Ligue 1,2024,Le Havre,Emmanuel Sabbi,USA,"FW,MF",27-108,1997.0,7.3,14,7,7,4,3,5,8,62.5,3,2,0,2,3,17,4,0,defense
FRA-Ligue 1,2024,Le Havre,Etienne Youte Kinkoue,FRA,DF,23-087,2002.0,20.9,18,9,10,7,1,12,17,70.6,5,31,19,12,23,41,132,2,defense
FRA-Ligue 1,2024,Le Havre,Fodé Ballo-Touré,SEN,DF,28-098,1997.0,2.3,2,2,0,2,0,2,4,50.0,2,2,0,2,1,3,10,0,defense
FRA-Ligue 1,2024,Le Havre,Gautier Lloris,FRA,DF,29-267,1995.0,27.0,58,37,43,15,0,34,49,69.4,15,32,20,12,22,80,173,0,defense
FRA-Ligue 1,2024,Le Havre,Ilyes Housni,FRA,"FW,MF",19-332,2005.0,2.5,7,5,2,3,2,2,4,50.0,2,2,0,2,1,8,2,0,defense
FRA-Ligue 1,2024,Le Havre,Issa Soumaré,SEN,"MF,FW",24-183,2000.0,15.3,15,9,4,8,3,8,30,26.7,22,13,4,9,8,23,22,0,defense
FRA-Ligue 1,2024,Le Havre,Josué Casimir,FRA,"FW,MF",23-199,2001.0,16.2,30,20,14,12,4,9,17,52.9,8,9,0,9,4,34,30,1,defense
FRA-Ligue 1,2024,Le Havre,Junior Mwanga,FRA,MF,21-335,2003.0,5.6,17,9,5,11,1,9,13,69.2,4,8,2,6,5,22,9,1,defense
FRA-Ligue 1,2024,Le Havre,Kandet Diawara,GUI,FW,25-060,2000.0,0.0,0,0,0,0,0,0,0,,0,1,0,1,0,0,1,0,defense
FRA-Ligue 1,2024,Le Havre,Koka,EGY,FW,32-037,1993.0,7.0,4,1,1,3,0,0,4,0.0,4,1,0,1,2,6,6,1,defense
FRA-Ligue 1,2024,Le Havre,Loïc Nego,HUN,"DF,FW",34-086,1991.0,21.3,43,27,27,12,4,31,46,67.4,15,14,2,12,23,66,67,0,defense
FRA-Ligue 1,2024,Le Havre,Mahamadou Diawara,FRA,MF,20-053,2005.0,5.2,17,10,9,7,1,7,11,63.6,4,12,5,7,10,27,10,1,defense
FRA-Ligue 1,2024,Le Havre,Mathieu Gorgelin,FRA,GK,34-249,1990.0,10.0,2,2,2,0,0,2,3,66.7,1,0,0,0,0,2,4,0,defense
FRA-Ligue 1,2024,Le Havre,Mathéo Bodmer,FRA,MF,20-340,2004.0,0.1,0,0,0,0,0,0,0,,0,0,0,0,0,0,1,0,defense
FRA-Ligue 1,2024,Le Havre,Oussama Targhalline,MAR,MF,22-326,2002.0,11.0,19,14,12,3,4,5,12,41.7,7,14,7,7,19,38,14,2,defense
FRA-Ligue 1,2024,Le Havre,Rassoul Ndiaye,SEN,MF,23-121,2001.0,11.4,28,19,17,9,2,8,20,40.0,12,15,4,11,11,39,24,0,defense
FRA-Ligue 1,2024,Le Havre,Samuel Grandsir,FRA,"MF,FW",28-240,1996.0,0.9,5,5,0,3,2,2,3,66.7,1,2,0,2,0,5,0,0,defense
FRA-Ligue 1,2024,Le Havre,Steve Ngoura,FRA,FW,20-048,2005.0,3.2,4,2,1,1,2,3,3,100.0,0,2,1,1,0,4,2,0,defense
FRA-Ligue 1,2024,Le Havre,Timothee Pembele,FRA,DF,22-214,2002.0,10.7,28,22,17,9,2,14,22,63.6,8,15,5,10,9,37,39,0,defense
FRA-Ligue 1,2024,Le Havre,Yanis Zouaoui,ALG,"DF,FW",30-275,1994.0,10.3,17,8,9,6,2,10,14,71.4,4,14,2,12,8,25,43,0,defense
FRA-Ligue 1,2024,Le Havre,Yassine Kechta,MAR,"MF,FW",23-045,2002.0,18.3,47,27,24,17,6,26,61,42.6,35,22,2,20,20,67,24,1,defense
FRA-Ligue 1,2024,Le Havre,Yoann Salmier,GUF,DF,32-141,1992.0,8.9,14,7,9,4,1,10,13,76.9,3,12,8,4,10,24,59,0,defense
FRA-Ligue 1,2024,Lens,Abdukodir Khusanov,UZB,DF,21-041,2004.0,10.8,15,11,9,5,1,7,11,63.6,4,17,11,6,26,41,57,0,defense
FRA-Ligue 1,2024,Lens,Adrien Thomasson,FRA,MF,31-122,1993.0,23.2,76,42,36,23,17,47,82,57.3,35,35,3,32,17,93,24,1,defense
FRA-Ligue 1,2024,Lens,Anass Zaroury,MAR,"FW,MF",24-155,2000.0,11.2,16,14,4,9,3,7,19,36.8,12,7,0,7,4,20,10,0,defense
FRA-Ligue 1,2024,Lens,Andy Diouf,FRA,MF,21-329,2003.0,19.7,34,23,9,20,5,13,32,40.6,19,21,1,20,11,45,15,2,defense
FRA-Ligue 1,2024,Lens,Angelo Fulgini,FRA,"MF,FW",28-234,1996.0,10.3,13,9,6,4,3,6,16,37.5,10,11,1,10,2,15,3,0,defense
FRA-Ligue 1,2024,Lens,Brice Samba,FRA,GK,30-351,1994.0,15.0,0,0,0,0,0,0,0,,0,0,0,0,1,1,6,2,defense
FRA-Ligue 1,2024,Lens,David Costa,POR,"MF,FW",24-096,2001.0,3.9,2,0,1,1,0,1,4,25.0,3,5,1,4,1,3,0,0,defense
FRA-Ligue 1,2024,Lens,Deiver Machado,COL,"DF,MF",31-221,1993.0,17.1,32,23,13,13,6,16,26,61.5,10,18,3,15,15,47,24,1,defense
FRA-Ligue 1,2024,Lens,Facundo Medina,ARG,DF,25-318,1999.0,23.3,39,25,18,17,4,20,32,62.5,12,28,9,19,30,69,50,0,defense
FRA-Ligue 1,2024,Lens,Florian Sotoca,FRA,"FW,MF",34-168,1990.0,18.1,21,13,3,7,11,11,21,52.4,10,12,2,10,12,33,25,0,defense
FRA-Ligue 1,2024,Lens,Gabin Capuano,FRA,FW,18-350,2006.0,0.1,0,0,0,0,0,0,0,,0,0,0,0,0,0,0,0,defense
FRA-Ligue 1,2024,Lens,Goduine Koyalipou,CTA,FW,25-055,2000.0,4.8,1,1,0,1,0,0,0,,0,0,0,0,0,1,4,0,defense
FRA-Ligue 1,2024,Lens,Hamzat Ojediran,NGA,"MF,FW",21-148,2003.0,4.2,25,13,11,12,2,5,15,33.3,10,10,2,8,10,35,7,0,defense
FRA-Ligue 1,2024,Lens,Hervé Koffi,BFA,GK,28-177,1996.0,5.0,1,1,1,0,0,1,1,100.0,0,0,0,0,0,1,5,0,defense
FRA-Ligue 1,2024,Lens,Jeremy Agbonifo,SWE,"FW,MF",19-169,2005.0,2.2,4,3,4,0,0,2,3,66.7,1,1,0,1,1,5,0,1,defense
FRA-Ligue 1,2024,Lens,Jhoanner Chávez,ECU,"DF,MF",22-351,2002.0,6.6,9,5,4,4,1,2,7,28.6,5,10,1,9,6,15,13,0,defense
FRA-Ligue 1,2024,Lens,Jonathan Gradit,FRA,DF,32-138,1992.0,17.5,33,17,18,13,2,19,31,61.3,12,19,8,11,23,56,84,1,defense
FRA-Ligue 1,2024,Lens,Juma Bah,SLE,DF,19-000,2006.0,3.2,8,6,2,6,0,4,6,66.7,2,4,3,1,10,18,23,0,defense
FRA-Ligue 1,2024,Lens,Kembo Diliwidi,FRA,DF,19-067,2006.0,0.0,0,0,0,0,0,0,0,,0,0,0,0,0,0,0,0,defense
FRA-Ligue 1,2024,Lens,Kevin Danso,AUT,DF,26-204,1998.0,12.0,19,7,12,5,2,12,16,75.0,4,25,19,6,20,39,62,1,defense
FRA-Ligue 1,2024,Lens,Kyllian Antonio,FRA,"DF,FW",17-097,2008.0,1.0,1,1,1,0,0,1,3,33.3,2,0,0,0,3,4,3,1,defense
FRA-Ligue 1,2024,Lens,M'Bala Nzola,ANG,FW,28-236,1996.0,16.1,5,4,0,1,4,3,9,33.3,6,9,1,8,5,10,7,0,defense
FRA-Ligue 1,2024,Lens,Malang Sarr,FRA,DF,26-078,1999.0,13.3,16,11,10,5,1,11,22,50.0,11,16,7,9,21,37,51,3,defense
FRA-Ligue 1,2024,Lens,Martin Satriano,URU,"FW,DF",24-050,2001.0,0.5,3,1,1,1,1,3,3,100.0,0,0,0,0,0,3,2,0,defense
FRA-Ligue 1,2024,Lens,Mathew Ryan,AUS,GK,33-003,1992.0,8.0,0,0,0,0,0,0,0,,0,0,0,0,0,0,1,2,defense
FRA-Ligue 1,2024,Lens,Nampalys Mendy,SEN,MF,32-292,1992.0,3.5,9,6,3,4,2,4,10,40.0,6,6,2,4,4,13,3,0,defense
FRA-Ligue 1,2024,Lens,Neil El Aynaoui,FRA,MF,23-283,2001.0,13.1,33,18,17,10,6,10,29,34.5,19,28,6,22,18,51,22,0,defense
FRA-Ligue 1,2024,Lens,Przemysław Frankowski,POL,DF,29-364,1995.0,15.4,32,21,17,10,5,19,30,63.3,11,10,2,8,19,51,28,0,defense
FRA-Ligue 1,2024,Lens,Rayan Fofana,FRA,"FW,MF",19-058,2006.0,0.3,2,2,1,1,0,0,0,,0,0,0,0,0,2,0,0,defense
FRA-Ligue 1,2024,Lens,Ruben Aguilar,FRA,"DF,MF",31-350,1993.0,9.6,31,17,15,11,5,23,35,65.7,12,21,3,18,12,43,19,0,defense
FRA-Ligue 1,2024,Lens,Rémy Labeau Lascary,GLP,"FW,MF",22-039,2003.0,7.1,16,10,7,6,3,5,11,45.5,6,5,0,5,1,17,7,0,defense
FRA-Ligue 1,2024,Lens,Tom Pouilly,FRA,DF,21-297,2003.0,0.7,2,2,1,1,0,1,2,50.0,1,2,1,1,1,3,4,0,defense
FRA-Ligue 1,2024,Lens,Wesley Saïd,FRA,FW,29-357,1995.0,9.4,15,11,2,10,3,5,12,41.7,7,6,0,6,2,17,2,0,defense
FRA-Ligue 1,2024,Lille,Aaron Malouda,FRA,FW,19-132,2005.0,0.0,0,0,0,0,0,0,0,,0,0,0,0,0,0,0,0,defense
FRA-Ligue 1,2024,Lille,Alexsandro Ribeiro,BRA,DF,25-245,1999.0,24.0,27,16,15,11,1,19,29,65.5,10,19,11,8,24,51,108,1,defense
FRA-Ligue 1,2024,Lille,André Gomes,POR,MF,31-255,1993.0,11.4,26,13,9,10,7,10,29,34.5,19,6,1,5,6,32,9,1,defense
FRA-Ligue 1,2024,Lille,Angel Gomes,ENG,MF,24-223,2000.0,8.2,10,6,4,4,2,2,12,16.7,10,0,0,0,0,10,2,0,defense
FRA-Ligue 1,2024,Lille,Ayyoub Bouaddi,FRA,MF,17-191,2007.0,11.5,48,30,21,20,7,18,31,58.1,13,10,3,7,9,57,10,1,defense
FRA-Ligue 1,2024,Lille,Aïssa Mandi,ALG,DF,33-171,1991.0,16.1,25,15,7,14,4,12,17,70.6,5,21,10,11,14,39,40,0,defense
FRA-Ligue 1,2024,Lille,Bafodé Diakité,FRA,DF,24-095,2001.0,27.0,28,15,15,10,3,16,24,66.7,8,28,17,11,21,49,79,5,defense
FRA-Ligue 1,2024,Lille,Benjamin André,FRA,MF,34-251,1990.0,24.9,76,37,23,46,7,43,78,55.1,35,37,6,31,42,118,48,0,defense
FRA-Ligue 1,2024,Lille,Chuba Akpom,ENG,FW,29-184,1995.0,3.8,3,2,0,1,2,1,2,50.0,1,3,0,3,0,3,2,0,defense
FRA-Ligue 1,2024,Lille,Edon Zhegrova,KVX,"FW,MF",26-011,1999.0,10.9,5,2,3,0,2,2,7,28.6,5,8,0,8,4,9,1,0,defense
FRA-Ligue 1,2024,Lille,Ethan Mbappé,FRA,"MF,FW",18-103,2006.0,2.2,6,2,3,2,1,0,3,0.0,3,5,0,5,1,7,0,0,defense
FRA-Ligue 1,2024,Lille,Gabriel Gudmundsson,SWE,DF,25-347,1999.0,18.5,32,22,11,15,6,20,33,60.6,13,15,5,10,15,47,36,3,defense
FRA-Ligue 1,2024,Lille,Hákon Arnar Haraldsson,ISL,"MF,FW",22-001,2003.0,14.4,25,10,6,13,6,9,22,40.9,13,8,1,7,6,31,4,0,defense
FRA-Ligue 1,2024,Lille,Ismaily,BRA,DF,35-090,1990.0,5.4,21,9,11,7,3,9,15,60.0,6,11,1,10,6,27,25,0,defense
FRA-Ligue 1,2024,Lille,Jonathan David,CAN,FW,25-087,2000.0,22.9,18,4,3,9,6,7,13,53.8,6,11,2,9,4,22,8,0,defense
FRA-Ligue 1,2024,Lille,Lucas Chevalier,FRA,GK,23-156,2001.0,28.0,3,2,3,0,0,3,4,75.0,1,0,0,0,0,3,9,3,defense
FRA-Ligue 1,2024,Lille,Matias Fernandez-Pardo,BEL,FW,20-067,2005.0,6.4,8,6,3,3,2,4,9,44.4,5,6,0,6,1,9,4,0,defense
FRA-Ligue 1,2024,Lille,Mitchel Bakker,NED,"FW,DF",24-295,2000.0,11.2,23,13,6,11,6,10,17,58.8,7,9,1,8,11,34,15,0,defense
FRA-Ligue 1,2024,Lille,Mohamed Lamine Bayo,GUI,FW,26-311,1998.0,3.4,1,1,0,0,1,1,1,100.0,0,0,0,0,0,1,4,0,defense
FRA-Ligue 1,2024,Lille,Nabil Bentaleb,ALG,"MF,FW",30-138,1994.0,1.7,4,3,2,0,2,3,5,60.0,2,1,0,1,3,7,3,1,defense
FRA-Ligue 1,2024,Lille,Ngal'Ayel Mukau,COD,MF,20-132,2004.0,12.1,31,17,9,20,2,16,26,61.5,10,11,0,11,14,45,18,0,defense
FRA-Ligue 1,2024,Lille,Osame Sahraoui,MAR,"FW,MF",23-304,2001.0,12.9,10,7,2,3,5,2,6,33.3,4,11,1,10,6,16,6,1,defense
FRA-Ligue 1,2024,Lille,Ousmane Toure,FRA,DF,20-052,2005.0,0.1,0,0,0,0,0,0,0,,0,0,0,0,1,1,2,0,defense
FRA-Ligue 1,2024,Lille,Rémy Cabella,FRA,"FW,MF",35-034,1990.0,10.0,34,18,15,10,9,18,31,58.1,13,9,1,8,8,42,4,0,defense
FRA-Ligue 1,2024,Lille,Thomas Meunier,BEL,DF,33-211,1991.0,16.3,46,35,28,14,4,31,42,73.8,11,15,5,10,28,74,51,0,defense
FRA-Ligue 1,2024,Lille,Tiago Santos,POR,DF,22-262,2002.0,4.5,12,7,4,5,3,6,9,66.7,3,2,0,2,2,14,4,0,defense
FRA-Ligue 1,2024,Lille,Younes Lachaab,FRA,"MF,FW",20-095,2005.0,0.1,1,1,0,0,1,1,1,100.0,0,0,0,0,1,2,0,0,defense
FRA-Ligue 1,2024,Lyon,Abner,BRA,DF,24-319,2000.0,10.0,22,16,10,8,4,17,26,65.4,9,12,1,11,5,27,33,0,defense
FRA-Ligue 1,2024,Lyon,Adryelson,BRA,DF,27-019,1998.0,0.0,0,0,0,0,0,0,0,,0,0,0,0,1,1,1,0,defense
FRA-Ligue 1,2024,Lyon,Ainsley Maitland-Niles,ENG,DF,27-225,1997.0,17.5,60,38,25,22,13,41,65,63.1,24,24,4,20,21,81,45,6,defense
FRA-Ligue 1,2024,Lyon,Alexandre Lacazette,FRA,FW,33-318,1991.0,18.1,13,6,3,7,3,5,14,35.7,9,9,1,8,7,20,6,0,defense
FRA-Ligue 1,2024,Lyon,Clinton Mata,ANG,DF,32-155,1992.0,24.1,39,27,22,13,4,26,34,76.5,8,25,17,8,44,83,70,3,defense
FRA-Ligue 1,2024,Lyon,Corentin Tolisso,FRA,MF,30-251,1994.0,22.7,48,21,19,20,9,28,53,52.8,25,46,11,35,17,65,36,1,defense
FRA-Ligue 1,2024,Lyon,Duje Ćaleta-Car,CRO,DF,28-206,1996.0,13.9,16,8,8,8,0,8,15,53.3,7,27,21,6,13,29,73,2,defense
FRA-Ligue 1,2024,Lyon,Ernest Nuamah,GHA,"FW,MF",21-161,2003.0,11.7,21,11,15,4,2,12,27,44.4,15,9,1,8,8,29,8,1,defense
FRA-Ligue 1,2024,Lyon,Georges Mikautadze,GEO,FW,24-162,2000.0,12.6,6,5,1,2,3,3,9,33.3,6,8,0,8,3,9,4,0,defense
FRA-Ligue 1,2024,Lyon,Gift Orban,NGA,"FW,DF",22-268,2002.0,2.1,0,0,0,0,0,0,1,0.0,1,0,0,0,0,0,0,0,defense
FRA-Ligue 1,2024,Lyon,Jordan Veretout,FRA,MF,32-041,1993.0,14.7,23,12,10,11,2,14,35,40.0,21,14,2,12,4,27,21,0,defense
FRA-Ligue 1,2024,Lyon,Lucas Perri,BRA,GK,27-122,1997.0,28.0,1,1,1,0,0,0,4,0.0,4,1,0,1,0,1,19,1,defense
FRA-Ligue 1,2024,Lyon,Mahamadou Diawara,FRA,MF,20-053,2005.0,0.2,1,0,0,1,0,1,3,33.3,2,2,0,2,0,1,0,0,defense
FRA-Ligue 1,2024,Lyon,Malick Fofana,BEL,FW,20-011,2005.0,13.4,16,8,7,8,1,7,14,50.0,7,10,0,10,8,24,6,0,defense
FRA-Ligue 1,2024,Lyon,Mama Samba Baldé,GNB,FW,29-156,1995.0,0.4,2,2,0,2,0,0,0,,0,0,0,0,1,3,1,0,defense
FRA-Ligue 1,2024,Lyon,Maxence Caqueret,FRA,MF,25-055,2000.0,6.4,21,11,5,11,5,4,22,18.2,18,12,2,10,7,28,2,0,defense
FRA-Ligue 1,2024,Lyon,Moussa Niakhate,SEN,DF,29-034,1996.0,24.3,40,22,34,5,1,19,26,73.1,7,19,11,8,17,57,120,3,defense
FRA-Ligue 1,2024,Lyon,Nemanja Matić,SRB,MF,36-253,1988.0,18.8,33,27,9,19,5,17,33,51.5,16,18,7,11,12,45,26,1,defense
FRA-Ligue 1,2024,Lyon,Nicolás Tagliafico,ARG,DF,32-223,1992.0,17.1,51,33,22,19,10,25,41,61.0,16,22,7,15,31,82,43,0,defense
FRA-Ligue 1,2024,Lyon,Orel Mangala,BEL,MF,27-024,1998.0,0.7,1,0,0,0,1,0,1,0.0,1,2,0,2,0,1,1,0,defense
FRA-Ligue 1,2024,Lyon,Paul Akouokou,CIV,MF,27-112,1997.0,0.0,0,0,0,0,0,0,0,,0,0,0,0,1,1,0,0,defense
FRA-Ligue 1,2024,Lyon,Rayan Cherki,FRA,"FW,MF",21-237,2003.0,17.5,14,11,3,7,4,5,24,20.8,19,6,0,6,6,20,6,0,defense
FRA-Ligue 1,2024,Lyon,Sael Kumbedi,FRA,DF,20-016,2005.0,8.8,23,12,10,9,4,11,14,78.6,3,10,3,7,8,31,31,0,defense
FRA-Ligue 1,2024,Lyon,Saïd Benrahma,ALG,"FW,MF",29-244,1995.0,8.2,9,5,4,4,1,3,10,30.0,7,6,0,6,3,12,2,0,defense
FRA-Ligue 1,2024,Lyon,Tanner Tessmann,USA,MF,23-199,2001.0,10.6,19,11,6,9,4,8,19,42.1,11,10,6,4,15,34,24,1,defense
FRA-Ligue 1,2024,Lyon,Thiago Almada,ARG,"MF,FW",23-350,2001.0,5.3,4,2,2,2,0,2,10,20.0,8,1,0,1,3,7,2,0,defense
FRA-Ligue 1,2024,Lyon,Warmed Omari,COM,DF,24-353,2000.0,0.1,0,0,0,0,0,0,0,,0,0,0,0,0,0,1,0,defense
FRA-Ligue 1,2024,Lyon,Wilfried Zaha,CIV,FW,32-152,1992.0,0.8,1,1,1,0,0,1,2,50.0,1,3,0,3,1,2,0,0,defense
FRA-Ligue 1,2024,Marseille,Adrien Rabiot,FRA,MF,30-008,1995.0,21.6,40,24,14,17,9,19,30,63.3,11,15,1,14,19,59,27,0,defense
FRA-Ligue 1,2024,Marseille,Amar Dedić,BIH,DF,22-236,2002.0,2.8,3,2,2,0,1,1,8,12.5,7,0,0,0,3,6,8,1,defense
FRA-Ligue 1,2024,Marseille,Amine Gouiri,ALG,"FW,MF",25-054,2000.0,6.9,5,5,0,1,4,2,2,100.0,0,5,0,5,0,5,1,0,defense
FRA-Ligue 1,2024,Marseille,Amine Harit,MAR,MF,27-297,1997.0,5.2,7,6,0,5,2,1,2,50.0,1,6,0,6,3,10,1,1,defense
FRA-Ligue 1,2024,Marseille,Bamo Meïté,CIV,DF,23-129,2001.0,0.3,0,0,0,0,0,0,0,,0,0,0,0,0,0,1,0,defense
FRA-Ligue 1,2024,Marseille,Bilal Nadir,MAR,MF,21-134,2003.0,4.0,10,3,4,6,0,4,6,66.7,2,6,1,5,2,12,7,0,defense
FRA-Ligue 1,2024,Marseille,Darryl Bakola,FRA,"DF,MF",17-132,2007.0,0.2,1,1,0,1,0,0,0,,0,0,0,0,0,1,0,0,defense
FRA-Ligue 1,2024,Marseille,Derek Cornelius,CAN,DF,27-137,1997.0,14.6,23,16,14,8,1,16,21,76.2,5,14,8,6,13,36,47,0,defense
FRA-Ligue 1,2024,Marseille,Elye Wahi,FRA,FW,22-099,2003.0,6.4,0,0,0,0,0,0,4,0.0,4,1,0,1,1,1,0,0,defense
FRA-Ligue 1,2024,Marseille,Emmanuel Koum Mbondo,FRA,DF,19-065,2006.0,0.1,0,0,0,0,0,0,0,,0,0,0,0,0,0,0,0,defense
FRA-Ligue 1,2024,Marseille,Enzo Sternal,FRA,"FW,MF",17-318,2007.0,0.3,0,0,0,0,0,0,0,,0,0,0,0,0,0,0,0,defense
FRA-Ligue 1,2024,Marseille,Faris Pemi Moumbagna,CMR,FW,24-284,2000.0,0.1,0,0,0,0,0,0,0,,0,0,0,0,0,0,0,0,defense
FRA-Ligue 1,2024,Marseille,Geoffrey Kondogbia,CTA,"DF,MF",32-055,1993.0,18.4,50,31,25,22,3,24,31,77.4,7,19,3,16,17,67,48,4,defense
FRA-Ligue 1,2024,Marseille,Gerónimo Rulli,ARG,GK,32-326,1992.0,28.0,3,2,3,0,0,3,7,42.9,4,1,0,1,0,3,21,2,defense
FRA-Ligue 1,2024,Marseille,Ismaël Bennacer,ALG,MF,27-131,1997.0,5.1,19,10,7,11,1,11,16,68.8,5,4,0,4,8,27,1,0,defense
FRA-Ligue 1,2024,Marseille,Ismaël Koné,CAN,"MF,FW",22-309,2002.0,4.0,8,4,3,3,2,3,4,75.0,1,4,1,3,4,12,2,1,defense
FRA-Ligue 1,2024,Marseille,Jon Rowe,ENG,"FW,MF",21-346,2003.0,6.3,10,9,1,3,6,4,8,50.0,4,2,1,1,1,11,1,0,defense
FRA-Ligue 1,2024,Marseille,Keyliane Abdallah,FRA,FW,19-006,2006.0,0.0,1,1,1,0,0,1,1,100.0,0,0,0,0,0,1,0,0,defense
FRA-Ligue 1,2024,Marseille,Leonardo Balerdi,ARG,DF,26-075,1999.0,21.4,47,34,26,16,5,24,42,57.1,18,24,14,10,30,77,58,4,defense
FRA-Ligue 1,2024,Marseille,Lilian Brassier,FRA,DF,25-160,1999.0,8.7,8,6,8,0,0,5,6,83.3,1,8,3,5,9,17,28,2,defense
FRA-Ligue 1,2024,Marseille,Luis Henrique,BRA,"DF,FW",23-118,2001.0,24.8,15,9,6,6,3,8,9,88.9,1,12,2,10,8,23,27,0,defense
FRA-Ligue 1,2024,Marseille,Luiz Felipe,ITA,DF,28-020,1997.0,0.8,2,1,2,0,0,0,1,0.0,1,2,2,0,1,3,1,0,defense
FRA-Ligue 1,2024,Marseille,Mason Greenwood,ENG,"FW,MF",23-192,2001.0,25.3,32,16,10,13,9,15,34,44.1,19,5,0,5,9,41,5,2,defense
FRA-Ligue 1,2024,Marseille,Michael Amir Murillo,PAN,DF,29-059,1996.0,21.1,38,23,23,9,6,23,36,63.9,13,14,5,9,13,51,52,3,defense
FRA-Ligue 1,2024,Marseille,Neal Maupay,FRA,FW,28-240,1996.0,11.5,9,4,1,6,2,3,6,50.0,3,5,0,5,2,11,0,0,defense
FRA-Ligue 1,2024,Marseille,Pierre Højbjerg,DEN,MF,29-249,1995.0,23.9,48,31,20,23,5,29,59,49.2,30,26,4,22,37,85,29,1,defense
FRA-Ligue 1,2024,Marseille,Pol Lirola,ESP,DF,27-241,1997.0,6.8,12,8,5,7,0,4,12,33.3,8,6,2,4,4,16,10,0,defense
FRA-Ligue 1,2024,Marseille,Quentin Merlin,FRA,DF,22-330,2002.0,15.0,17,13,10,3,4,5,11,45.5,6,18,4,14,13,30,14,1,defense
FRA-Ligue 1,2024,Marseille,Robinio Vaz,FRA,FW,18-053,2007.0,0.8,1,1,0,0,1,0,2,0.0,2,0,0,0,0,1,2,0,defense
FRA-Ligue 1,2024,Marseille,Ulisses Garcia,SUI,DF,29-090,1996.0,5.9,10,8,4,4,2,3,10,30.0,7,3,0,3,5,15,11,0,defense
FRA-Ligue 1,2024,Marseille,Valentin Carboni,ARG,"MF,FW",20-037,2005.0,1.1,2,2,0,1,1,0,1,0.0,1,1,0,1,1,3,1,0,defense
FRA-Ligue 1,2024,Marseille,Valentin Rongier,FRA,"MF,DF",30-125,1994.0,13.4,36,20,10,23,3,17,30,56.7,13,25,7,18,26,62,24,4,defense
FRA-Ligue 1,2024,Monaco,Aleksandr Golovin,RUS,"MF,FW",28-316,1996.0,12.8,38,24,9,20,9,17,39,43.6,22,16,4,12,12,50,7,0,defense
FRA-Ligue 1,2024,Monaco,Almoatasem Al Musrati,LBY,MF,29-005,1996.0,3.5,10,7,3,6,1,5,9,55.6,4,3,1,2,4,14,7,0,defense
FRA-Ligue 1,2024,Monaco,Breel Embolo,SUI,"FW,MF",28-056,1997.0,15.9,17,12,6,3,8,4,14,28.6,10,5,0,5,3,20,5,1,defense
FRA-Ligue 1,2024,Monaco,Caio Henrique Oliveira Silva,BRA,DF,27-254,1997.0,15.8,28,20,12,14,2,16,31,51.6,15,18,3,15,15,43,37,0,defense
FRA-Ligue 1,2024,Monaco,Christian Mawissa,FRA,DF,19-358,2005.0,13.6,37,26,24,11,2,25,42,59.5,17,21,5,16,24,61,37,1,defense
FRA-Ligue 1,2024,Monaco,Denis Zakaria,SUI,MF,28-142,1996.0,18.8,33,19,10,17,6,21,30,70.0,9,23,7,16,25,58,31,1,defense
FRA-Ligue 1,2024,Monaco,Eliesse Ben Seghir,MAR,"MF,FW",20-054,2005.0,17.3,25,20,8,11,6,15,27,55.6,12,17,0,17,10,35,3,0,defense
FRA-Ligue 1,2024,Monaco,Eliot Matazo,BEL,MF,23-055,2002.0,0.8,3,2,0,3,0,0,0,,0,0,0,0,1,4,2,0,defense
FRA-Ligue 1,2024,Monaco,Folarin Balogun,USA,FW,23-282,2001.0,5.4,0,0,0,0,0,0,2,0.0,2,0,0,0,1,1,0,0,defense
FRA-Ligue 1,2024,Monaco,George Ilenikhena,FRA,FW,18-238,2006.0,7.1,1,1,0,1,0,0,1,0.0,1,0,0,0,2,3,0,0,defense
FRA-Ligue 1,2024,Monaco,Ismail Jakobs,SEN,DF,25-237,1999.0,2.0,5,5,3,0,2,3,5,60.0,2,0,0,0,2,7,6,0,defense
FRA-Ligue 1,2024,Monaco,Jordan Teze,NED,DF,25-193,1999.0,4.2,15,7,6,8,1,4,11,36.4,7,11,1,10,3,18,8,0,defense
FRA-Ligue 1,2024,Monaco,Kassoum Ouattara,FRA,"DF,FW",20-179,2004.0,4.3,9,7,5,4,0,4,14,28.6,10,6,0,6,5,14,2,1,defense
FRA-Ligue 1,2024,Monaco,Krépin Diatta,SEN,DF,26-045,1999.0,4.4,17,11,12,2,3,13,20,65.0,7,5,1,4,7,24,11,2,defense
FRA-Ligue 1,2024,Monaco,Lamine Camara,SEN,MF,21-100,2004.0,18.6,54,32,17,29,8,23,39,59.0,16,26,4,22,24,78,25,1,defense
FRA-Ligue 1,2024,Monaco,Lucas Michal,FRA,"FW,MF",19-294,2005.0,1.1,5,3,3,2,0,2,4,50.0,2,2,0,2,1,6,2,0,defense
FRA-Ligue 1,2024,Monaco,Maghnes Akliouche,FRA,"FW,MF",23-045,2002.0,21.7,44,27,12,19,13,16,36,44.4,20,16,0,16,12,56,12,0,defense
FRA-Ligue 1,2024,Monaco,Mamadou Coulibaly,FRA,MF,20-355,2004.0,0.1,1,0,0,1,0,0,0,,0,0,0,0,0,1,0,0,defense
FRA-Ligue 1,2024,Monaco,Mika Biereth,DEN,FW,22-062,2003.0,9.9,3,3,0,1,2,2,5,40.0,3,9,0,9,3,6,5,0,defense
FRA-Ligue 1,2024,Monaco,Mohammed Salisu,GHA,DF,25-359,1999.0,11.3,28,18,16,11,1,13,16,81.3,3,10,8,2,16,44,54,2,defense
FRA-Ligue 1,2024,Monaco,Philipp Köhn,SUI,GK,27-009,1998.0,13.0,0,0,0,0,0,0,1,0.0,1,0,0,0,0,0,7,1,defense
FRA-Ligue 1,2024,Monaco,Radosław Majecki,POL,GK,25-146,1999.0,15.0,0,0,0,0,0,0,2,0.0,2,0,0,0,0,0,8,1,defense
FRA-Ligue 1,2024,Monaco,Saïmon Bouabré,FRA,"MF,FW",18-314,2006.0,0.8,0,0,0,0,0,0,3,0.0,3,1,0,1,0,0,0,0,defense
FRA-Ligue 1,2024,Monaco,Soungoutou Magassa,FRA,MF,21-185,2003.0,9.8,40,23,12,24,4,22,38,57.9,16,12,3,9,21,61,18,1,defense
FRA-Ligue 1,2024,Monaco,Takumi Minamino,JPN,"MF,FW",30-085,1995.0,19.9,28,15,7,14,7,13,35,37.1,22,20,1,19,9,37,16,0,defense
FRA-Ligue 1,2024,Monaco,Thilo Kehrer,GER,DF,28-202,1996.0,23.5,35,22,24,11,0,20,34,58.8,14,16,9,7,31,66,101,1,defense
FRA-Ligue 1,2024,Monaco,Vanderson,BRA,DF,23-294,2001.0,19.1,61,35,30,25,6,38,53,71.7,15,36,6,30,32,93,53,1,defense
FRA-Ligue 1,2024,Monaco,Wilfried Singo,CIV,DF,24-107,2000.0,17.3,31,19,20,8,3,15,22,68.2,7,9,4,5,35,66,80,2,defense
FRA-Ligue 1,2024,Montpellier,Akor Adams,NGA,FW,25-072,2000.0,11.9,4,3,1,2,1,3,4,75.0,1,2,1,1,1,5,5,1,defense
FRA-Ligue 1,2024,Montpellier,Andy Delort,ALG,FW,33-184,1991.0,5.7,4,3,1,2,1,1,2,50.0,1,3,1,2,0,4,3,0,defense
FRA-Ligue 1,2024,Montpellier,Arnaud Nordin,FRA,FW,26-298,1998.0,13.0,24,15,6,16,2,11,21,52.4,10,12,0,12,5,29,7,0,defense
FRA-Ligue 1,2024,Montpellier,Axel Gueguin,FRA,FW,20-018,2005.0,0.3,1,1,0,1,0,1,1,100.0,0,0,0,0,0,1,0,0,defense
FRA-Ligue 1,2024,Montpellier,Bamo Meïté,CIV,DF,23-129,2001.0,4.5,4,2,1,1,2,1,2,50.0,1,3,3,0,3,7,13,2,defense
FRA-Ligue 1,2024,Montpellier,Becir Omeragic,SUI,"DF,MF",23-081,2002.0,14.0,19,8,13,5,1,10,15,66.7,5,24,15,9,9,28,48,0,defense
FRA-Ligue 1,2024,Montpellier,Benjamin Lecomte,FRA,GK,33-350,1991.0,24.0,0,0,0,0,0,0,0,,0,0,0,0,0,0,15,1,defense
FRA-Ligue 1,2024,Montpellier,Birama Touré,MLI,"MF,DF",32-309,1992.0,3.3,8,5,5,2,1,4,6,66.7,2,3,2,1,6,14,7,0,defense
FRA-Ligue 1,2024,Montpellier,Boubakar Kouyaté,MLI,DF,27-361,1997.0,6.4,16,10,11,5,0,9,17,52.9,8,15,10,5,11,27,52,0,defense
FRA-Ligue 1,2024,Montpellier,Dimitry Bertaud,COD,GK,26-309,1998.0,3.0,0,0,0,0,0,0,0,,0,0,0,0,0,0,2,0,defense
FRA-Ligue 1,2024,Montpellier,Enzo Tchato,CMR,DF,22-139,2002.0,19.6,45,23,25,16,4,25,42,59.5,17,29,9,20,22,67,53,0,defense
FRA-Ligue 1,2024,Montpellier,Falaye Sacko,MLI,DF,29-345,1995.0,12.2,14,8,9,4,1,9,19,47.4,10,17,7,10,12,26,21,0,defense
FRA-Ligue 1,2024,Montpellier,Gabriel Bares,SUI,"MF,DF",24-225,2000.0,0.6,2,2,2,0,0,1,2,50.0,1,0,0,0,1,3,3,0,defense
FRA-Ligue 1,2024,Montpellier,Issiaga Sylla,GUI,DF,31-100,1994.0,12.1,25,9,17,7,1,15,29,51.7,14,13,4,9,9,34,33,1,defense
FRA-Ligue 1,2024,Montpellier,Jordan Ferri,FRA,MF,33-030,1992.0,14.5,32,16,14,17,1,13,34,38.2,21,13,2,11,8,40,15,0,defense
FRA-Ligue 1,2024,Montpellier,Joris Chotard,FRA,MF,23-199,2001.0,16.7,32,21,16,15,1,17,39,43.6,22,26,8,18,16,48,48,0,defense
FRA-Ligue 1,2024,Montpellier,Junior Ndiaye,FRA,FW,20-013,2005.0,1.2,1,0,1,0,0,0,0,,0,1,1,0,0,1,1,0,defense
FRA-Ligue 1,2024,Montpellier,Khalil Fayad,FRA,"MF,FW",20-306,2004.0,7.8,26,13,11,14,1,12,21,57.1,9,12,1,11,7,33,14,1,defense
FRA-Ligue 1,2024,Montpellier,Lucas Mincarelli,FRA,DF,21-096,2004.0,2.8,4,4,1,2,1,1,5,20.0,4,1,1,0,1,5,8,0,defense
FRA-Ligue 1,2024,Montpellier,Modibo Sagnan,MLI,DF,25-362,1999.0,21.7,54,32,37,14,3,24,42,57.1,18,23,13,10,26,80,108,5,defense
FRA-Ligue 1,2024,Montpellier,Musa Al-Taamari,JOR,"FW,MF",27-305,1997.0,12.4,14,10,4,5,5,8,15,53.3,7,2,0,2,3,17,3,2,defense
FRA-Ligue 1,2024,Montpellier,Nicolas Pays,FRA,"FW,MF",21-247,2003.0,3.1,7,3,2,2,3,3,7,42.9,4,1,0,1,3,10,1,0,defense
FRA-Ligue 1,2024,Montpellier,Nikola Maksimović,SRB,DF,33-137,1991.0,6.5,9,5,6,3,0,6,7,85.7,1,5,4,1,6,15,30,1,defense
FRA-Ligue 1,2024,Montpellier,Othmane Maamma,MAR,"FW,MF",19-187,2005.0,3.0,3,1,2,1,0,1,4,25.0,3,4,0,4,1,4,2,1,defense
FRA-Ligue 1,2024,Montpellier,Rabby Nzingoula,CGO,MF,19-137,2005.0,14.2,45,28,18,21,6,20,46,43.5,26,20,4,16,25,70,20,0,defense
FRA-Ligue 1,2024,Montpellier,Simon Cara,FRA,"MF,FW",19-315,2005.0,0.1,0,0,0,0,0,0,0,,0,0,0,0,0,0,0,0,defense
FRA-Ligue 1,2024,Montpellier,Stefan Džodić,SRB,"DF,MF",20-027,2005.0,2.1,6,3,3,3,0,4,6,66.7,2,5,4,1,4,10,8,0,defense
FRA-Ligue 1,2024,Montpellier,Tanguy Coulibaly,FRA,"FW,MF",24-052,2001.0,9.8,16,11,3,10,3,5,15,33.3,10,13,1,12,6,22,1,0,defense
FRA-Ligue 1,2024,Montpellier,Théo Chennahi,FRA,"MF,DF",20-064,2005.0,0.1,0,0,0,0,0,0,0,,0,1,0,1,0,0,0,0,defense
FRA-Ligue 1,2024,Montpellier,Théo Sainte-Luce,FRA,DF,26-173,1998.0,7.2,15,8,12,1,2,11,24,45.8,13,12,4,8,4,19,22,0,defense
FRA-Ligue 1,2024,Montpellier,Téji Savanier,FRA,MF,33-110,1991.0,23.9,28,23,7,16,5,17,39,43.6,22,15,1,14,12,40,20,4,defense
FRA-Ligue 1,2024,Montpellier,Wahbi Khazri,TUN,"FW,MF",34-062,1991.0,11.3,23,16,5,14,4,7,19,36.8,12,11,1,10,5,28,7,0,defense
FRA-Ligue 1,2024,Montpellier,Wilfried Ndollo,CMR,DF,19-272,2005.0,0.5,1,1,1,0,0,1,1,100.0,0,0,0,0,1,2,0,0,defense
FRA-Ligue 1,2024,Montpellier,Yael Mouanga,FRA,DF,19-262,2005.0,5.7,6,3,4,1,1,3,5,60.0,2,9,6,3,4,10,32,0,defense
FRA-Ligue 1,2024,Montpellier,Yanis Issoufou,FRA,"MF,FW",18-165,2006.0,0.9,6,4,4,1,1,3,5,60.0,2,1,0,1,0,6,1,0,defense
FRA-Ligue 1,2024,Nantes,Alban Lafont,FRA,GK,26-078,1999.0,12.0,1,1,1,0,0,1,1,100.0,0,2,0,2,0,1,8,1,defense
FRA-Ligue 1,2024,Nantes,Anthony Lopes,POR,GK,34-192,1990.0,13.0,1,0,1,0,0,1,1,100.0,0,0,0,0,0,1,6,1,defense
FRA-Ligue 1,2024,Nantes,Bahereba Guirassy,FRA,"FW,MF",18-225,2006.0,3.5,9,5,4,2,3,4,10,40.0,6,10,0,10,1,10,4,0,defense
FRA-Ligue 1,2024,Nantes,Dehmaine Assoumani,FRA,"MF,FW",19-359,2005.0,0.9,6,3,0,4,2,4,5,80.0,1,1,0,1,1,7,4,0,defense
FRA-Ligue 1,2024,Nantes,Douglas,BRA,MF,28-088,1997.0,21.1,56,32,24,26,6,20,36,55.6,16,44,9,35,25,81,35,0,defense
FRA-Ligue 1,2024,Nantes,Fabien Centonze,FRA,DF,29-085,1996.0,0.9,3,1,1,1,1,1,3,33.3,2,1,0,1,1,4,7,0,defense
FRA-Ligue 1,2024,Nantes,Florent Mollet,FRA,"MF,FW",33-143,1991.0,2.7,2,2,1,1,0,1,1,100.0,0,2,0,2,1,3,4,0,defense
FRA-Ligue 1,2024,Nantes,Francis Coquelin,FRA,"MF,FW",33-333,1991.0,0.7,3,1,1,2,0,0,1,0.0,1,1,1,0,3,6,2,0,defense
FRA-Ligue 1,2024,Nantes,Ignatius Ganago,CMR,"FW,MF",26-054,1999.0,2.7,1,1,0,1,0,1,2,50.0,1,3,1,2,4,5,2,0,defense
FRA-Ligue 1,2024,Nantes,Jean-Charles Castelletto,CMR,"DF,MF",30-075,1995.0,23.1,29,13,14,13,2,15,23,65.2,8,22,15,7,23,52,123,0,defense
FRA-Ligue 1,2024,Nantes,Jean-Kevin Duverne,HAI,DF,27-273,1997.0,6.0,21,12,13,4,4,15,27,55.6,12,10,3,7,8,29,23,0,defense
FRA-Ligue 1,2024,Nantes,Jean-Philippe Gbamin,CIV,MF,29-198,1995.0,2.4,2,1,0,2,0,1,4,25.0,3,5,2,3,3,5,2,0,defense
FRA-Ligue 1,2024,Nantes,Johann Lepenant,FRA,MF,22-171,2002.0,19.6,60,29,25,24,11,27,60,45.0,33,27,2,25,14,74,18,0,defense
FRA-Ligue 1,2024,Nantes,Kelvin Amian,FRA,DF,27-062,1998.0,19.4,46,25,35,10,1,23,26,88.5,3,14,8,6,9,55,67,0,defense
FRA-Ligue 1,2024,Nantes,Louis Leroux,FRA,"MF,DF",19-078,2006.0,5.8,20,14,9,8,3,11,14,78.6,3,14,0,14,5,25,14,1,defense
FRA-Ligue 1,2024,Nantes,Marcus Coco,FRA,DF,28-291,1996.0,10.3,27,21,15,9,3,16,31,51.6,15,16,5,11,10,37,45,0,defense
FRA-Ligue 1,2024,Nantes,Matthis Abline,FRA,FW,22-014,2003.0,25.0,11,5,2,4,5,3,9,33.3,6,11,1,10,3,14,30,1,defense
FRA-Ligue 1,2024,Nantes,Meschak Elia,COD,FW,27-248,1997.0,1.7,6,5,3,2,1,1,1,100.0,0,2,0,2,0,6,2,0,defense
FRA-Ligue 1,2024,Nantes,Moses Simon,NGA,"FW,MF",29-273,1995.0,23.3,13,9,2,5,6,6,19,31.6,13,11,0,11,10,23,13,0,defense
FRA-Ligue 1,2024,Nantes,Mostafa Mohamed,EGY,FW,27-134,1997.0,11.1,17,9,5,8,4,4,12,33.3,8,8,2,6,8,25,23,0,defense
FRA-Ligue 1,2024,Nantes,Nathan Zeze,FRA,DF,19-297,2005.0,11.6,26,15,13,13,0,16,23,69.6,7,18,8,10,17,43,87,0,defense
FRA-Ligue 1,2024,Nantes,Nicolas Cozza,FRA,"DF,MF",26-093,1999.0,19.5,48,34,28,15,5,24,37,64.9,13,22,9,13,24,72,61,0,defense
FRA-Ligue 1,2024,Nantes,Nicolas Pallois,FRA,DF,37-204,1987.0,19.2,55,22,39,12,4,35,57,61.4,22,44,15,29,25,80,152,3,defense
FRA-Ligue 1,2024,Nantes,Patrik Carlgren,SWE,GK,33-093,1992.0,3.0,0,0,0,0,0,0,0,,0,0,0,0,0,0,0,0,defense
FRA-Ligue 1,2024,Nantes,Pedro Chirivella,ESP,MF,27-323,1997.0,21.3,32,23,14,15,3,14,32,43.8,18,20,3,17,15,47,40,0,defense
FRA-Ligue 1,2024,Nantes,Plamedi Nsingi,,MF,24-115,2000.0,0.2,1,0,1,0,0,0,1,0.0,1,0,0,0,0,1,0,0,defense
FRA-Ligue 1,2024,Nantes,Saidou Sow,GUI,DF,22-281,2002.0,8.9,17,11,13,4,0,6,10,60.0,4,19,12,7,13,30,46,1,defense
FRA-Ligue 1,2024,Nantes,Sorba Thomas,WAL,"FW,MF",25-232,1999.0,12.5,12,6,6,4,2,8,14,57.1,6,10,1,9,5,17,22,1,defense
FRA-Ligue 1,2024,Nantes,Sékou Doucoure,FRA,DF,19-350,2005.0,0.1,0,0,0,0,0,0,0,,0,0,0,0,0,0,3,0,defense
FRA-Ligue 1,2024,Nantes,Tino Kadewere,ZIM,"MF,FW",29-096,1996.0,5.3,13,7,4,3,6,6,12,50.0,6,3,0,3,5,18,8,0,defense
FRA-Ligue 1,2024,Nice,Ali Abdi,TUN,"DF,MF",31-112,1993.0,12.2,34,21,13,12,9,24,38,63.2,14,18,4,14,15,49,30,0,defense
FRA-Ligue 1,2024,Nice,Amidou Doumbouya,FRA,DF,17-249,2007.0,0.5,1,1,0,0,1,1,1,100.0,0,3,1,2,1,2,1,0,defense
FRA-Ligue 1,2024,Nice,Antoine Mendy,SEN,DF,20-319,2004.0,6.1,24,17,12,12,0,16,23,69.6,7,7,3,4,5,29,22,0,defense
FRA-Ligue 1,2024,Nice,Badredine Bouanani,ALG,"MF,FW",20-124,2004.0,7.9,7,3,2,3,2,2,10,20.0,8,12,3,9,6,13,4,0,defense
FRA-Ligue 1,2024,Nice,Baptiste Santamaria,FRA,MF,30-033,1995.0,8.3,18,8,9,7,2,12,19,63.2,7,12,2,10,15,33,18,1,defense
FRA-Ligue 1,2024,Nice,Bernard Nguene,CMR,FW,18-250,2006.0,0.1,0,0,0,0,0,0,0,,0,0,0,0,0,0,0,0,defense
FRA-Ligue 1,2024,Nice,Bilal Brahimi,ALG,MF,25-028,2000.0,0.8,0,0,0,0,0,0,0,,0,1,0,1,0,0,2,0,defense
FRA-Ligue 1,2024,Nice,Dante,BRA,DF,41-175,1983.0,19.2,29,12,16,11,2,14,27,51.9,13,25,11,14,30,59,65,1,defense
FRA-Ligue 1,2024,Nice,Evann Guessand,CIV,"FW,MF",23-284,2001.0,26.0,39,25,12,15,12,6,13,46.2,7,24,3,21,14,53,15,0,defense
FRA-Ligue 1,2024,Nice,Gaëtan Laborde,FRA,FW,30-343,1994.0,15.1,16,10,8,7,1,7,18,38.9,11,16,4,12,5,21,14,0,defense
FRA-Ligue 1,2024,Nice,Hicham Boudaoui,ALG,MF,25-200,1999.0,21.3,62,40,22,30,10,24,44,54.5,20,32,6,26,19,81,38,0,defense
FRA-Ligue 1,2024,Nice,Issiaga Camara,GUI,MF,20-068,2005.0,0.2,2,1,0,2,0,0,1,0.0,1,0,0,0,3,5,0,0,defense
FRA-Ligue 1,2024,Nice,Jeremie Boga,CIV,"MF,FW",28-098,1997.0,9.6,8,5,2,5,1,3,5,60.0,2,12,0,12,3,11,2,1,defense
FRA-Ligue 1,2024,Nice,Jonathan Clauss,FRA,"DF,MF",32-198,1992.0,19.7,44,33,24,15,5,25,46,54.3,21,18,2,16,39,83,62,2,defense
FRA-Ligue 1,2024,Nice,Jordan Lotomba,SUI,"MF,DF",26-194,1998.0,0.4,0,0,0,0,0,0,0,,0,0,0,0,0,0,1,0,defense
FRA-Ligue 1,2024,Nice,Marcin Bułka,POL,GK,25-189,1999.0,28.0,0,0,0,0,0,0,1,0.0,1,0,0,0,0,0,13,6,defense
FRA-Ligue 1,2024,Nice,Melvin Bard,FRA,"DF,MF",24-156,2000.0,15.5,42,28,26,12,4,18,34,52.9,16,25,8,17,20,62,40,2,defense
FRA-Ligue 1,2024,Nice,Mohamed Abdelmoneim,EGY,DF,26-069,1999.0,7.8,20,13,11,6,3,13,20,65.0,7,7,3,4,13,33,46,1,defense
FRA-Ligue 1,2024,Nice,Mohamed Ali Cho,FRA,"FW,MF",21-082,2004.0,17.5,12,8,4,4,4,4,11,36.4,7,17,1,16,4,16,8,0,defense
FRA-Ligue 1,2024,Nice,Morgan Sanson,FRA,MF,30-236,1994.0,0.3,3,2,1,2,0,0,0,,0,0,0,0,0,3,0,0,defense
FRA-Ligue 1,2024,Nice,Moïse Bombito,CAN,DF,25-012,2000.0,20.7,32,21,18,11,3,23,34,67.6,11,32,17,15,17,49,104,5,defense
FRA-Ligue 1,2024,Nice,Pablo Rosario,NED,"MF,DF",28-094,1997.0,16.0,23,15,4,16,3,8,16,50.0,8,15,8,7,25,48,37,2,defense
FRA-Ligue 1,2024,Nice,Rareş Ilie,ROU,MF,21-357,2003.0,0.1,1,1,1,0,0,1,1,100.0,0,0,0,0,0,1,0,0,defense
FRA-Ligue 1,2024,Nice,Sofiane Diop,FRA,"MF,FW",24-306,2000.0,10.6,22,15,15,3,4,9,22,40.9,13,19,2,17,16,38,7,1,defense
FRA-Ligue 1,2024,Nice,Tanguy Ndombele,FRA,MF,28-104,1996.0,12.6,35,23,10,21,4,12,20,60.0,8,9,0,9,14,49,9,0,defense
FRA-Ligue 1,2024,Nice,Terem Moffi,NGA,FW,25-321,1999.0,0.3,0,0,0,0,0,0,0,,0,0,0,0,0,0,0,0,defense
FRA-Ligue 1,2024,Nice,Tom Louchet,FRA,"DF,MF",21-342,2003.0,8.0,25,15,16,4,5,17,20,85.0,3,12,4,8,16,41,17,0,defense
FRA-Ligue 1,2024,Nice,Victor Orakpo,NGA,FW,18-301,2006.0,0.4,0,0,0,0,0,0,0,,0,0,0,0,0,0,0,0,defense
FRA-Ligue 1,2024,Nice,Yael Nandjou,FRA,DF,19-279,2005.0,1.7,4,1,2,1,1,4,8,50.0,4,4,1,3,4,8,7,0,defense
FRA-Ligue 1,2024,Nice,Youssouf Ndayishimiye,BDI,DF,26-166,1998.0,18.5,40,21,25,14,1,16,25,64.0,9,30,15,15,19,59,104,2,defense
FRA-Ligue 1,2024,Nice,Youssoufa Moukoko,GER,"FW,MF",20-142,2004.0,2.3,3,2,2,1,0,1,2,50.0,1,2,0,2,0,3,0,0,defense
FRA-Ligue 1,2024,Paris S-G,Achraf Hakimi,MAR,DF,26-158,1998.0,20.3,45,34,17,18,10,25,49,51.0,24,23,2,21,29,74,15,3,defense
FRA-Ligue 1,2024,Paris S-G,Bradley Barcola,FRA,FW,22-221,2002.0,20.4,24,14,8,7,9,6,28,21.4,22,22,2,20,16,40,9,0,defense
FRA-Ligue 1,2024,Paris S-G,Désiré Doué,FRA,"FW,MF",19-312,2005.0,15.9,34,21,12,15,7,17,35,48.6,18,16,0,16,12,46,7,0,defense
FRA-Ligue 1,2024,Paris S-G,Fabián Ruiz Peña,ESP,MF,29-008,1996.0,18.5,35,22,13,15,7,19,44,43.2,25,21,2,19,14,49,26,1,defense
FRA-Ligue 1,2024,Paris S-G,Gianluigi Donnarumma,ITA,GK,26-045,1999.0,20.2,1,1,1,0,0,1,2,50.0,1,0,0,0,0,1,10,0,defense
FRA-Ligue 1,2024,Paris S-G,Gonçalo Ramos,POR,FW,23-295,2001.0,8.1,11,6,5,5,1,3,6,50.0,3,4,1,3,0,11,4,0,defense
FRA-Ligue 1,2024,Paris S-G,Ibrahim Mbaye,FRA,"FW,MF",17-077,2008.0,1.1,1,1,0,1,0,1,4,25.0,3,0,0,0,0,1,1,0,defense
FRA-Ligue 1,2024,Paris S-G,João Neves,POR,"MF,DF",20-196,2004.0,17.3,55,29,17,24,14,24,40,60.0,16,25,8,17,20,75,19,1,defense
FRA-Ligue 1,2024,Paris S-G,Khvicha Kvaratskhelia,GEO,FW,24-058,2001.0,7.2,14,8,2,10,2,9,15,60.0,6,5,0,5,2,16,3,0,defense
FRA-Ligue 1,2024,Paris S-G,Lee Kang-in,KOR,"FW,MF",24-051,2001.0,15.5,20,13,6,8,6,17,31,54.8,14,8,1,7,2,22,3,1,defense
FRA-Ligue 1,2024,Paris S-G,Lucas Beraldo,BRA,DF,21-138,2003.0,17.9,31,24,25,6,0,19,31,61.3,12,12,6,6,19,50,45,2,defense
FRA-Ligue 1,2024,Paris S-G,Lucas Hernández,FRA,DF,29-056,1996.0,7.2,20,15,10,8,2,12,18,66.7,6,9,4,5,5,25,30,1,defense
FRA-Ligue 1,2024,Paris S-G,Marco Asensio,ESP,"FW,MF",29-080,1996.0,6.9,4,3,1,3,0,0,6,0.0,6,1,0,1,0,4,1,0,defense
FRA-Ligue 1,2024,Paris S-G,Marquinhos,BRA,DF,30-332,1994.0,16.6,26,15,7,14,5,22,28,78.6,6,23,11,12,9,35,58,0,defense
FRA-Ligue 1,2024,Paris S-G,Matvei Safonov,RUS,GK,26-045,1999.0,7.8,0,0,0,0,0,0,0,,0,1,0,1,1,1,3,0,defense
FRA-Ligue 1,2024,Paris S-G,Milan Škriniar,SVK,DF,30-059,1995.0,4.2,7,5,3,4,0,3,3,100.0,0,7,6,1,3,10,16,0,defense
FRA-Ligue 1,2024,Paris S-G,Nuno Mendes,POR,DF,22-296,2002.0,15.6,27,17,13,12,2,21,33,63.6,12,21,8,13,16,43,30,1,defense
FRA-Ligue 1,2024,Paris S-G,Ousmane Dembélé,FRA,FW,27-331,1997.0,17.0,11,5,0,7,4,4,11,36.4,7,3,0,3,9,20,2,1,defense
FRA-Ligue 1,2024,Paris S-G,Presnel Kimpembe,FRA,DF,29-241,1995.0,0.1,1,0,1,0,0,0,0,,0,2,2,0,0,1,1,0,defense
FRA-Ligue 1,2024,Paris S-G,Randal Kolo Muani,FRA,FW,26-127,1998.0,4.0,4,4,1,1,2,0,2,0.0,2,1,0,1,0,4,5,0,defense
FRA-Ligue 1,2024,Paris S-G,Senny Mayulu,FRA,MF,18-329,2006.0,5.3,18,11,7,10,1,5,9,55.6,4,7,3,4,3,21,5,0,defense
FRA-Ligue 1,2024,Paris S-G,Vitinha,POR,MF,25-057,2000.0,19.4,36,19,11,23,2,21,41,51.2,20,24,6,18,13,49,16,2,defense
FRA-Ligue 1,2024,Paris S-G,Warren Zaïre-Emery,FRA,"MF,DF",19-034,2006.0,18.4,43,21,16,17,10,19,37,51.4,18,29,5,24,17,60,18,2,defense
FRA-Ligue 1,2024,Paris S-G,Willian Pacho,ECU,DF,23-177,2001.0,21.4,52,31,31,21,0,23,31,74.2,8,35,22,13,36,88,83,1,defense
FRA-Ligue 1,2024,Paris S-G,Yoram Zague,FRA,DF,18-331,2006.0,1.8,4,3,2,1,1,2,3,66.7,1,2,0,2,2,6,2,0,defense
FRA-Ligue 1,2024,Reims,Abdoul Koné,FRA,DF,19-354,2005.0,1.3,5,3,4,1,0,3,5,60.0,2,2,1,1,1,6,4,0,defense
FRA-Ligue 1,2024,Reims,Amadou Koné,MLI,MF,19-332,2005.0,9.7,36,25,23,13,0,17,24,70.8,7,12,2,10,16,52,24,1,defense
FRA-Ligue 1,2024,Reims,Amine Salama,FRA,FW,24-267,2000.0,4.1,3,2,0,2,1,0,3,0.0,3,2,1,1,1,4,0,0,defense
FRA-Ligue 1,2024,Reims,Ange Martial Tia,MLI,MF,18-142,2006.0,0.0,1,1,0,1,0,1,2,50.0,1,0,0,0,0,1,0,0,defense
FRA-Ligue 1,2024,Reims,Aurélio Buta,POR,DF,28-060,1997.0,17.6,36,23,21,11,4,21,37,56.8,16,11,2,9,18,54,49,0,defense
FRA-Ligue 1,2024,Reims,Cédric Kipré,CIV,DF,28-123,1996.0,19.8,33,22,24,8,1,24,32,75.0,8,33,21,12,27,60,130,2,defense
FRA-Ligue 1,2024,Reims,Eloge Zabi,CIV,"DF,MF",18-199,2006.0,0.2,0,0,0,0,0,0,0,,0,0,0,0,0,0,1,0,defense
FRA-Ligue 1,2024,Reims,Emmanuel Agbadou,CIV,DF,27-298,1997.0,14.0,25,17,19,3,3,19,26,73.1,7,22,13,9,19,44,64,1,defense
FRA-Ligue 1,2024,Reims,Gabriel Moscardo,BRA,MF,19-195,2005.0,0.4,2,0,2,0,0,1,3,33.3,2,1,1,0,0,2,0,0,defense
FRA-Ligue 1,2024,Reims,Hafiz Ibrahim,NGA,FW,19-112,2005.0,2.5,0,0,0,0,0,0,3,0.0,3,2,1,1,1,1,3,0,defense
FRA-Ligue 1,2024,Reims,Hiroki Sekine,JPN,DF,22-243,2002.0,5.5,7,5,5,2,0,5,12,41.7,7,8,2,6,5,12,25,0,defense
FRA-Ligue 1,2024,Reims,Ike Orazi,IRL,MF,17-304,2007.0,0.0,0,0,0,0,0,0,0,,0,0,0,0,0,0,0,0,defense
FRA-Ligue 1,2024,Reims,John Joe,IRL,MF,21-169,2003.0,5.1,15,9,9,4,2,3,15,20.0,12,7,0,7,6,21,6,0,defense
FRA-Ligue 1,2024,Reims,Jordan Pefok,USA,FW,28-350,1996.0,0.1,0,0,0,0,0,0,0,,0,0,0,0,0,0,0,0,defense
FRA-Ligue 1,2024,Reims,Joseph Okumu,KEN,DF,27-320,1997.0,15.9,25,13,19,6,0,13,20,65.0,7,27,17,10,22,47,107,2,defense
FRA-Ligue 1,2024,Reims,Junya Ito,JPN,FW,32-033,1993.0,26.4,39,27,14,15,10,16,55,29.1,39,29,1,28,13,52,13,1,defense
FRA-Ligue 1,2024,Reims,Keito Nakamura,JPN,FW,24-257,2000.0,24.6,22,15,7,9,6,11,27,40.7,16,19,1,18,9,31,12,0,defense
FRA-Ligue 1,2024,Reims,Malcolm Jeng,SWE,DF,20-033,2005.0,0.5,0,0,0,0,0,0,0,,0,0,0,0,3,3,1,0,defense
FRA-Ligue 1,2024,Reims,Mamadou Diakhon,FRA,"FW,MF",19-201,2005.0,8.0,12,8,4,3,5,9,16,56.3,7,4,1,3,2,14,5,0,defense
FRA-Ligue 1,2024,Reims,Marshall Munetsi,ZIM,MF,28-293,1996.0,18.8,36,18,22,9,5,22,38,57.9,16,27,3,24,17,53,35,0,defense
FRA-Ligue 1,2024,Reims,Martin Adeline,FRA,MF,21-130,2003.0,0.3,1,1,0,1,0,1,2,50.0,1,0,0,0,0,1,2,0,defense
FRA-Ligue 1,2024,Reims,Mohamed Bamba,CIV,MF,20-185,2004.0,0.1,0,0,0,0,0,0,1,0.0,1,2,1,1,0,0,1,0,defense
FRA-Ligue 1,2024,Reims,Mohammed Daramy,DEN,FW,23-094,2002.0,0.2,0,0,0,0,0,0,0,,0,0,0,0,0,0,1,0,defense
FRA-Ligue 1,2024,Reims,Mory Gbane,CIV,"DF,MF",24-107,2000.0,7.5,14,8,11,3,0,9,16,56.3,7,6,5,1,13,27,49,1,defense
FRA-Ligue 1,2024,Reims,Nhoa Sangui,FRA,"DF,MF",19-043,2006.0,10.5,14,7,5,5,4,7,10,70.0,3,7,3,4,5,19,18,0,defense
FRA-Ligue 1,2024,Reims,Niama Sissoko,MLI,"FW,MF",19-116,2005.0,0.5,0,0,0,0,0,0,0,,0,1,0,1,0,0,0,0,defense
FRA-Ligue 1,2024,Reims,Oumar Diakité,CIV,FW,21-112,2003.0,17.8,20,13,7,8,5,9,19,47.4,10,12,2,10,3,23,9,0,defense
FRA-Ligue 1,2024,Reims,Reda Khadra,GER,"MF,FW",23-281,2001.0,0.9,1,1,1,0,0,0,1,0.0,1,0,0,0,0,1,1,0,defense
FRA-Ligue 1,2024,Reims,Sergio Akieme,ESP,DF,27-116,1997.0,22.5,30,21,27,2,1,20,32,62.5,12,22,7,15,13,43,70,4,defense
FRA-Ligue 1,2024,Reims,Teddy Teuma,MLT,MF,31-193,1993.0,8.3,18,10,6,6,6,7,25,28.0,18,12,2,10,12,30,8,1,defense
FRA-Ligue 1,2024,Reims,Thibault De Smet,BEL,DF,26-310,1998.0,2.1,6,4,5,1,0,4,4,100.0,0,5,3,2,4,10,12,0,defense
FRA-Ligue 1,2024,Reims,Valentin Atangana Edoa,FRA,MF,19-229,2005.0,25.7,55,42,25,23,7,21,29,72.4,8,24,12,12,32,87,47,0,defense
FRA-Ligue 1,2024,Reims,Yaya Kader Fofana,MLI,"MF,FW",20-303,2004.0,7.0,17,11,8,5,4,4,12,33.3,8,11,2,9,3,20,2,0,defense
FRA-Ligue 1,2024,Reims,Yehvann Diouf,FRA,GK,25-146,1999.0,28.0,2,1,2,0,0,1,3,33.3,2,0,0,0,1,3,12,2,defense
FRA-Ligue 1,2024,Rennes,Adrien Truffert,FRA,"DF,MF",23-142,2001.0,24.6,51,29,22,17,12,25,38,65.8,13,40,6,34,23,74,44,1,defense
FRA-Ligue 1,2024,Rennes,Albert Grønbaek,DEN,"MF,FW",23-323,2001.0,9.0,21,11,10,7,4,10,28,35.7,18,9,1,8,4,25,6,0,defense
FRA-Ligue 1,2024,Rennes,Alidu Seidu,GHA,DF,24-311,2000.0,8.9,22,18,14,6,2,12,15,80.0,3,13,6,7,14,36,17,0,defense
FRA-Ligue 1,2024,Rennes,Amine Gouiri,ALG,"MF,FW",25-054,2000.0,11.5,9,6,4,4,1,2,8,25.0,6,8,0,8,2,11,5,0,defense
FRA-Ligue 1,2024,Rennes,Anthony Rouault,FRA,DF,23-317,2001.0,4.8,5,3,3,2,0,3,3,100.0,0,7,6,1,3,8,24,0,defense
FRA-Ligue 1,2024,Rennes,Arnaud Kalimuendo,FRA,"FW,MF",23-081,2002.0,23.9,16,11,5,8,3,6,12,50.0,6,8,2,6,4,20,11,0,defense
FRA-Ligue 1,2024,Rennes,Ayanda Sishuba,BEL,FW,20-068,2005.0,0.0,1,0,1,0,0,1,1,100.0,0,0,0,0,0,1,0,0,defense
FRA-Ligue 1,2024,Rennes,Azor Matusiwa,NED,MF,26-348,1998.0,18.2,58,35,27,29,2,29,39,74.4,10,25,9,16,33,91,45,0,defense
FRA-Ligue 1,2024,Rennes,Baptiste Santamaria,FRA,MF,30-033,1995.0,5.4,11,4,7,3,1,6,11,54.5,5,10,4,6,12,23,7,0,defense
FRA-Ligue 1,2024,Rennes,Benjamin Bourigeaud,FRA,MF,31-087,1994.0,0.9,1,0,0,1,0,0,2,0.0,2,2,1,1,2,3,1,0,defense
FRA-Ligue 1,2024,Rennes,Brice Samba,FRA,GK,30-351,1994.0,11.0,1,0,1,0,0,1,1,100.0,0,0,0,0,0,1,9,2,defense
FRA-Ligue 1,2024,Rennes,Carlos Gómez,COL,"MF,FW",22-211,2002.0,3.5,7,6,2,4,1,3,9,33.3,6,5,0,5,2,9,2,0,defense
FRA-Ligue 1,2024,Rennes,Christopher Wooh,CMR,DF,23-205,2001.0,15.5,33,16,19,12,2,16,22,72.7,6,22,8,14,23,56,63,0,defense
FRA-Ligue 1,2024,Rennes,Djaoui Cissé,FRA,MF,21-070,2004.0,7.3,23,14,10,7,6,13,21,61.9,8,17,3,14,10,33,7,0,defense
FRA-Ligue 1,2024,Rennes,Gauthier Gallon,FRA,GK,31-353,1993.0,0.5,0,0,0,0,0,0,0,,0,0,0,0,0,0,0,0,defense
FRA-Ligue 1,2024,Rennes,Glen Kamara,FIN,MF,29-165,1995.0,7.4,23,11,10,11,2,11,17,64.7,6,7,0,7,7,30,7,0,defense
FRA-Ligue 1,2024,Rennes,Hans Hateboer,NED,DF,31-092,1994.0,18.5,30,15,14,11,5,17,35,48.6,18,18,6,12,29,59,63,2,defense
FRA-Ligue 1,2024,Rennes,Henrik Meister,DEN,FW,21-145,2003.0,0.7,2,0,0,2,0,0,0,,0,4,0,4,1,3,0,0,defense
FRA-Ligue 1,2024,Rennes,Ismaël Koné,CAN,MF,22-309,2002.0,3.1,6,3,2,3,1,3,4,75.0,1,5,1,4,3,9,4,0,defense
FRA-Ligue 1,2024,Rennes,Jordan James,WAL,MF,20-283,2004.0,11.6,25,15,5,16,4,13,26,50.0,13,12,1,11,12,37,16,1,defense
FRA-Ligue 1,2024,Rennes,Jota,POR,"FW,MF",26-012,1999.0,3.7,5,2,2,3,0,4,7,57.1,3,1,0,1,3,8,2,0,defense
FRA-Ligue 1,2024,Rennes,Jérémy Jacquet,FRA,DF,19-272,2005.0,5.6,16,10,7,4,5,8,14,57.1,6,3,2,1,19,35,36,1,defense
FRA-Ligue 1,2024,Rennes,Kazeem Olaigbe,BEL,"MF,FW",22-099,2003.0,2.0,3,2,2,1,0,1,3,33.3,2,2,0,2,0,3,0,0,defense
FRA-Ligue 1,2024,Rennes,Kyogo Furuhashi,JPN,FW,30-081,1995.0,1.3,2,2,1,1,0,1,1,100.0,0,0,0,0,0,2,0,0,defense
FRA-Ligue 1,2024,Rennes,Leo Skiri Østigård,NOR,DF,25-134,1999.0,13.6,20,18,16,4,0,15,22,68.2,7,12,10,2,15,35,81,1,defense
FRA-Ligue 1,2024,Rennes,Lilian Brassier,FRA,DF,25-160,1999.0,7.7,6,6,6,0,0,4,5,80.0,1,14,9,5,19,25,38,0,defense
FRA-Ligue 1,2024,Rennes,Lorenz Assignon,TOG,"DF,MF",24-293,2000.0,21.2,41,22,21,18,2,15,35,42.9,20,18,3,15,22,63,60,0,defense
FRA-Ligue 1,2024,Rennes,Ludovic Blas,FRA,"MF,FW",27-101,1997.0,22.2,34,21,7,12,15,21,39,53.8,18,16,2,14,12,46,9,0,defense
FRA-Ligue 1,2024,Rennes,Mahamadou Nagida,CMR,DF,19-287,2005.0,4.8,8,6,4,3,1,4,5,80.0,1,3,0,3,9,17,6,0,defense
FRA-Ligue 1,2024,Rennes,Mikayil Ngor Faye,SEN,DF,20-271,2004.0,7.6,15,12,10,3,2,7,9,77.8,2,9,4,5,12,27,30,0,defense
FRA-Ligue 1,2024,Rennes,Mohamed Meité,FRA,FW,17-182,2007.0,4.4,1,0,0,1,0,0,0,,0,0,0,0,0,1,4,0,defense
FRA-Ligue 1,2024,Rennes,Musa Al-Taamari,JOR,"MF,FW",27-305,1997.0,3.2,2,0,1,0,1,0,1,0.0,1,3,0,3,1,3,0,0,defense
FRA-Ligue 1,2024,Rennes,Naouirou Ahamada,FRA,"MF,FW",23-013,2002.0,0.6,0,0,0,0,0,0,0,,0,0,0,0,2,2,2,0,defense
FRA-Ligue 1,2024,Rennes,Seko Fofana,CIV,MF,29-339,1995.0,6.4,10,7,3,6,1,2,4,50.0,2,7,1,6,6,16,5,0,defense
FRA-Ligue 1,2024,Rennes,Steve Mandanda,FRA,GK,40-014,1985.0,16.5,0,0,0,0,0,0,1,0.0,1,0,0,0,0,0,6,2,defense
FRA-Ligue 1,2024,Saint-Étienne,Aimen Moueffek,FRA,MF,24-002,2001.0,7.4,18,11,3,11,4,9,20,45.0,11,10,3,7,3,21,19,1,defense
FRA-Ligue 1,2024,Saint-Étienne,Anthony Briançon,FRA,DF,30-134,1994.0,0.0,0,0,0,0,0,0,0,,0,0,0,0,0,0,0,0,defense
FRA-Ligue 1,2024,Saint-Étienne,Augustine Boakye,GHA,"FW,MF",24-159,2000.0,8.1,7,3,3,4,0,3,11,27.3,8,5,0,5,6,13,4,0,defense
FRA-Ligue 1,2024,Saint-Étienne,Ayman Aiki,FRA,"FW,MF",19-290,2005.0,1.4,3,3,1,2,0,1,1,100.0,0,1,0,1,1,4,0,0,defense
FRA-Ligue 1,2024,Saint-Étienne,Ben Old,NZL,"MF,FW",22-241,2002.0,4.7,6,5,3,2,1,3,10,30.0,7,6,1,5,1,7,1,0,defense
FRA-Ligue 1,2024,Saint-Étienne,Benjamin Bouchouari,MAR,MF,23-149,2001.0,17.4,27,20,12,11,4,14,38,36.8,24,17,1,16,17,44,15,2,defense
FRA-Ligue 1,2024,Saint-Étienne,Beres Owusu,FRA,DF,21-204,2003.0,1.0,2,2,1,1,0,2,2,100.0,0,2,2,0,0,2,5,0,defense
FRA-Ligue 1,2024,Saint-Étienne,Dennis Appiah,FRA,DF,32-306,1992.0,17.7,50,34,29,18,3,31,55,56.4,24,24,6,18,18,68,69,1,defense
FRA-Ligue 1,2024,Saint-Étienne,Djylian N'Guessan,FRA,FW,16-224,2008.0,1.4,3,2,2,1,0,1,3,33.3,2,1,0,1,0,3,1,0,defense
FRA-Ligue 1,2024,Saint-Étienne,Dylan Batubinsika,COD,DF,29-055,1996.0,21.9,25,13,19,5,1,13,22,59.1,9,23,14,9,38,63,139,3,defense
FRA-Ligue 1,2024,Saint-Étienne,Florian Tardieu,FRA,MF,32-354,1992.0,7.6,12,8,4,6,2,3,10,30.0,7,10,2,8,9,21,10,0,defense
FRA-Ligue 1,2024,Saint-Étienne,Gautier Larsonneur,FRA,GK,28-047,1997.0,27.0,1,0,1,0,0,0,1,0.0,1,1,0,1,0,1,20,0,defense
FRA-Ligue 1,2024,Saint-Étienne,Ibrahim Sissoko,MLI,FW,29-135,1995.0,9.0,11,9,5,3,3,2,5,40.0,3,10,2,8,2,13,13,0,defense
FRA-Ligue 1,2024,Saint-Étienne,Ibrahima Wadji,SEN,"FW,MF",29-341,1995.0,1.6,5,5,2,2,1,3,7,42.9,4,0,0,0,0,5,0,0,defense
FRA-Ligue 1,2024,Saint-Étienne,Igor Miladinović,SRB,"FW,MF",21-307,2003.0,0.3,0,0,0,0,0,0,0,,0,0,0,0,1,1,1,0,defense
FRA-Ligue 1,2024,Saint-Étienne,Irvin Cardona,FRA,FW,27-246,1997.0,5.8,4,3,3,1,0,2,9,22.2,7,11,1,10,1,5,3,1,defense
FRA-Ligue 1,2024,Saint-Étienne,Jibril Othman,TUN,FW,20-350,2004.0,0.1,0,0,0,0,0,0,0,,0,0,0,0,0,0,0,0,defense
FRA-Ligue 1,2024,Saint-Étienne,Kévin Pedro,FRA,DF,19-049,2006.0,0.1,3,0,2,1,0,3,3,100.0,0,1,0,1,2,5,1,0,defense
FRA-Ligue 1,2024,Saint-Étienne,Lamine Fomba,FRA,MF,27-075,1998.0,2.4,8,6,2,5,1,2,7,28.6,5,7,1,6,4,12,5,1,defense
FRA-Ligue 1,2024,Saint-Étienne,Louis Mouton,FRA,MF,22-312,2002.0,10.8,41,21,12,20,9,17,30,56.7,13,16,3,13,10,51,16,0,defense
FRA-Ligue 1,2024,Saint-Étienne,Lucas Stassin,BEL,FW,20-134,2004.0,17.1,13,9,2,4,7,5,17,29.4,12,9,0,9,3,16,7,0,defense
FRA-Ligue 1,2024,Saint-Étienne,Léo Pétrot,FRA,DF,27-361,1997.0,22.3,50,30,31,16,3,28,38,73.7,10,39,20,19,34,84,81,1,defense
FRA-Ligue 1,2024,Saint-Étienne,Marwann Nzuzi,FRA,DF,20-330,2004.0,1.4,2,2,1,0,1,1,2,50.0,1,0,0,0,2,4,6,0,defense
FRA-Ligue 1,2024,Saint-Étienne,Mathieu Cafaro,FRA,"MF,FW",28-017,1997.0,8.1,10,7,4,4,2,4,15,26.7,11,7,1,6,7,17,3,0,defense
FRA-Ligue 1,2024,Saint-Étienne,Mathis Amougou,FRA,MF,19-083,2006.0,9.5,21,15,15,5,1,10,19,52.6,9,10,0,10,12,33,4,0,defense
FRA-Ligue 1,2024,Saint-Étienne,Maxime Bernauer,FRA,DF,26-284,1998.0,2.5,3,3,2,0,1,2,2,100.0,0,1,1,0,2,5,15,0,defense
FRA-Ligue 1,2024,Saint-Étienne,Mickael Nade,FRA,DF,26-038,1999.0,18.6,43,29,28,15,0,17,23,73.9,6,27,13,14,29,72,94,6,defense
FRA-Ligue 1,2024,Saint-Étienne,Pierre Cornud,FRA,DF,28-120,1996.0,6.4,12,10,6,4,2,8,17,47.1,9,9,4,5,9,21,28,1,defense
FRA-Ligue 1,2024,Saint-Étienne,Pierre Ekwah Elimby,FRA,MF,23-086,2002.0,21.6,44,24,16,24,4,29,46,63.0,17,20,10,10,38,82,62,1,defense
FRA-Ligue 1,2024,Saint-Étienne,Yunis Abdelhamid,MAR,DF,37-195,1987.0,10.9,17,11,15,2,0,10,16,62.5,6,26,18,8,13,30,56,1,defense
FRA-Ligue 1,2024,Saint-Étienne,Yvann Macon,FRA,DF,26-192,1998.0,7.8,19,11,9,7,3,10,21,47.6,11,14,4,10,2,21,10,1,defense
FRA-Ligue 1,2024,Saint-Étienne,Zuriko Davitashvili,GEO,"FW,MF",24-055,2001.0,24.0,19,11,7,7,5,12,40,30.0,28,20,0,20,12,31,9,0,defense
FRA-Ligue 1,2024,Strasbourg,Abakar Sylla,CIV,DF,22-107,2002.0,10.2,26,14,13,11,2,15,17,88.2,2,18,10,8,11,37,57,0,defense
FRA-Ligue 1,2024,Strasbourg,Andrew Omobamidele,IRL,DF,22-292,2002.0,2.7,4,3,2,2,0,1,3,33.3,2,4,3,1,3,7,21,0,defense
FRA-Ligue 1,2024,Strasbourg,Andrey Santos,BRA,MF,20-343,2004.0,25.7,91,62,41,41,9,39,68,57.4,29,38,12,26,23,114,59,1,defense
FRA-Ligue 1,2024,Strasbourg,Caleb Wiley,USA,"DF,MF",20-110,2004.0,3.0,1,0,0,1,0,0,1,0.0,1,3,1,2,4,5,5,0,defense
FRA-Ligue 1,2024,Strasbourg,Diego Moreira,POR,"DF,MF",20-248,2004.0,24.4,35,21,15,15,5,18,40,45.0,22,20,3,17,31,66,61,0,defense
FRA-Ligue 1,2024,Strasbourg,Dilane Bakwa,FRA,"MF,FW",22-228,2002.0,22.3,24,13,10,8,6,11,21,52.4,10,16,0,16,9,33,25,0,defense
FRA-Ligue 1,2024,Strasbourg,Eduard Sobol,UKR,DF,29-356,1995.0,1.0,0,0,0,0,0,0,2,0.0,2,2,1,1,2,2,14,0,defense
FRA-Ligue 1,2024,Strasbourg,Emanuel Emegha,NED,FW,22-067,2003.0,21.5,5,5,1,2,2,1,3,33.3,2,16,5,11,1,6,25,0,defense
FRA-Ligue 1,2024,Strasbourg,Félix Lemaréchal,FRA,"MF,FW",21-247,2003.0,15.1,28,19,11,13,4,13,26,50.0,13,26,1,25,14,42,15,0,defense
FRA-Ligue 1,2024,Strasbourg,Guela Doué,CIV,DF,22-176,2002.0,25.2,57,38,35,13,9,33,47,70.2,14,26,5,21,30,87,126,1,defense
FRA-Ligue 1,2024,Strasbourg,Guimissongui Ouattara,FRA,"FW,DF",19-171,2005.0,4.2,6,4,3,1,2,3,5,60.0,2,8,0,8,4,10,10,2,defense
FRA-Ligue 1,2024,Strasbourg,Habib Diarra,SEN,"MF,FW",21-098,2004.0,22.0,19,10,5,12,2,8,19,42.1,11,19,6,13,11,30,37,2,defense
FRA-Ligue 1,2024,Strasbourg,Ismaël Doukouré,FRA,"DF,MF",21-261,2003.0,23.8,31,16,15,14,2,13,21,61.9,8,26,11,15,22,53,92,3,defense
FRA-Ligue 1,2024,Strasbourg,Junior Mwanga,FRA,MF,21-335,2003.0,3.3,17,9,9,7,1,5,9,55.6,4,2,0,2,2,19,2,0,defense
FRA-Ligue 1,2024,Strasbourg,Jérémy Sebas,MTQ,"FW,MF",21-362,2003.0,2.1,3,2,1,1,1,2,3,66.7,1,2,0,2,0,3,4,0,defense
FRA-Ligue 1,2024,Strasbourg,Karl-Johan Johnsson,SWE,GK,35-073,1990.0,3.0,0,0,0,0,0,0,1,0.0,1,0,0,0,0,0,3,0,defense
FRA-Ligue 1,2024,Strasbourg,Karol Fila,POL,MF,26-302,1998.0,0.1,0,0,0,0,0,0,0,,0,0,0,0,0,0,0,0,defense
FRA-Ligue 1,2024,Strasbourg,Mamadou Sarr,FRA,DF,19-225,2005.0,21.5,26,16,15,10,1,15,22,68.2,7,20,16,4,20,46,95,2,defense
FRA-Ligue 1,2024,Strasbourg,Marvin Senaya,TOG,DF,24-073,2001.0,2.5,8,3,5,2,1,6,12,50.0,6,6,2,4,7,15,12,0,defense
FRA-Ligue 1,2024,Strasbourg,Milos Lukovic,SRB,"FW,MF",19-144,2005.0,0.1,0,0,0,0,0,0,0,,0,0,0,0,0,0,0,0,defense
FRA-Ligue 1,2024,Strasbourg,Nordine Kandil,FRA,MF,23-162,2001.0,0.1,0,0,0,0,0,0,0,,0,0,0,0,0,0,1,0,defense
FRA-Ligue 1,2024,Strasbourg,Pape Daouda Diongue,SEN,"MF,FW",,,0.9,2,0,1,1,0,1,2,50.0,1,0,0,0,3,5,2,0,defense
FRA-Ligue 1,2024,Strasbourg,Saidou Sow,GUI,DF,22-281,2002.0,11.3,9,5,6,3,0,6,12,50.0,6,15,9,6,15,24,37,2,defense
FRA-Ligue 1,2024,Strasbourg,Samuel Amo-Ameyaw,ENG,"DF,FW",18-267,2006.0,1.3,3,1,2,1,0,1,4,25.0,3,2,0,2,0,3,1,0,defense
FRA-Ligue 1,2024,Strasbourg,Sebastian Nanasi,SWE,"FW,MF",22-330,2002.0,21.0,19,12,5,12,2,7,19,36.8,12,23,3,20,6,25,16,0,defense
FRA-Ligue 1,2024,Strasbourg,Sekou Mara,FRA,"FW,MF",22-255,2002.0,7.1,9,6,0,5,4,3,8,37.5,5,8,0,8,3,12,2,0,defense
FRA-Ligue 1,2024,Strasbourg,Thomas Delaine,FRA,DF,33-018,1992.0,0.1,1,1,1,0,0,1,1,100.0,0,0,0,0,1,2,1,0,defense
FRA-Ligue 1,2024,Strasbourg,Valentín Barco,ARG,"MF,DF",20-262,2004.0,7.3,20,11,16,3,1,13,18,72.2,5,2,0,2,9,29,19,1,defense
FRA-Ligue 1,2024,Strasbourg,Óscar Perea,COL,MF,19-196,2005.0,0.1,0,0,0,0,0,0,0,,0,0,0,0,0,0,0,0,defense
FRA-Ligue 1,2024,Strasbourg,Đorđe Petrović,SRB,GK,25-185,1999.0,25.0,1,1,1,0,0,0,0,,0,0,0,0,0,1,19,0,defense
FRA-Ligue 1,2024,Toulouse,Aron Dønnum,NOR,"DF,MF",26-356,1998.0,24.9,45,26,19,20,6,24,45,53.3,21,26,3,23,25,70,33,1,defense
FRA-Ligue 1,2024,Toulouse,Charlie Cresswell,ENG,DF,22-237,2002.0,23.8,33,21,17,15,1,27,43,62.8,16,39,25,14,24,57,161,3,defense
FRA-Ligue 1,2024,Toulouse,Cristian Cásseres Jr.,VEN,MF,25-081,2000.0,24.0,84,56,39,35,10,39,70,55.7,31,29,6,23,32,116,32,1,defense
FRA-Ligue 1,2024,Toulouse,Denis Genreau,AUS,MF,25-325,1999.0,2.5,7,5,4,1,2,4,8,50.0,4,3,0,3,3,10,4,0,defense
FRA-Ligue 1,2024,Toulouse,Djibril Sidibé,FRA,DF,32-256,1992.0,17.6,51,27,27,17,7,23,37,62.2,14,8,2,6,17,68,48,1,defense
FRA-Ligue 1,2024,Toulouse,Edhy Zuliani,ITA,DF,20-243,2004.0,0.1,0,0,0,0,0,0,0,,0,0,0,0,1,1,0,0,defense
FRA-Ligue 1,2024,Toulouse,Frank Magri,CMR,FW,25-219,1999.0,11.4,4,0,0,3,1,3,7,42.9,4,15,1,14,2,6,8,0,defense
FRA-Ligue 1,2024,Toulouse,Gabriel Suazo,CHI,DF,27-245,1997.0,20.8,56,37,24,20,12,30,65,46.2,35,24,3,21,31,87,38,1,defense
FRA-Ligue 1,2024,Toulouse,Guillaume Restes,FRA,GK,20-031,2005.0,22.3,2,1,2,0,0,2,3,66.7,1,0,0,0,1,3,13,1,defense
FRA-Ligue 1,2024,Toulouse,Jaydee Canvot,FRA,"DF,MF",18-256,2006.0,8.3,17,7,10,5,2,9,14,64.3,5,8,2,6,8,25,28,1,defense
FRA-Ligue 1,2024,Toulouse,Joshua King,NOR,"FW,MF",33-086,1992.0,14.4,7,7,2,3,2,3,9,33.3,6,9,3,6,3,10,16,0,defense
FRA-Ligue 1,2024,Toulouse,Kjetil Haug,NOR,GK,26-303,1998.0,5.5,0,0,0,0,0,0,0,,0,0,0,0,0,0,3,0,defense
FRA-Ligue 1,2024,Toulouse,Logan Costa,CPV,DF,24-010,2001.0,1.0,2,1,0,2,0,1,1,100.0,0,2,2,0,2,4,4,0,defense
FRA-Ligue 1,2024,Toulouse,Mark McKenzie,USA,DF,26-045,1999.0,24.4,47,27,29,17,1,29,41,70.7,12,25,15,10,20,67,117,1,defense
FRA-Ligue 1,2024,Toulouse,Miha Zajc,SVN,MF,30-284,1994.0,2.7,4,4,1,2,1,3,5,60.0,2,1,1,0,3,7,7,0,defense
FRA-Ligue 1,2024,Toulouse,Naatan Skyttä,FIN,FW,22-339,2002.0,0.1,1,0,0,0,1,0,0,,0,0,0,0,0,1,0,0,defense
FRA-Ligue 1,2024,Toulouse,Niklas Schmidt,GER,MF,27-041,1998.0,2.3,6,4,1,5,0,4,7,57.1,3,0,0,0,1,7,4,0,defense
FRA-Ligue 1,2024,Toulouse,Noah Edjouma,FRA,"MF,FW",19-189,2005.0,1.4,2,2,0,1,1,1,2,50.0,1,1,1,0,2,4,2,0,defense
FRA-Ligue 1,2024,Toulouse,Rafik Messali,FRA,DF,21-348,2003.0,4.0,14,7,6,6,2,6,7,85.7,1,7,1,6,8,22,8,0,defense
FRA-Ligue 1,2024,Toulouse,Rasmus Nicolaisen,DEN,DF,28-026,1997.0,6.9,6,3,4,2,0,3,5,60.0,2,10,5,5,10,16,25,0,defense
FRA-Ligue 1,2024,Toulouse,Shavy Babicka,GAB,"MF,FW",24-314,2000.0,13.0,21,12,6,11,4,10,21,47.6,11,13,0,13,3,24,4,3,defense
FRA-Ligue 1,2024,Toulouse,Vincent Sierro,SUI,MF,29-185,1995.0,20.7,40,24,13,21,6,26,46,56.5,20,27,5,22,14,54,35,1,defense
FRA-Ligue 1,2024,Toulouse,Waren Kamanzi,NOR,"DF,MF",24-151,2000.0,8.8,25,12,11,11,3,12,24,50.0,12,3,1,2,7,32,19,0,defense
FRA-Ligue 1,2024,Toulouse,Yann Gboho,FRA,"MF,FW",24-087,2001.0,21.0,23,10,6,9,8,11,25,44.0,14,20,0,20,4,27,4,0,defense
FRA-Ligue 1,2024,Toulouse,Zakaria Aboukhlal,MAR,"MF,FW",25-052,2000.0,20.3,19,11,6,7,6,4,21,19.0,17,16,1,15,6,25,8,0,defense
FRA-Ligue 1,2024,Toulouse,Álex Domínguez,ESP,GK,26-255,1998.0,0.2,0,0,0,0,0,0,0,,0,0,0,0,0,0,0,0,defense
FRA-Ligue 1,2024,Toulouse,Ümit Akdag,ROU,DF,21-187,2003.0,4.8,5,2,1,4,0,3,9,33.3,6,8,6,2,11,16,15,0,defense
