league,season,team,player,nation,pos,age,born,90s,Tackles Tkl,Tackles TklW,Tackles Def 3rd,Tackles Mid 3rd,Tackles Att 3rd,Challenges Tkl,Challenges Att,Challenges Tkl%,Challenges Lost,Blocks Blocks,Blocks Sh,Blocks Pass,Int,Tkl+Int,Clr,Err,stat_type
FRA-Ligue 1,2021,Angers,Angelo Fulgini,FRA,MF,23,1996,30.3,22,13,4,12,6,12,34,35.3,22,17,0,17,15,37,9,0,defense
FRA-Ligue 1,2021,Angers,Antonin Bobichon,FRA,"MF,FW",24,1995,10.1,23,14,10,8,5,9,15,60.0,6,4,1,3,2,25,1,0,defense
FRA-Ligue 1,2021,Angers,Baptiste Santamaria,FRA,MF,25,1995,3.0,9,6,3,5,1,2,7,28.6,5,4,0,4,7,16,8,0,defense
FRA-Ligue 1,2021,Angers,Casimir Ninga,CHA,FW,27,1993,0.3,0,0,0,0,0,0,0,,0,0,0,0,0,0,1,0,defense
FRA-Ligue 1,2021,Angers,Enzo Ebosse,CMR,DF,21,1999,2.9,5,3,5,0,0,3,4,75.0,1,1,1,0,2,7,13,0,defense
FRA-Ligue 1,2021,Angers,Farid El Melali,ALG,"FW,MF",23,1997,4.6,9,5,5,4,0,2,13,15.4,11,12,0,12,6,15,2,0,defense
FRA-Ligue 1,2021,Angers,Ibrahim Amadou,FRA,MF,27,1993,16.7,39,26,18,19,2,15,38,39.5,23,14,4,10,23,62,25,0,defense
FRA-Ligue 1,2021,Angers,Ismaël Traoré,CIV,DF,33,1986,33.3,32,14,23,9,0,20,37,54.1,17,27,13,14,40,72,107,0,defense
FRA-Ligue 1,2021,Angers,Jimmy Cabot,FRA,"FW,MF",26,1994,10.5,26,13,8,14,4,11,36,30.6,25,8,0,8,12,38,6,0,defense
FRA-Ligue 1,2021,Angers,Lassana Coulibaly,MLI,MF,24,1996,18.7,78,41,33,34,11,39,75,52.0,36,29,4,25,33,111,17,0,defense
FRA-Ligue 1,2021,Angers,Lois Diony,FRA,FW,27,1992,19.4,15,10,3,9,3,4,18,22.2,14,6,3,3,5,20,16,0,defense
FRA-Ligue 1,2021,Angers,Mateo Pavlović,BIH,DF,30,1990,12.3,11,6,8,3,0,8,23,34.8,15,13,11,2,21,32,40,0,defense
FRA-Ligue 1,2021,Angers,Mathias Pereira Lage,POR,"FW,MF",23,1996,16.3,29,17,12,15,2,10,40,25.0,30,21,4,17,15,44,16,0,defense
FRA-Ligue 1,2021,Angers,Mohamed Ali Cho,FRA,"FW,MF",16,2004,3.9,9,7,2,6,1,4,9,44.4,5,4,0,4,3,12,0,0,defense
FRA-Ligue 1,2021,Angers,Noah Fatar,FRA,"FW,MF",18,2002,0.2,1,0,0,0,1,0,0,,0,0,0,0,0,1,0,0,defense
FRA-Ligue 1,2021,Angers,Paul Bernardoni,FRA,GK,23,1997,38.0,1,1,1,0,0,1,2,50.0,1,0,0,0,2,3,23,1,defense
FRA-Ligue 1,2021,Angers,Pierrick Capelle,FRA,"MF,DF",33,1987,22.8,53,28,24,17,12,31,79,39.2,48,25,1,24,47,100,32,0,defense
FRA-Ligue 1,2021,Angers,Rachid Alioui,MAR,FW,28,1992,0.2,0,0,0,0,0,0,1,0.0,1,0,0,0,0,0,0,0,defense
FRA-Ligue 1,2021,Angers,Rayan Aït-Nouri,ALG,DF,19,2001,2.1,3,2,1,2,0,3,5,60.0,2,2,1,1,4,7,1,0,defense
FRA-Ligue 1,2021,Angers,Romain Thomas,FRA,DF,32,1988,33.6,47,25,34,11,2,20,35,57.1,15,35,20,15,50,97,138,0,defense
FRA-Ligue 1,2021,Angers,Sada Thioub,SEN,"FW,MF",25,1995,14.0,17,14,7,6,4,7,23,30.4,16,10,0,10,9,26,3,0,defense
FRA-Ligue 1,2021,Angers,Sofiane Boufal,MAR,"FW,MF",26,1993,8.1,17,11,8,6,3,8,28,28.6,20,8,0,8,3,20,1,0,defense
FRA-Ligue 1,2021,Angers,Souleyman Doumbia,CIV,DF,23,1996,24.7,48,33,25,19,4,22,36,61.1,14,18,4,14,42,90,50,0,defense
FRA-Ligue 1,2021,Angers,Stéphane Bahoken,CMR,FW,28,1992,18.0,9,6,1,7,1,4,12,33.3,8,9,0,9,9,18,9,0,defense
FRA-Ligue 1,2021,Angers,Thomas Mangani,FRA,MF,33,1987,29.9,54,37,25,26,3,30,90,33.3,60,31,8,23,38,92,39,0,defense
FRA-Ligue 1,2021,Angers,Vincent Manceau,FRA,DF,31,1989,25.7,42,27,23,17,2,30,63,47.6,33,23,2,21,35,77,61,0,defense
FRA-Ligue 1,2021,Angers,Waniss Taibi,FRA,MF,18,2002,0.4,0,0,0,0,0,0,2,0.0,2,1,0,1,0,0,0,0,defense
FRA-Ligue 1,2021,Angers,Wilfried Kanga,CIV,FW,22,1998,1.5,0,0,0,0,0,0,1,0.0,1,1,0,1,0,0,2,0,defense
FRA-Ligue 1,2021,Angers,Yassin Fortune,FRA,FW,21,1999,0.2,0,0,0,0,0,0,0,,0,0,0,0,0,0,0,0,defense
FRA-Ligue 1,2021,Angers,Zinédine Ould Khaled,FRA,MF,20,2000,0.4,0,0,0,0,0,0,0,,0,0,0,0,1,1,0,0,defense
FRA-Ligue 1,2021,Bordeaux,Amadou Traore,FRA,"FW,MF",18,2002,3.4,6,1,2,2,2,2,9,22.2,7,9,0,9,1,7,2,0,defense
FRA-Ligue 1,2021,Bordeaux,Benoît Costil,FRA,GK,33,1987,38.0,1,1,1,0,0,1,3,33.3,2,1,0,1,1,2,17,0,defense
FRA-Ligue 1,2021,Bordeaux,Dilane Bakwa,FRA,"FW,MF",17,2002,0.6,2,2,1,1,0,0,1,0.0,1,2,0,2,1,3,0,0,defense
FRA-Ligue 1,2021,Bordeaux,Enock Kwateng,FRA,DF,23,1997,11.5,21,12,15,4,2,14,27,51.9,13,15,3,12,26,47,27,0,defense
FRA-Ligue 1,2021,Bordeaux,Hatem Ben Arfa,FRA,"MF,FW",33,1987,18.9,11,7,1,7,3,2,9,22.2,7,3,0,3,2,13,0,0,defense
FRA-Ligue 1,2021,Bordeaux,Hwang Ui-jo,KOR,"FW,MF",27,1992,27.8,14,6,5,8,1,6,25,24.0,19,17,2,15,8,22,14,0,defense
FRA-Ligue 1,2021,Bordeaux,Issouf Sissokho,MLI,"MF,DF",18,2002,0.9,6,4,4,2,0,3,6,50.0,3,2,0,2,1,7,0,0,defense
FRA-Ligue 1,2021,Bordeaux,Jean Seri,CIV,MF,29,1991,7.9,17,9,3,12,2,4,15,26.7,11,8,2,6,12,29,7,0,defense
FRA-Ligue 1,2021,Bordeaux,Jimmy Briand,FRA,FW,34,1985,6.3,7,3,3,2,2,1,1,100.0,0,2,0,2,1,8,3,0,defense
FRA-Ligue 1,2021,Bordeaux,Josh Maja,NGA,FW,21,1998,8.9,8,2,3,3,2,3,14,21.4,11,3,0,3,6,14,9,0,defense
FRA-Ligue 1,2021,Bordeaux,Laurent Koscielny,FRA,DF,34,1985,24.6,29,17,18,11,0,16,24,66.7,8,44,34,10,54,83,115,1,defense
FRA-Ligue 1,2021,Bordeaux,Loris Benito,SUI,DF,28,1992,29.5,42,26,27,12,3,22,48,45.8,26,33,10,23,42,84,70,0,defense
FRA-Ligue 1,2021,Bordeaux,Loïc Bessile,TOG,DF,21,1999,1.0,0,0,0,0,0,0,0,,0,2,1,1,1,1,3,0,defense
FRA-Ligue 1,2021,Bordeaux,Maxime Poundjé,FRA,DF,27,1992,5.5,10,7,9,1,0,2,6,33.3,4,7,3,4,11,21,5,0,defense
FRA-Ligue 1,2021,Bordeaux,Mehdi Zerkane,ALG,"MF,FW",21,1999,13.2,23,15,7,10,6,5,18,27.8,13,15,2,13,9,32,5,0,defense
FRA-Ligue 1,2021,Bordeaux,Mexer,MOZ,DF,31,1988,7.9,9,6,8,0,1,5,10,50.0,5,8,5,3,17,26,22,0,defense
FRA-Ligue 1,2021,Bordeaux,Nicolas de Préville,FRA,"FW,MF",29,1991,17.9,19,14,7,6,6,9,42,21.4,33,15,0,15,13,32,7,0,defense
FRA-Ligue 1,2021,Bordeaux,Otávio,BRA,MF,26,1994,17.3,54,31,33,19,2,26,55,47.3,29,20,5,15,26,80,36,0,defense
FRA-Ligue 1,2021,Bordeaux,Pablo,BRA,DF,29,1991,12.0,17,11,13,4,0,8,14,57.1,6,17,12,5,25,42,46,1,defense
FRA-Ligue 1,2021,Bordeaux,Paul Baysse,FRA,DF,32,1988,29.0,35,18,21,13,1,16,21,76.2,5,33,24,9,52,87,123,1,defense
FRA-Ligue 1,2021,Bordeaux,Remi Oudin,FRA,"FW,MF",23,1996,26.9,34,16,22,7,5,15,36,41.7,21,22,2,20,51,85,40,1,defense
FRA-Ligue 1,2021,Bordeaux,Rubén Pardo,ESP,MF,27,1992,0.3,0,0,0,0,0,0,0,,0,0,0,0,1,1,0,0,defense
FRA-Ligue 1,2021,Bordeaux,Samuel Kalu,NGA,"FW,MF",22,1997,10.7,21,12,11,8,2,4,13,30.8,9,14,0,14,9,30,2,0,defense
FRA-Ligue 1,2021,Bordeaux,Sekou Mara,FRA,"FW,MF",18,2002,2.5,5,3,1,3,1,2,10,20.0,8,0,0,0,1,6,1,0,defense
FRA-Ligue 1,2021,Bordeaux,Tom Lacoux,FRA,MF,18,2002,5.8,22,14,10,11,1,9,21,42.9,12,12,3,9,12,34,7,0,defense
FRA-Ligue 1,2021,Bordeaux,Toma Bašić,CRO,MF,23,1996,28.9,33,22,15,16,2,16,58,27.6,42,21,5,16,32,65,42,1,defense
FRA-Ligue 1,2021,Bordeaux,Yacine Adli,FRA,MF,20,2000,26.9,74,37,30,33,11,35,92,38.0,57,27,2,25,39,113,17,2,defense
FRA-Ligue 1,2021,Bordeaux,Youssouf Sabaly,SEN,DF,27,1993,32.3,47,33,24,17,6,27,45,60.0,18,31,8,23,49,96,57,2,defense
FRA-Ligue 1,2021,Brest,Bandiougou Fadiga,FRA,"MF,FW",19,2001,0.5,0,0,0,0,0,0,2,0.0,2,0,0,0,0,0,0,0,defense
FRA-Ligue 1,2021,Brest,Brendan Chardonnet,FRA,DF,25,1994,30.2,51,29,31,19,1,27,41,65.9,14,54,41,13,64,115,151,0,defense
FRA-Ligue 1,2021,Brest,Christophe Hérelle,MTQ,DF,27,1992,15.3,19,13,12,6,1,10,12,83.3,2,13,9,4,31,50,41,2,defense
FRA-Ligue 1,2021,Brest,Cristian Battocchio,ITA,MF,28,1992,3.9,5,2,1,4,0,2,9,22.2,7,0,0,0,4,9,5,0,defense
FRA-Ligue 1,2021,Brest,Franck Honorat,FRA,"MF,FW",23,1996,27.3,28,13,12,10,6,14,37,37.8,23,15,3,12,11,39,24,0,defense
FRA-Ligue 1,2021,Brest,Gautier Larsonneur,FRA,GK,23,1997,35.0,1,1,1,0,0,1,1,100.0,0,2,0,2,0,1,16,3,defense
FRA-Ligue 1,2021,Brest,Gaëtan Charbonnier,FRA,"MF,FW",31,1988,17.4,24,15,6,11,7,12,32,37.5,20,15,1,14,9,33,19,0,defense
FRA-Ligue 1,2021,Brest,Haris Belkebla,ALG,MF,26,1994,30.3,69,39,32,28,9,31,66,47.0,35,26,5,21,57,126,34,0,defense
FRA-Ligue 1,2021,Brest,Heriberto Tavares,POR,"FW,MF",23,1997,0.5,2,0,0,0,2,1,3,33.3,2,0,0,0,1,3,1,0,defense
FRA-Ligue 1,2021,Brest,Hianga Mananga Mbock,FRA,"MF,FW",20,1999,5.1,4,3,2,2,0,2,9,22.2,7,2,0,2,3,7,6,0,defense
FRA-Ligue 1,2021,Brest,Hugo Magnetti,FRA,MF,22,1998,6.7,24,12,10,13,1,20,40,50.0,20,6,1,5,14,38,8,0,defense
FRA-Ligue 1,2021,Brest,Ibrahima Diallo,FRA,MF,21,1999,4.9,14,9,2,9,3,4,8,50.0,4,4,0,4,3,17,3,0,defense
FRA-Ligue 1,2021,Brest,Irvin Cardona,FRA,FW,22,1997,22.5,10,5,3,6,1,4,22,18.2,18,17,3,14,9,19,23,2,defense
FRA-Ligue 1,2021,Brest,Jean Lucas,BRA,"MF,FW",22,1998,11.2,19,13,10,9,0,8,29,27.6,21,7,0,7,8,27,10,1,defense
FRA-Ligue 1,2021,Brest,Jean-Kevin Duverne,HAI,DF,23,1997,22.5,38,21,24,14,0,15,32,46.9,17,24,16,8,30,68,70,0,defense
FRA-Ligue 1,2021,Brest,Julien Faussurier,FRA,DF,33,1987,10.6,16,11,6,8,2,11,25,44.0,14,12,4,8,9,25,10,0,defense
FRA-Ligue 1,2021,Brest,Jérémy Le Douaron,FRA,"FW,MF",22,1998,9.1,15,10,9,4,2,7,21,33.3,14,14,1,13,8,23,11,0,defense
FRA-Ligue 1,2021,Brest,Lilian Brassier,FRA,DF,20,1999,10.7,19,10,12,4,3,7,11,63.6,4,13,6,7,23,42,38,1,defense
FRA-Ligue 1,2021,Brest,Ludovic Baal,GUF,"DF,MF",34,1986,3.3,6,5,4,1,1,2,5,40.0,3,4,1,3,5,11,5,0,defense
FRA-Ligue 1,2021,Brest,Paul Lasne,FRA,MF,31,1989,18.7,46,26,25,19,2,17,40,42.5,23,25,5,20,47,93,17,2,defense
FRA-Ligue 1,2021,Brest,Romain Faivre,FRA,"MF,FW",22,1998,32.1,54,27,26,23,5,21,54,38.9,33,30,0,30,30,84,18,0,defense
FRA-Ligue 1,2021,Brest,Romain Perraud,FRA,DF,22,1997,34.9,60,34,42,16,2,24,45,53.3,21,36,3,33,45,105,76,0,defense
FRA-Ligue 1,2021,Brest,Romain Philippoteaux,FRA,"MF,FW",32,1988,6.5,11,6,6,3,2,6,9,66.7,3,4,0,4,10,21,2,0,defense
FRA-Ligue 1,2021,Brest,Ronaël Pierre-Gabriel,FRA,DF,22,1998,25.6,60,40,42,16,2,35,52,67.3,17,17,7,10,30,90,57,0,defense
FRA-Ligue 1,2021,Brest,Steve Mounié,BEN,FW,25,1994,29.8,15,11,3,11,1,3,28,10.7,25,18,3,15,12,27,40,0,defense
FRA-Ligue 1,2021,Brest,Sébastien Cibois,FRA,GK,22,1998,3.0,0,0,0,0,0,0,0,,0,0,0,0,0,0,0,1,defense
FRA-Ligue 1,2021,Dijon,Aboubakar Kamara,MTN,"FW,MF",25,1995,6.2,3,1,0,2,1,1,7,14.3,6,1,0,1,0,3,2,0,defense
FRA-Ligue 1,2021,Dijon,Ahmad Ngouyamsa,CHA,DF,19,2000,1.7,6,4,5,1,0,4,8,50.0,4,2,1,1,2,8,8,0,defense
FRA-Ligue 1,2021,Dijon,Alfred Gomis,SEN,GK,26,1993,5.0,1,0,1,0,0,1,2,50.0,1,0,0,0,1,2,7,0,defense
FRA-Ligue 1,2021,Dijon,Anthony Racioppi,SUI,GK,21,1998,21.0,0,0,0,0,0,0,2,0.0,2,0,0,0,2,2,12,4,defense
FRA-Ligue 1,2021,Dijon,Aníbal Chalá,ECU,DF,24,1996,8.3,10,7,6,3,1,6,12,50.0,6,5,3,2,14,24,15,1,defense
FRA-Ligue 1,2021,Dijon,Arthur Zagre,FRA,"DF,MF",18,2001,1.4,3,1,2,1,0,2,2,100.0,0,1,1,0,3,6,1,0,defense
FRA-Ligue 1,2021,Dijon,Aurélien Scheidler,FRA,FW,22,1998,3.8,2,0,0,2,0,0,2,0.0,2,0,0,0,1,3,5,0,defense
FRA-Ligue 1,2021,Dijon,Bersant Celina,KVX,"MF,FW",23,1996,25.5,20,12,8,8,4,7,38,18.4,31,20,2,18,8,28,10,0,defense
FRA-Ligue 1,2021,Dijon,Bruno Ecuele Manga,GAB,DF,32,1988,38.0,52,38,46,6,0,29,40,72.5,11,50,33,17,57,109,165,3,defense
FRA-Ligue 1,2021,Dijon,Charles Costes,FRA,MF,17,2002,0.0,0,0,0,0,0,0,0,,0,0,0,0,0,0,0,0,defense
FRA-Ligue 1,2021,Dijon,Didier Ibrahim Ndong,GAB,MF,26,1994,29.0,53,32,22,30,1,25,70,35.7,45,35,7,28,37,90,40,0,defense
FRA-Ligue 1,2021,Dijon,Erwan Belhadji,FRA,MF,19,2001,0.3,3,0,3,0,0,3,5,60.0,2,1,0,1,0,3,0,0,defense
FRA-Ligue 1,2021,Dijon,Fouad Chafik,MAR,DF,33,1986,18.0,39,24,29,8,2,16,35,45.7,19,19,10,9,21,60,41,0,defense
FRA-Ligue 1,2021,Dijon,Frédéric Sammaritano,FRA,"FW,MF",34,1986,12.6,15,10,9,5,1,9,26,34.6,17,6,0,6,9,24,3,0,defense
FRA-Ligue 1,2021,Dijon,Jacques Siwe,FRA,FW,19,2001,1.9,4,1,1,1,2,0,1,0.0,1,1,0,1,1,5,1,0,defense
FRA-Ligue 1,2021,Dijon,Jonathan Panzo,ENG,DF,19,2000,20.0,17,12,13,4,0,8,11,72.7,3,27,13,14,59,76,91,2,defense
FRA-Ligue 1,2021,Dijon,Jordan Marié,FRA,MF,28,1991,15.9,34,17,9,23,2,23,56,41.1,33,14,5,9,23,57,12,2,defense
FRA-Ligue 1,2021,Dijon,Junior Dina Ebimbe,FRA,"FW,MF",19,2000,23.8,38,25,14,19,5,15,45,33.3,30,17,1,16,14,52,9,0,defense
FRA-Ligue 1,2021,Dijon,Mama Samba Baldé,GNB,FW,24,1995,24.0,23,9,4,13,6,9,22,40.9,13,16,1,15,4,27,26,0,defense
FRA-Ligue 1,2021,Dijon,Mihai Dobre,ROU,FW,21,1998,5.9,12,5,6,2,4,7,14,50.0,7,5,0,5,10,22,3,0,defense
FRA-Ligue 1,2021,Dijon,Mounir Chouiar,FRA,"FW,MF",21,1999,14.3,22,12,10,9,3,6,18,33.3,12,10,0,10,11,33,8,0,defense
FRA-Ligue 1,2021,Dijon,Moussa Konaté,SEN,FW,27,1993,13.3,5,3,1,2,2,2,11,18.2,9,4,1,3,5,10,8,0,defense
FRA-Ligue 1,2021,Dijon,Muzinga Ngonda,COD,DF,25,1994,25.6,59,40,37,21,1,30,50,60.0,20,28,3,25,72,131,58,0,defense
FRA-Ligue 1,2021,Dijon,Pape Cheikh Diop,SEN,MF,22,1997,12.1,24,14,15,6,3,13,33,39.4,20,14,2,12,6,30,6,0,defense
FRA-Ligue 1,2021,Dijon,Rayan Philippe,FRA,FW,19,2000,1.0,3,1,1,1,1,2,2,100.0,0,0,0,0,0,3,0,0,defense
FRA-Ligue 1,2021,Dijon,Roger Assalé,CIV,"FW,MF",26,1993,9.2,10,8,3,5,2,4,12,33.3,8,7,3,4,2,12,2,0,defense
FRA-Ligue 1,2021,Dijon,Romain Amalfitano,FRA,"FW,DF",30,1989,1.3,4,2,3,1,0,1,3,33.3,2,2,1,1,1,5,1,0,defense
FRA-Ligue 1,2021,Dijon,Sacha Boey,FRA,DF,19,2000,20.7,54,40,30,23,1,27,55,49.1,28,25,5,20,41,95,62,0,defense
FRA-Ligue 1,2021,Dijon,Saturnin Allagbé,BEN,GK,26,1993,12.0,0,0,0,0,0,0,1,0.0,1,0,0,0,0,0,9,3,defense
FRA-Ligue 1,2021,Dijon,Senou Coulibaly,MLI,DF,25,1994,21.5,33,21,23,10,0,12,24,50.0,12,18,12,6,30,63,89,0,defense
FRA-Ligue 1,2021,Dijon,Wesley Lautoa,NCL,"MF,DF",32,1987,17.9,36,20,20,13,3,11,37,29.7,26,17,8,9,29,65,33,1,defense
FRA-Ligue 1,2021,Dijon,Wilitty Younoussa,CMR,MF,18,2001,0.9,6,3,3,3,0,3,7,42.9,4,3,0,3,2,8,0,0,defense
FRA-Ligue 1,2021,Dijon,Yassine Benzia,ALG,"MF,FW",25,1994,4.5,10,5,5,3,2,2,10,20.0,8,3,0,3,6,16,2,0,defense
FRA-Ligue 1,2021,Lens,Adrien Louveau,FRA,MF,20,2000,0.1,0,0,0,0,0,0,0,,0,0,0,0,0,0,1,0,defense
FRA-Ligue 1,2021,Lens,Aleksandar Radovanović,SRB,DF,26,1993,1.0,1,1,0,1,0,0,0,,0,2,1,1,0,1,2,0,defense
FRA-Ligue 1,2021,Lens,Ansou Sow,SEN,MF,20,2000,0.1,0,0,0,0,0,0,0,,0,1,0,1,0,0,0,0,defense
FRA-Ligue 1,2021,Lens,Arnaud Kalimuendo,FRA,"FW,MF",18,2002,13.5,8,2,2,2,4,1,7,14.3,6,11,0,11,2,10,2,0,defense
FRA-Ligue 1,2021,Lens,Cheick Doucouré,MLI,MF,20,2000,29.2,87,47,40,42,5,32,65,49.2,33,20,4,16,52,139,26,1,defense
FRA-Ligue 1,2021,Lens,Cheick Traoré,MLI,DF,25,1995,0.4,2,2,1,1,0,2,4,50.0,2,1,0,1,2,4,1,0,defense
FRA-Ligue 1,2021,Lens,Clément Michelin,FRA,DF,23,1997,12.8,25,19,13,9,3,9,16,56.3,7,13,4,9,25,50,32,0,defense
FRA-Ligue 1,2021,Lens,Corentin Jean,FRA,"FW,MF",25,1995,6.4,4,3,1,1,2,0,5,0.0,5,4,0,4,2,6,2,0,defense
FRA-Ligue 1,2021,Lens,David Costa,POR,"MF,FW",19,2001,1.7,4,4,1,2,1,2,3,66.7,1,2,0,2,0,4,4,0,defense
FRA-Ligue 1,2021,Lens,Facundo Medina,ARG,DF,21,1999,22.3,39,22,22,15,2,24,38,63.2,14,25,9,16,39,78,51,3,defense
FRA-Ligue 1,2021,Lens,Florian Sotoca,FRA,FW,29,1990,26.8,31,20,3,20,8,6,22,27.3,16,27,0,27,9,40,24,0,defense
FRA-Ligue 1,2021,Lens,Gaël Kakuta,COD,"MF,FW",29,1991,26.6,38,23,10,18,10,8,44,18.2,36,24,3,21,17,55,4,0,defense
FRA-Ligue 1,2021,Lens,Ignatius Ganago,CMR,FW,21,1999,14.5,4,3,0,2,2,3,12,25.0,9,7,1,6,6,10,3,0,defense
FRA-Ligue 1,2021,Lens,Ismaël Boura,COM,DF,19,2000,9.2,11,7,8,2,1,3,9,33.3,6,7,2,5,21,32,12,0,defense
FRA-Ligue 1,2021,Lens,Issiaga Sylla,GUI,"DF,MF",26,1994,12.4,28,20,11,17,0,11,21,52.4,10,13,3,10,16,44,21,0,defense
FRA-Ligue 1,2021,Lens,Jean-Louis Leca,FRA,GK,34,1985,36.8,3,2,3,0,0,3,5,60.0,2,0,0,0,1,4,14,4,defense
FRA-Ligue 1,2021,Lens,Jonathan Clauss,FRA,DF,27,1992,28.0,43,20,12,20,11,17,38,44.7,21,24,1,23,45,88,46,0,defense
FRA-Ligue 1,2021,Lens,Jonathan Gradit,FRA,DF,27,1992,31.4,60,39,26,28,6,22,38,57.9,16,37,19,18,56,116,81,1,defense
FRA-Ligue 1,2021,Lens,Loïc Bade,FRA,DF,20,2000,29.0,57,34,47,10,0,30,55,54.5,25,43,17,26,74,131,135,2,defense
FRA-Ligue 1,2021,Lens,Manuel Perez,FRA,"MF,FW",29,1991,1.4,1,0,1,0,0,0,8,0.0,8,2,0,2,2,3,2,0,defense
FRA-Ligue 1,2021,Lens,Massadio Haïdara,MLI,DF,27,1992,23.7,48,32,21,21,6,23,37,62.2,14,29,6,23,35,83,60,0,defense
FRA-Ligue 1,2021,Lens,Seko Fofana,CIV,MF,25,1995,25.7,16,8,3,10,3,4,26,15.4,22,16,5,11,34,50,23,1,defense
FRA-Ligue 1,2021,Lens,Simon Banza,COD,FW,23,1996,15.2,13,6,0,4,9,1,14,7.1,13,16,1,15,7,20,15,0,defense
FRA-Ligue 1,2021,Lens,Steven Fortes,CPV,DF,28,1992,15.9,33,20,20,10,3,16,22,72.7,6,25,10,15,27,60,52,0,defense
FRA-Ligue 1,2021,Lens,Tony Mauricio,FRA,MF,26,1994,5.6,19,12,7,8,4,11,17,64.7,6,8,1,7,3,22,4,0,defense
FRA-Ligue 1,2021,Lens,Wuilker Faríñez,VEN,GK,22,1998,1.2,0,0,0,0,0,0,0,,0,0,0,0,0,0,1,0,defense
FRA-Ligue 1,2021,Lens,Yannick Cahuzac,FRA,MF,35,1985,25.0,26,12,12,10,4,9,27,33.3,18,18,5,13,33,59,72,0,defense
FRA-Ligue 1,2021,Lille,Adama Soumaoro,FRA,DF,28,1992,1.6,1,0,0,0,1,0,0,,0,1,1,0,2,3,2,0,defense
FRA-Ligue 1,2021,Lille,Benjamin André,FRA,MF,29,1990,32.1,114,68,47,61,6,53,122,43.4,69,39,10,29,76,190,49,0,defense
FRA-Ligue 1,2021,Lille,Boubakary Soumaré,FRA,MF,21,1999,21.3,44,29,16,25,3,14,29,48.3,15,14,6,8,39,83,21,0,defense
FRA-Ligue 1,2021,Lille,Burak Yılmaz,TUR,FW,35,1985,22.8,13,6,3,7,3,4,30,13.3,26,7,0,7,5,18,22,0,defense
FRA-Ligue 1,2021,Lille,Domagoj Bradarić,CRO,DF,20,1999,14.0,28,18,11,13,4,12,27,44.4,15,14,4,10,26,54,21,0,defense
FRA-Ligue 1,2021,Lille,Isaac Lihadji,FRA,"MF,FW",18,2002,2.2,11,4,2,6,3,4,5,80.0,1,5,1,4,1,12,0,1,defense
FRA-Ligue 1,2021,Lille,Jonathan Bamba,CIV,MF,24,1996,33.2,45,23,15,19,11,24,84,28.6,60,24,2,22,24,69,15,0,defense
FRA-Ligue 1,2021,Lille,Jonathan David,CAN,FW,20,2000,26.2,17,10,5,5,7,9,24,37.5,15,19,1,18,3,20,9,0,defense
FRA-Ligue 1,2021,Lille,Jonathan Ikone,FRA,"MF,FW",22,1998,24.2,18,12,3,8,7,9,22,40.9,13,16,1,15,7,25,9,0,defense
FRA-Ligue 1,2021,Lille,José Fonte,POR,DF,36,1983,35.4,40,29,28,10,2,27,33,81.8,6,36,23,13,36,76,137,1,defense
FRA-Ligue 1,2021,Lille,Jérémy Pied,FRA,DF,31,1989,3.5,7,0,3,3,1,4,9,44.4,5,3,1,2,6,13,8,0,defense
FRA-Ligue 1,2021,Lille,Luiz Araújo,BRA,MF,24,1996,16.6,38,25,12,18,8,8,28,28.6,20,23,1,22,11,49,3,0,defense
FRA-Ligue 1,2021,Lille,Mike Maignan,FRA,GK,25,1995,38.0,0,0,0,0,0,0,0,,0,0,0,0,0,0,7,2,defense
FRA-Ligue 1,2021,Lille,Reinildo Mandava,MOZ,DF,26,1994,24.2,79,43,39,32,8,35,58,60.3,23,26,3,23,45,124,53,0,defense
FRA-Ligue 1,2021,Lille,Renato Sanches,POR,MF,22,1997,14.1,13,7,4,8,1,5,25,20.0,20,13,2,11,13,26,8,0,defense
FRA-Ligue 1,2021,Lille,Sven Botman,NED,DF,20,2000,36.8,31,21,18,12,1,14,26,53.8,12,31,21,10,57,88,126,2,defense
FRA-Ligue 1,2021,Lille,Tiago Djaló,POR,DF,20,2000,9.7,22,13,14,5,3,15,23,65.2,8,10,4,6,9,31,23,0,defense
FRA-Ligue 1,2021,Lille,Timothy Weah,USA,"FW,MF",20,2000,9.8,15,7,3,9,3,7,14,50.0,7,7,0,7,4,19,5,0,defense
FRA-Ligue 1,2021,Lille,Xeka,POR,MF,25,1994,13.3,33,17,14,15,4,16,43,37.2,27,14,2,12,20,53,18,0,defense
FRA-Ligue 1,2021,Lille,Yusuf Yazıcı,TUR,"FW,MF",23,1997,12.1,12,5,6,2,4,1,24,4.2,23,5,1,4,2,14,2,0,defense
FRA-Ligue 1,2021,Lille,Zeki Çelik,TUR,DF,23,1997,26.5,72,33,30,30,12,44,81,54.3,37,32,6,26,38,110,52,0,defense
FRA-Ligue 1,2021,Lorient,Adrian Grbić,AUT,FW,23,1996,10.7,6,4,2,2,2,1,7,14.3,6,6,0,6,5,11,7,0,defense
FRA-Ligue 1,2021,Lorient,Andrew Gravillon,GLP,DF,22,1998,25.2,26,17,17,9,0,13,28,46.4,15,44,31,13,59,85,118,4,defense
FRA-Ligue 1,2021,Lorient,Armand Lauriente,FRA,"MF,FW",21,1998,18.0,30,10,10,19,1,7,26,26.9,19,21,0,21,15,45,4,0,defense
FRA-Ligue 1,2021,Lorient,Enzo Le Fée,FRA,MF,20,2000,20.2,51,28,23,23,5,27,73,37.0,46,30,6,24,25,76,10,0,defense
FRA-Ligue 1,2021,Lorient,Fabien Lemoine,FRA,MF,33,1987,21.5,74,45,39,33,2,36,89,40.4,53,25,1,24,27,101,35,0,defense
FRA-Ligue 1,2021,Lorient,Franklin Wadja,CMR,"MF,FW",25,1995,0.4,4,2,0,2,2,2,2,100.0,0,0,0,0,2,6,1,0,defense
FRA-Ligue 1,2021,Lorient,Houboulang Mendes,GNB,DF,22,1998,14.4,28,19,19,5,4,16,28,57.1,12,14,2,12,14,42,35,0,defense
FRA-Ligue 1,2021,Lorient,Jonathan Delaplace,FRA,DF,34,1986,10.1,8,5,5,1,2,7,13,53.8,6,12,5,7,17,25,19,1,defense
FRA-Ligue 1,2021,Lorient,Julien Laporte,FRA,DF,26,1993,29.5,65,39,48,16,1,42,74,56.8,32,34,23,11,65,130,125,0,defense
FRA-Ligue 1,2021,Lorient,Jérémy Morel,MAD,DF,36,1984,27.7,31,19,21,10,0,20,39,51.3,19,26,11,15,44,75,81,1,defense
FRA-Ligue 1,2021,Lorient,Jérôme Hergault,FRA,"DF,MF",34,1986,18.1,38,23,22,10,6,17,31,54.8,14,16,2,14,22,60,34,0,defense
FRA-Ligue 1,2021,Lorient,Laurent Abergel,FRA,MF,27,1993,32.9,145,84,64,69,12,54,162,33.3,108,64,6,58,46,191,12,0,defense
FRA-Ligue 1,2021,Lorient,Loris Mouyokolo,FRA,DF,19,2001,0.2,1,1,1,0,0,1,1,100.0,0,1,1,0,0,1,1,0,defense
FRA-Ligue 1,2021,Lorient,Matthieu Dreyer,FRA,GK,31,1989,15.0,0,0,0,0,0,0,0,,0,0,0,0,0,0,4,2,defense
FRA-Ligue 1,2021,Lorient,Paul Nardi,FRA,GK,26,1994,23.0,0,0,0,0,0,0,1,0.0,1,1,0,1,0,0,15,2,defense
FRA-Ligue 1,2021,Lorient,Pierre-Yves Hamel,FRA,FW,26,1994,9.4,15,8,3,9,3,1,6,16.7,5,12,1,11,10,25,6,0,defense
FRA-Ligue 1,2021,Lorient,Quentin Boisgard,FRA,"MF,FW",23,1997,14.6,24,17,3,15,6,11,24,45.8,13,17,2,15,15,39,1,0,defense
FRA-Ligue 1,2021,Lorient,Stéphane Diarra,FRA,"MF,FW",21,1998,2.2,0,0,0,0,0,0,7,0.0,7,6,1,5,4,4,1,0,defense
FRA-Ligue 1,2021,Lorient,Sylvain Marveaux,FRA,"MF,FW",34,1986,2.2,6,3,1,4,1,3,3,100.0,0,2,0,2,1,7,2,0,defense
FRA-Ligue 1,2021,Lorient,Terem Moffi,NGA,FW,21,1999,23.0,13,8,0,8,5,4,19,21.1,15,5,2,3,4,17,8,0,defense
FRA-Ligue 1,2021,Lorient,Thomas Fontaine,MAD,DF,29,1991,3.6,5,2,5,0,0,2,2,100.0,0,3,2,1,5,10,14,0,defense
FRA-Ligue 1,2021,Lorient,Thomas Monconduit,FRA,MF,29,1991,12.8,28,15,9,16,3,15,41,36.6,26,10,3,7,13,41,21,1,defense
FRA-Ligue 1,2021,Lorient,Trevoh Chalobah,ENG,"DF,MF",21,1999,24.9,45,26,32,13,0,24,50,48.0,26,20,7,13,69,114,56,0,defense
FRA-Ligue 1,2021,Lorient,Umut Bozok,TUR,"MF,FW",23,1996,0.7,0,0,0,0,0,0,2,0.0,2,0,0,0,0,0,0,0,defense
FRA-Ligue 1,2021,Lorient,Vincent Le Goff,FRA,DF,30,1989,25.6,42,29,16,24,2,18,49,36.7,31,27,5,22,44,86,44,0,defense
FRA-Ligue 1,2021,Lorient,Yoane Wissa,COD,"MF,FW",23,1996,29.7,35,20,12,14,9,11,34,32.4,23,25,3,22,20,55,14,0,defense
FRA-Ligue 1,2021,Lorient,Yoann Etienne,FRA,DF,23,1997,1.0,2,0,1,1,0,1,1,100.0,0,1,0,1,1,3,2,0,defense
FRA-Ligue 1,2021,Lyon,Anthony Lopes,POR,GK,29,1990,38.0,1,1,1,0,0,1,2,50.0,1,1,0,1,1,2,20,1,defense
FRA-Ligue 1,2021,Lyon,Bruno Guimarães,BRA,MF,22,1997,19.5,76,34,26,41,9,30,64,46.9,34,24,4,20,14,90,13,0,defense
FRA-Ligue 1,2021,Lyon,Djamel Benlamri,ALG,DF,30,1989,1.7,5,3,5,0,0,3,6,50.0,3,3,2,1,6,11,11,0,defense
FRA-Ligue 1,2021,Lyon,Fernando Marçal,BRA,DF,31,1989,0.9,1,0,0,1,0,0,0,,0,0,0,0,2,3,0,0,defense
FRA-Ligue 1,2021,Lyon,Florent da Silva,FRA,FW,17,2003,0.0,0,0,0,0,0,0,0,,0,0,0,0,0,0,0,0,defense
FRA-Ligue 1,2021,Lyon,Habib Keita,MLI,MF,18,2002,0.1,0,0,0,0,0,0,0,,0,0,0,0,0,0,0,0,defense
FRA-Ligue 1,2021,Lyon,Houssem Aouar,ALG,"MF,FW",22,1998,19.8,17,12,0,13,4,8,25,32.0,17,17,1,16,17,34,4,0,defense
FRA-Ligue 1,2021,Lyon,Islam Slimani,ALG,FW,32,1988,6.4,7,5,3,1,3,3,12,25.0,9,4,1,3,1,8,6,0,defense
FRA-Ligue 1,2021,Lyon,Jason Denayer,BEL,DF,25,1995,29.0,25,16,16,9,0,6,13,46.2,7,36,25,11,27,52,91,1,defense
FRA-Ligue 1,2021,Lyon,Jean Lucas,BRA,MF,22,1998,1.9,3,2,2,1,0,1,4,25.0,3,3,1,2,2,5,1,0,defense
FRA-Ligue 1,2021,Lyon,Jeff Reine-Adélaïde,FRA,FW,22,1998,0.3,0,0,0,0,0,0,0,,0,0,0,0,0,0,0,0,defense
FRA-Ligue 1,2021,Lyon,Joachim Andersen,DEN,DF,24,1996,2.1,2,1,1,1,0,2,2,100.0,0,1,1,0,2,4,6,0,defense
FRA-Ligue 1,2021,Lyon,Karl Toko Ekambi,CMR,FW,27,1992,31.2,16,10,5,3,8,8,32,25.0,24,20,1,19,26,42,8,0,defense
FRA-Ligue 1,2021,Lyon,Kenny Tete,NED,DF,24,1995,0.2,2,0,1,1,0,0,0,,0,0,0,0,2,4,0,0,defense
FRA-Ligue 1,2021,Lyon,Leo Dubois,FRA,DF,25,1994,32.3,38,26,19,16,3,18,36,50.0,18,27,9,18,31,69,69,2,defense
FRA-Ligue 1,2021,Lyon,Lucas Paquetá,BRA,MF,22,1997,25.3,70,36,30,28,12,23,66,34.8,43,28,3,25,20,90,16,1,defense
FRA-Ligue 1,2021,Lyon,Malo Gusto,FRA,"DF,MF",17,2003,0.0,0,0,0,0,0,0,0,,0,0,0,0,0,0,0,0,defense
FRA-Ligue 1,2021,Lyon,Marcelo,BRA,DF,33,1987,32.3,44,29,30,12,2,26,37,70.3,11,35,25,10,49,93,122,2,defense
FRA-Ligue 1,2021,Lyon,Mattia De Sciglio,ITA,DF,27,1992,16.3,29,17,15,11,3,18,27,66.7,9,13,4,9,27,56,44,0,defense
FRA-Ligue 1,2021,Lyon,Maxence Caqueret,FRA,MF,20,2000,19.6,72,45,17,39,16,35,106,33.0,71,35,3,32,23,95,5,2,defense
FRA-Ligue 1,2021,Lyon,Maxwel Cornet,CIV,"DF,FW",23,1996,27.2,70,41,39,24,7,33,58,56.9,25,23,5,18,43,113,47,2,defense
FRA-Ligue 1,2021,Lyon,Melvin Bard,FRA,DF,19,2000,4.8,12,8,7,4,1,6,11,54.5,5,10,2,8,6,18,14,0,defense
FRA-Ligue 1,2021,Lyon,Memphis,NED,FW,26,1994,32.5,4,3,0,3,1,1,20,5.0,19,11,1,10,5,9,3,0,defense
FRA-Ligue 1,2021,Lyon,Moussa Dembélé,FRA,FW,24,1996,7.5,2,2,0,1,1,0,4,0.0,4,4,2,2,5,7,9,0,defense
FRA-Ligue 1,2021,Lyon,Rayan Cherki,FRA,"FW,MF",16,2003,7.8,5,3,0,3,2,1,11,9.1,10,3,0,3,4,9,0,0,defense
FRA-Ligue 1,2021,Lyon,Sinaly Diomande,CIV,DF,19,2001,12.6,10,7,8,1,1,5,14,35.7,9,19,15,4,33,43,53,1,defense
FRA-Ligue 1,2021,Lyon,Thiago Mendes,BRA,MF,28,1992,24.9,37,22,13,20,4,18,38,47.4,20,33,7,26,39,76,21,2,defense
FRA-Ligue 1,2021,Lyon,Tino Kadewere,ZIM,FW,24,1996,22.3,35,22,12,16,7,17,49,34.7,32,16,3,13,21,56,31,0,defense
FRA-Ligue 1,2021,Lyon,Yaya Soumaré,FRA,FW,20,2000,0.0,1,1,1,0,0,1,2,50.0,1,0,0,0,2,3,0,0,defense
FRA-Ligue 1,2021,Marseille,Arkadiusz Milik,POL,FW,26,1994,13.6,14,9,0,7,7,2,12,16.7,10,5,1,4,2,16,9,0,defense
FRA-Ligue 1,2021,Marseille,Bamba Dieng,SEN,"FW,DF",20,2000,1.4,5,3,3,2,0,2,4,50.0,2,2,0,2,0,5,0,0,defense
FRA-Ligue 1,2021,Marseille,Boubacar Kamara,FRA,MF,20,1999,32.2,88,51,31,49,8,40,74,54.1,34,36,13,23,34,122,51,0,defense
FRA-Ligue 1,2021,Marseille,Bouna Sarr,SEN,DF,28,1992,0.8,1,1,0,0,1,1,1,100.0,0,1,1,0,1,2,1,0,defense
FRA-Ligue 1,2021,Marseille,Cheick Souaré,FRA,MF,17,2002,0.1,0,0,0,0,0,0,0,,0,1,1,0,1,1,0,0,defense
FRA-Ligue 1,2021,Marseille,Christopher Rocchia,FRA,"DF,FW",22,1998,0.2,1,0,1,0,0,0,2,0.0,2,0,0,0,0,1,1,0,defense
FRA-Ligue 1,2021,Marseille,Darío Benedetto,ARG,FW,30,1990,17.5,6,4,1,4,1,5,13,38.5,8,9,2,7,3,9,17,0,defense
FRA-Ligue 1,2021,Marseille,Dimitri Payet,FRA,"FW,MF",33,1987,26.9,27,17,4,16,7,17,40,42.5,23,19,2,17,8,35,10,0,defense
FRA-Ligue 1,2021,Marseille,Duje Ćaleta-Car,CRO,DF,23,1996,31.3,29,17,19,9,1,17,30,56.7,13,29,22,7,44,73,130,0,defense
FRA-Ligue 1,2021,Marseille,Florian Thauvin,FRA,"FW,MF",27,1993,30.4,40,22,14,21,5,20,54,37.0,34,26,2,24,14,54,11,0,defense
FRA-Ligue 1,2021,Marseille,Hiroki Sakai,JPN,DF,30,1990,26.5,81,48,34,35,12,39,51,76.5,12,21,5,16,54,135,65,0,defense
FRA-Ligue 1,2021,Marseille,Jordan Amavi,FRA,DF,26,1994,9.0,11,9,9,1,1,9,12,75.0,3,12,2,10,27,38,33,1,defense
FRA-Ligue 1,2021,Marseille,Kevin Strootman,NED,"MF,FW",30,1990,2.6,9,6,5,4,0,4,8,50.0,4,5,2,3,5,14,7,0,defense
FRA-Ligue 1,2021,Marseille,Leonardo Balerdi,ARG,DF,21,1999,18.2,29,18,19,7,3,14,31,45.2,17,17,9,8,28,57,65,3,defense
FRA-Ligue 1,2021,Marseille,Lucas Perrin,FRA,DF,21,1998,3.4,7,4,4,3,0,5,12,41.7,7,5,4,1,8,15,16,0,defense
FRA-Ligue 1,2021,Marseille,Luis Henrique,BRA,"FW,DF",18,2001,7.5,5,4,3,1,1,4,9,44.4,5,5,1,4,7,12,4,0,defense
FRA-Ligue 1,2021,Marseille,Marley Aké,FRA,FW,19,2001,1.6,3,3,1,0,2,0,1,0.0,1,2,0,2,0,3,1,0,defense
FRA-Ligue 1,2021,Marseille,Maxime Lopez,FRA,"FW,MF",22,1997,1.5,1,1,1,0,0,0,2,0.0,2,0,0,0,2,3,2,0,defense
FRA-Ligue 1,2021,Marseille,Mickaël Cuisance,FRA,MF,20,1999,11.4,24,11,2,15,7,10,33,30.3,23,13,1,12,3,27,4,0,defense
FRA-Ligue 1,2021,Marseille,Morgan Sanson,FRA,MF,25,1994,9.2,21,12,6,12,3,9,28,32.1,19,12,0,12,9,30,5,0,defense
FRA-Ligue 1,2021,Marseille,Nemanja Radonjić,SRB,FW,24,1996,4.4,6,5,1,2,3,2,12,16.7,10,8,0,8,3,9,1,0,defense
FRA-Ligue 1,2021,Marseille,Olivier Ntcham,CMR,MF,24,1996,1.3,1,0,0,1,0,1,3,33.3,2,3,1,2,2,3,3,0,defense
FRA-Ligue 1,2021,Marseille,Pape Gueye,SEN,MF,21,1999,22.9,49,21,25,19,5,15,45,33.3,30,25,6,19,47,96,34,0,defense
FRA-Ligue 1,2021,Marseille,Pol Lirola,ESP,"DF,FW",22,1997,17.3,28,16,11,15,2,16,28,57.1,12,18,5,13,25,53,26,0,defense
FRA-Ligue 1,2021,Marseille,Saîf-Eddine Khaoui,TUN,"FW,DF",25,1995,6.7,19,11,7,6,6,7,16,43.8,9,8,0,8,12,31,1,0,defense
FRA-Ligue 1,2021,Marseille,Steve Mandanda,FRA,GK,35,1985,37.0,0,0,0,0,0,0,1,0.0,1,0,0,0,2,2,8,6,defense
FRA-Ligue 1,2021,Marseille,Valentin Rongier,FRA,MF,25,1994,21.0,93,59,31,55,7,43,85,50.6,42,32,2,30,28,121,21,1,defense
FRA-Ligue 1,2021,Marseille,Valère Germain,FRA,"FW,MF",30,1990,9.5,8,6,2,4,2,3,11,27.3,8,7,2,5,11,19,22,0,defense
FRA-Ligue 1,2021,Marseille,Yohann Pelé,FRA,GK,37,1982,1.0,0,0,0,0,0,0,0,,0,0,0,0,0,0,0,0,defense
FRA-Ligue 1,2021,Marseille,Yuto Nagatomo,JPN,DF,33,1986,17.7,23,16,12,8,3,9,18,50.0,9,14,3,11,29,52,43,0,defense
FRA-Ligue 1,2021,Marseille,Álvaro González,ESP,DF,30,1990,31.5,26,17,20,6,0,19,31,61.3,12,30,18,12,33,59,119,1,defense
FRA-Ligue 1,2021,Metz,Aaron Leya Iseka,BEL,FW,22,1997,11.2,6,4,2,3,1,0,4,0.0,4,4,2,2,0,6,6,0,defense
FRA-Ligue 1,2021,Metz,Alexandre Oukidja,ALG,GK,32,1988,34.0,0,0,0,0,0,0,1,0.0,1,1,0,1,0,0,17,3,defense
FRA-Ligue 1,2021,Metz,Boubacar Traoré,MLI,MF,18,2001,0.6,3,2,1,2,0,1,1,100.0,0,1,0,1,0,3,0,0,defense
FRA-Ligue 1,2021,Metz,Boubakar Kouyaté,MLI,DF,23,1997,21.8,60,35,45,15,0,32,58,55.2,26,44,27,17,60,120,132,1,defense
FRA-Ligue 1,2021,Metz,Cheikh Tidiane Sabaly,SEN,FW,21,1999,0.1,0,0,0,0,0,0,0,,0,0,0,0,0,0,0,0,defense
FRA-Ligue 1,2021,Metz,Dylan Bronn,TUN,DF,25,1995,37.9,57,37,38,19,0,24,44,54.5,20,31,14,17,44,101,112,0,defense
FRA-Ligue 1,2021,Metz,Fabien Centonze,FRA,DF,24,1996,35.8,104,68,64,30,10,43,73,58.9,30,62,17,45,112,216,119,1,defense
FRA-Ligue 1,2021,Metz,Farid Boulaya,ALG,"MF,FW",27,1993,31.3,24,16,4,17,3,13,51,25.5,38,19,3,16,12,36,7,0,defense
FRA-Ligue 1,2021,Metz,Habib Diallo,SEN,"FW,MF",25,1995,1.6,1,1,0,1,0,1,1,100.0,0,0,0,0,0,1,5,0,defense
FRA-Ligue 1,2021,Metz,Habib Maïga,CIV,MF,24,1996,29.9,81,52,36,40,5,42,85,49.4,43,37,6,31,49,130,36,0,defense
FRA-Ligue 1,2021,Metz,Ibrahima Niane,SEN,FW,21,1999,7.4,1,1,0,0,1,1,2,50.0,1,3,0,3,0,1,8,0,defense
FRA-Ligue 1,2021,Metz,John Boye,GHA,DF,33,1987,33.8,58,34,43,13,2,31,54,57.4,23,36,20,16,80,138,146,1,defense
FRA-Ligue 1,2021,Metz,Kévin N'Doram,FRA,MF,24,1996,3.4,3,2,0,3,0,1,3,33.3,2,0,0,0,6,9,2,0,defense
FRA-Ligue 1,2021,Metz,Lamine Gueye,SEN,"FW,MF",22,1998,16.2,18,9,4,11,3,7,24,29.2,17,7,2,5,21,39,5,0,defense
FRA-Ligue 1,2021,Metz,Mamadou Fofana,MLI,"MF,DF",22,1998,11.9,25,11,17,8,0,7,31,22.6,24,14,2,12,18,43,36,0,defense
FRA-Ligue 1,2021,Metz,Marc-Aurèle Caillard,FRA,GK,26,1994,4.0,0,0,0,0,0,0,0,,0,0,0,0,0,0,2,0,defense
FRA-Ligue 1,2021,Metz,Matthieu Udol,FRA,DF,24,1996,19.2,34,21,18,12,4,17,39,43.6,22,25,5,20,39,73,30,0,defense
FRA-Ligue 1,2021,Metz,Opa Nguette,SEN,"FW,MF",26,1994,12.6,15,8,2,8,5,3,10,30.0,7,14,2,12,1,16,1,0,defense
FRA-Ligue 1,2021,Metz,Papa Ndiaga Yade,MTN,"FW,MF",20,2000,11.1,15,8,9,2,4,7,20,35.0,13,9,0,9,4,19,6,0,defense
FRA-Ligue 1,2021,Metz,Pape Matar Sarr,SEN,MF,17,2002,17.7,45,29,19,21,5,20,38,52.6,18,24,4,20,27,72,16,0,defense
FRA-Ligue 1,2021,Metz,Thierry Ambrose,GLP,FW,23,1997,8.4,7,4,1,1,5,2,12,16.7,10,2,0,2,2,9,4,0,defense
FRA-Ligue 1,2021,Metz,Thomas Delaine,FRA,"DF,FW",28,1992,19.8,32,18,19,11,2,20,35,57.1,15,22,5,17,24,56,30,1,defense
FRA-Ligue 1,2021,Metz,Vagner Gonçalves,CPV,"FW,MF",24,1996,10.7,16,9,5,5,6,2,15,13.3,13,6,0,6,4,20,1,1,defense
FRA-Ligue 1,2021,Metz,Victorien Angban,CIV,MF,23,1996,18.6,36,24,17,15,4,17,42,40.5,25,17,4,13,19,55,9,1,defense
FRA-Ligue 1,2021,Metz,Vincent Pajot,FRA,MF,29,1990,10.2,35,20,19,11,5,10,18,55.6,8,9,2,7,42,77,11,0,defense
FRA-Ligue 1,2021,Metz,Warren Tchimbembé,CGO,"MF,FW",22,1998,5.5,7,4,4,3,0,3,9,33.3,6,6,1,5,2,9,3,0,defense
FRA-Ligue 1,2021,Metz,Youssef Maziz,FRA,"MF,FW",22,1998,2.9,2,0,1,1,0,1,5,20.0,4,1,0,1,6,8,1,0,defense
FRA-Ligue 1,2021,Monaco,Aleksandr Golovin,RUS,"MF,FW",24,1996,11.9,28,16,6,18,4,8,39,20.5,31,21,0,21,11,39,3,0,defense
FRA-Ligue 1,2021,Monaco,Aurélien Tchouaméni,FRA,MF,20,2000,34.0,127,68,47,62,18,48,92,52.2,44,39,11,28,60,187,47,0,defense
FRA-Ligue 1,2021,Monaco,Axel Disasi,FRA,DF,22,1998,22.3,29,20,17,12,0,20,35,57.1,15,18,11,7,26,55,66,1,defense
FRA-Ligue 1,2021,Monaco,Benjamin Lecomte,FRA,GK,29,1991,28.0,0,0,0,0,0,0,2,0.0,2,1,0,1,2,2,20,1,defense
FRA-Ligue 1,2021,Monaco,Benoît Badiashile,FRA,DF,19,2001,31.9,24,17,15,9,0,13,28,46.4,15,21,12,9,58,82,102,4,defense
FRA-Ligue 1,2021,Monaco,Caio Henrique Oliveira Silva,BRA,DF,23,1997,26.3,50,34,25,20,5,31,51,60.8,20,20,3,17,16,66,37,0,defense
FRA-Ligue 1,2021,Monaco,Cesc Fàbregas,ESP,"MF,FW",33,1987,9.7,20,12,6,9,5,9,22,40.9,13,11,1,10,13,33,3,0,defense
FRA-Ligue 1,2021,Monaco,Chrislain Matsima,FRA,"DF,FW",18,2002,3.9,5,4,3,2,0,4,7,57.1,3,3,0,3,4,9,12,0,defense
FRA-Ligue 1,2021,Monaco,Djibril Sidibé,FRA,DF,28,1992,22.0,58,34,26,29,3,37,52,71.2,15,20,5,15,50,108,37,2,defense
FRA-Ligue 1,2021,Monaco,Eliot Matazo,BEL,MF,18,2002,3.5,11,5,6,5,0,3,7,42.9,4,1,0,1,1,12,2,0,defense
FRA-Ligue 1,2021,Monaco,Enzo Millot,FRA,MF,18,2002,0.5,2,0,0,1,1,1,1,100.0,0,0,0,0,2,4,0,0,defense
FRA-Ligue 1,2021,Monaco,Florentino Luís,POR,MF,20,1999,2.7,7,2,4,2,1,6,10,60.0,4,1,0,1,6,13,2,1,defense
FRA-Ligue 1,2021,Monaco,Fodé Ballo-Touré,SEN,DF,23,1997,7.4,21,17,9,11,1,6,13,46.2,7,7,0,7,6,27,11,1,defense
FRA-Ligue 1,2021,Monaco,Gelson Martins,POR,"MF,FW",25,1995,17.2,41,26,12,16,13,15,37,40.5,22,20,0,20,13,54,8,0,defense
FRA-Ligue 1,2021,Monaco,Giulian Biancone,FRA,"DF,MF",20,2000,1.0,3,3,1,1,1,2,3,66.7,1,1,0,1,1,4,4,0,defense
FRA-Ligue 1,2021,Monaco,Guillermo Maripán,CHI,DF,26,1994,23.2,26,11,17,9,0,15,27,55.6,12,18,11,7,27,53,66,1,defense
FRA-Ligue 1,2021,Monaco,Henry Onyekuru,NGA,FW,23,1997,1.6,1,0,1,0,0,1,4,25.0,3,1,0,1,0,1,0,0,defense
FRA-Ligue 1,2021,Monaco,Jean-Eudes Aholou,CIV,MF,26,1994,0.4,1,0,0,1,0,1,3,33.3,2,0,0,0,1,2,1,0,defense
FRA-Ligue 1,2021,Monaco,Kevin Volland,GER,"FW,MF",28,1992,30.8,33,16,11,19,3,8,34,23.5,26,23,0,23,4,37,4,0,defense
FRA-Ligue 1,2021,Monaco,Krépin Diatta,SEN,"MF,DF",21,1999,4.3,4,3,1,1,2,1,3,33.3,2,5,1,4,4,8,1,0,defense
FRA-Ligue 1,2021,Monaco,Pietro Pellegri,ITA,"FW,MF",19,2001,2.6,2,1,0,2,0,0,0,,0,1,0,1,0,2,0,0,defense
FRA-Ligue 1,2021,Monaco,Radosław Majecki,POL,GK,20,1999,1.0,0,0,0,0,0,0,0,,0,0,0,0,0,0,1,0,defense
FRA-Ligue 1,2021,Monaco,Ruben Aguilar,FRA,"DF,MF",27,1993,24.7,63,37,32,21,10,32,52,61.5,20,30,3,27,47,110,43,1,defense
FRA-Ligue 1,2021,Monaco,Sofiane Diop,FRA,"MF,FW",20,2000,22.5,49,34,17,25,7,18,53,34.0,35,25,1,24,31,80,15,0,defense
FRA-Ligue 1,2021,Monaco,Stevan Jovetić,MNE,"FW,MF",30,1989,8.9,8,4,2,3,3,3,13,23.1,10,1,0,1,3,11,3,0,defense
FRA-Ligue 1,2021,Monaco,Strahinja Pavlović,SRB,DF,19,2001,0.0,0,0,0,0,0,0,0,,0,0,0,0,0,0,0,0,defense
FRA-Ligue 1,2021,Monaco,Vito Mannone,ITA,GK,32,1988,9.0,0,0,0,0,0,0,0,,0,0,0,0,0,0,3,1,defense
FRA-Ligue 1,2021,Monaco,Willem Geubbels,FRA,"MF,FW",18,2001,3.3,12,8,5,7,0,5,13,38.5,8,9,0,9,3,15,5,0,defense
FRA-Ligue 1,2021,Monaco,Wissam Ben Yedder,FRA,FW,29,1990,29.0,18,9,2,10,6,3,13,23.1,10,16,0,16,13,31,3,0,defense
FRA-Ligue 1,2021,Monaco,Youssouf Fofana,FRA,MF,21,1999,31.9,90,51,31,51,8,42,82,51.2,40,43,7,36,34,124,14,2,defense
FRA-Ligue 1,2021,Montpellier,Ambroise Oyongo,CMR,DF,29,1991,6.2,13,6,10,3,0,9,15,60.0,6,3,2,1,8,21,26,1,defense
FRA-Ligue 1,2021,Montpellier,Andy Delort,ALG,FW,28,1991,27.6,12,7,1,9,2,8,18,44.4,10,11,1,10,4,16,34,0,defense
FRA-Ligue 1,2021,Montpellier,Arnaud Souquet,FRA,DF,28,1992,13.6,50,33,35,13,2,27,48,56.3,21,15,6,9,17,67,34,0,defense
FRA-Ligue 1,2021,Montpellier,Clément Vidal,FRA,DF,20,2000,1.0,2,1,1,1,0,2,4,50.0,2,4,4,0,1,3,6,1,defense
FRA-Ligue 1,2021,Montpellier,Damien Le Tallec,FRA,"MF,DF",30,1990,13.6,16,10,10,4,2,10,30,33.3,20,15,8,7,25,41,21,2,defense
FRA-Ligue 1,2021,Montpellier,Daniel Congré,FRA,DF,35,1985,36.6,59,35,45,12,2,36,70,51.4,34,50,33,17,69,128,144,3,defense
FRA-Ligue 1,2021,Montpellier,Dimitry Bertaud,COD,GK,22,1998,8.3,0,0,0,0,0,0,0,,0,0,0,0,1,1,2,0,defense
FRA-Ligue 1,2021,Montpellier,Elye Wahi,FRA,FW,17,2003,6.2,4,3,2,1,1,1,6,16.7,5,4,0,4,2,6,5,0,defense
FRA-Ligue 1,2021,Montpellier,Florent Mollet,FRA,MF,28,1991,26.2,20,15,7,11,2,12,47,25.5,35,18,4,14,32,52,9,1,defense
FRA-Ligue 1,2021,Montpellier,Gaëtan Laborde,FRA,"FW,MF",26,1994,36.2,43,22,21,17,5,16,60,26.7,44,29,3,26,16,59,25,1,defense
FRA-Ligue 1,2021,Montpellier,Jonas Omlin,SUI,GK,26,1994,29.7,1,1,1,0,0,1,4,25.0,3,0,0,0,0,1,9,1,defense
FRA-Ligue 1,2021,Montpellier,Jordan Ferri,FRA,MF,28,1992,28.6,58,40,34,22,2,31,103,30.1,72,30,5,25,8,66,18,1,defense
FRA-Ligue 1,2021,Montpellier,Joris Chotard,FRA,MF,18,2001,12.9,12,8,5,6,1,6,31,19.4,25,12,3,9,11,23,15,0,defense
FRA-Ligue 1,2021,Montpellier,Junior Sambia,FRA,"DF,MF",23,1996,27.2,41,29,20,14,7,26,38,68.4,12,27,14,13,39,80,46,0,defense
FRA-Ligue 1,2021,Montpellier,Keagan Dolly,RSA,MF,27,1993,5.0,7,2,6,0,1,4,8,50.0,4,3,0,3,5,12,2,0,defense
FRA-Ligue 1,2021,Montpellier,Mihailo Ristić,SRB,DF,24,1995,24.8,45,22,25,13,7,28,44,63.6,16,30,9,21,26,71,57,0,defense
FRA-Ligue 1,2021,Montpellier,Nicolas Cozza,FRA,DF,21,1999,15.2,39,30,27,11,1,20,40,50.0,20,20,11,9,26,65,62,0,defense
FRA-Ligue 1,2021,Montpellier,Pedro Mendes,POR,DF,29,1990,18.1,21,19,16,5,0,14,21,66.7,7,23,13,10,34,55,58,0,defense
FRA-Ligue 1,2021,Montpellier,Petar Škuletić,SRB,"FW,MF",30,1990,2.6,3,2,1,2,0,0,5,0.0,5,4,2,2,0,3,4,0,defense
FRA-Ligue 1,2021,Montpellier,Sacha Delaye,FRA,MF,18,2002,0.1,0,0,0,0,0,0,1,0.0,1,0,0,0,1,1,1,0,defense
FRA-Ligue 1,2021,Montpellier,Samy Benchamma,FRA,"DF,MF",20,2000,0.5,1,1,1,0,0,0,0,,0,0,0,0,0,1,1,0,defense
FRA-Ligue 1,2021,Montpellier,Stephy Mavididi,ENG,"FW,MF",22,1998,22.6,18,5,7,10,1,8,23,34.8,15,12,0,12,14,32,6,0,defense
FRA-Ligue 1,2021,Montpellier,Téji Savanier,FRA,MF,28,1991,24.1,49,33,16,25,8,22,73,30.1,51,28,6,22,38,87,15,0,defense
FRA-Ligue 1,2021,Montpellier,Vitorino Hilton,BRA,DF,42,1977,23.5,15,10,10,4,1,3,14,21.4,11,34,26,8,38,53,104,3,defense
FRA-Ligue 1,2021,Montpellier,Yun Il-lok,KOR,"MF,FW",28,1992,3.5,0,0,0,0,0,0,4,0.0,4,0,0,0,5,5,1,0,defense
FRA-Ligue 1,2021,Nantes,Abdoul Kader Bamba,FRA,"FW,MF",26,1994,10.2,18,3,7,8,3,11,18,61.1,7,10,0,10,7,25,4,1,defense
FRA-Ligue 1,2021,Nantes,Abdoulaye Sylla,GUI,DF,20,2000,0.1,2,1,2,0,0,1,1,100.0,0,1,0,1,0,2,1,0,defense
FRA-Ligue 1,2021,Nantes,Abdoulaye Touré,GUI,MF,26,1994,18.7,28,12,10,16,2,14,31,45.2,17,17,2,15,22,50,19,0,defense
FRA-Ligue 1,2021,Nantes,Alban Lafont,FRA,GK,21,1999,38.0,1,0,1,0,0,1,1,100.0,0,1,0,1,0,1,14,0,defense
FRA-Ligue 1,2021,Nantes,Andrei Girotto,BRA,"DF,MF",28,1992,29.6,65,41,50,15,0,39,70,55.7,31,34,15,19,59,124,103,0,defense
FRA-Ligue 1,2021,Nantes,Batista Mendy,FRA,MF,20,2000,0.8,1,1,0,1,0,0,1,0.0,1,3,1,2,1,2,1,0,defense
FRA-Ligue 1,2021,Nantes,Bridge Ndilu,FRA,"FW,MF",20,2000,0.5,0,0,0,0,0,0,2,0.0,2,2,0,2,0,0,0,0,defense
FRA-Ligue 1,2021,Nantes,Charles Traore,MLI,DF,28,1992,18.9,53,34,30,17,6,27,54,50.0,27,26,5,21,36,89,65,0,defense
FRA-Ligue 1,2021,Nantes,Dennis Appiah,FRA,DF,28,1992,17.3,55,34,33,15,7,32,59,54.2,27,23,6,17,25,80,43,0,defense
FRA-Ligue 1,2021,Nantes,Fábio,BRA,DF,30,1990,16.7,62,37,37,23,2,35,61,57.4,26,29,8,21,37,99,49,0,defense
FRA-Ligue 1,2021,Nantes,Imran Louza,MAR,MF,21,1999,26.4,55,28,25,26,4,21,69,30.4,48,20,4,16,33,88,15,2,defense
FRA-Ligue 1,2021,Nantes,Jean-Charles Castelletto,CMR,DF,25,1995,21.6,32,18,20,11,1,18,31,58.1,13,25,19,6,42,74,79,0,defense
FRA-Ligue 1,2021,Nantes,Jean-Kévin Augustin,FRA,FW,23,1997,0.4,2,0,0,2,0,2,2,100.0,0,0,0,0,0,2,0,0,defense
FRA-Ligue 1,2021,Nantes,Kalifa Coulibaly,MLI,FW,28,1991,10.9,3,1,0,1,2,2,8,25.0,6,3,1,2,2,5,12,0,defense
FRA-Ligue 1,2021,Nantes,Ludovic Blas,FRA,"MF,FW",22,1997,31.0,58,30,18,37,3,23,54,42.6,31,33,4,29,21,79,19,0,defense
FRA-Ligue 1,2021,Nantes,Marcus Coco,FRA,"MF,FW",24,1996,16.4,36,21,17,15,4,16,36,44.4,20,16,3,13,20,56,17,0,defense
FRA-Ligue 1,2021,Nantes,Mehdi Abeid,ALG,MF,27,1992,14.7,34,19,16,14,4,15,30,50.0,15,9,2,7,20,54,10,0,defense
FRA-Ligue 1,2021,Nantes,Moses Simon,NGA,"FW,MF",25,1995,25.8,27,14,11,9,7,17,36,47.2,19,24,1,23,15,42,15,1,defense
FRA-Ligue 1,2021,Nantes,Nicolas Pallois,FRA,DF,32,1987,30.8,58,36,42,14,2,38,72,52.8,34,44,20,24,37,95,155,1,defense
FRA-Ligue 1,2021,Nantes,Pedro Chirivella,ESP,MF,23,1997,25.3,26,8,7,13,6,14,49,28.6,35,23,4,19,41,67,19,0,defense
FRA-Ligue 1,2021,Nantes,Randal Kolo Muani,FRA,FW,21,1998,33.7,22,14,1,13,8,7,27,25.9,20,15,2,13,8,30,26,0,defense
FRA-Ligue 1,2021,Nantes,Renaud Emond,BEL,"FW,MF",28,1991,3.9,0,0,0,0,0,0,1,0.0,1,2,0,2,0,0,1,0,defense
FRA-Ligue 1,2021,Nantes,Roli Pereira de Sa,FRA,"FW,MF",23,1996,0.6,4,3,1,3,0,3,4,75.0,1,2,0,2,0,4,0,0,defense
FRA-Ligue 1,2021,Nantes,Samuel Moutoussamy,COD,FW,23,1996,0.9,0,0,0,0,0,0,1,0.0,1,1,0,1,0,0,0,0,defense
FRA-Ligue 1,2021,Nantes,Sébastien Corchia,FRA,DF,29,1990,23.0,55,30,29,17,9,33,60,55.0,27,28,10,18,38,93,40,1,defense
FRA-Ligue 1,2021,Nice,Alexis Claude-Maurice,FRA,"MF,FW",22,1998,21.2,40,19,17,14,9,14,48,29.2,34,16,2,14,14,54,3,0,defense
FRA-Ligue 1,2021,Nice,Alexis Trouillet,FRA,"MF,FW",19,2000,1.2,5,4,1,4,0,4,5,80.0,1,0,0,0,3,8,0,0,defense
FRA-Ligue 1,2021,Nice,Amine Gouiri,ALG,"FW,MF",20,2000,30.5,31,18,7,16,8,10,41,24.4,31,22,6,16,17,48,23,0,defense
FRA-Ligue 1,2021,Nice,Andy Pelmard,FRA,DF,20,2000,13.4,18,12,12,5,1,9,12,75.0,3,11,3,8,20,38,35,0,defense
FRA-Ligue 1,2021,Nice,Dan Ndoye,SUI,"FW,MF",19,2000,6.1,7,6,3,4,0,1,8,12.5,7,4,0,4,7,14,4,0,defense
FRA-Ligue 1,2021,Nice,Danilo Barbosa,BRA,DF,24,1996,2.8,6,3,5,1,0,4,6,66.7,2,2,1,1,2,8,11,2,defense
FRA-Ligue 1,2021,Nice,Dante,BRA,DF,36,1983,8.6,10,5,6,4,0,3,7,42.9,4,6,4,2,10,20,20,0,defense
FRA-Ligue 1,2021,Nice,Eddy Sylvestre,FRA,"FW,MF",20,1999,1.1,1,1,1,0,0,0,1,0.0,1,1,0,1,1,2,0,0,defense
FRA-Ligue 1,2021,Nice,Evann Guessand,CIV,FW,19,2001,0.3,0,0,0,0,0,0,1,0.0,1,1,1,0,1,1,1,0,defense
FRA-Ligue 1,2021,Nice,Flavius Daniliuc,AUT,DF,19,2001,16.4,23,15,15,5,3,10,21,47.6,11,17,6,11,14,37,32,0,defense
FRA-Ligue 1,2021,Nice,Hassane Kamara,CIV,"DF,FW",26,1994,32.9,65,39,40,16,9,27,49,55.1,22,39,12,27,55,120,61,1,defense
FRA-Ligue 1,2021,Nice,Hicham Boudaoui,ALG,MF,20,1999,19.3,52,35,20,24,8,26,68,38.2,42,14,4,10,23,75,26,1,defense
FRA-Ligue 1,2021,Nice,Hicham Mahou,FRA,FW,21,1999,0.4,1,1,1,0,0,1,2,50.0,1,2,0,2,1,2,0,0,defense
FRA-Ligue 1,2021,Nice,Jean-Clair Todibo,FRA,DF,20,1999,14.8,25,15,16,9,0,16,31,51.6,15,13,7,6,19,44,48,1,defense
FRA-Ligue 1,2021,Nice,Jeff Reine-Adélaïde,FRA,"MF,FW",22,1998,11.8,7,4,1,4,2,2,9,22.2,7,10,1,9,4,11,6,0,defense
FRA-Ligue 1,2021,Nice,Jordan Lotomba,SUI,"DF,MF",21,1998,23.6,35,25,19,11,5,20,34,58.8,14,19,7,12,33,68,52,1,defense
FRA-Ligue 1,2021,Nice,Kasper Dolberg,DEN,FW,22,1997,21.4,6,2,1,3,2,2,11,18.2,9,11,2,9,6,12,19,1,defense
FRA-Ligue 1,2021,Nice,Khéphren Thuram,FRA,MF,19,2001,16.6,32,16,5,21,6,9,27,33.3,18,21,9,12,18,50,22,1,defense
FRA-Ligue 1,2021,Nice,Malik Sellouki,FRA,"FW,MF",20,2000,0.7,0,0,0,0,0,0,1,0.0,1,2,0,2,2,2,0,0,defense
FRA-Ligue 1,2021,Nice,Morgan Schneiderlin,FRA,MF,30,1989,24.4,51,31,21,24,6,20,54,37.0,34,21,11,10,53,104,46,0,defense
FRA-Ligue 1,2021,Nice,Myziane Maolida,COM,"FW,MF",21,1999,12.0,13,8,4,4,5,4,11,36.4,7,6,1,5,6,19,4,0,defense
FRA-Ligue 1,2021,Nice,Patrick Burner,MTQ,DF,24,1996,0.0,0,0,0,0,0,0,0,,0,0,0,0,0,0,0,0,defense
FRA-Ligue 1,2021,Nice,Pierre Lees-Melou,FRA,MF,27,1993,22.9,67,39,33,31,3,25,83,30.1,58,50,14,36,29,96,31,1,defense
FRA-Ligue 1,2021,Nice,Racine Coly,SEN,MF,24,1995,0.2,0,0,0,0,0,0,0,,0,0,0,0,0,0,0,0,defense
FRA-Ligue 1,2021,Nice,Robson Bambu,BRA,DF,22,1997,11.6,16,11,14,2,0,11,14,78.6,3,8,7,1,10,26,57,0,defense
FRA-Ligue 1,2021,Nice,Rony Lopes,POR,"FW,MF",24,1995,19.8,20,14,4,13,3,6,27,22.2,21,14,3,11,8,28,6,0,defense
FRA-Ligue 1,2021,Nice,Salim Ben Seghir,FRA,DF,17,2003,0.1,0,0,0,0,0,0,0,,0,0,0,0,0,0,0,0,defense
FRA-Ligue 1,2021,Nice,Stanley N'Soki,FRA,DF,21,1999,13.8,27,19,15,9,3,13,22,59.1,9,17,4,13,26,53,38,2,defense
FRA-Ligue 1,2021,Nice,Walter Benítez,ARG,GK,27,1993,38.0,1,1,1,0,0,1,3,33.3,2,1,0,1,1,2,7,2,defense
FRA-Ligue 1,2021,Nice,William Saliba,FRA,DF,19,2001,20.0,15,9,8,5,2,5,6,83.3,1,17,16,1,26,41,80,2,defense
FRA-Ligue 1,2021,Nice,Youcef Atal,ALG,"DF,FW",24,1996,10.6,25,12,11,14,0,13,26,50.0,13,10,2,8,26,51,12,0,defense
FRA-Ligue 1,2021,Nîmes,Andrés Cubas,PAR,MF,24,1996,24.9,80,47,30,44,6,33,74,44.6,41,37,10,27,50,130,29,3,defense
FRA-Ligue 1,2021,Nîmes,Anthony Briançon,FRA,DF,25,1994,13.6,12,7,9,3,0,9,19,47.4,10,19,12,7,33,45,57,2,defense
FRA-Ligue 1,2021,Nîmes,Antoine Valerio,FRA,MF,20,1999,0.8,0,0,0,0,0,0,1,0.0,1,1,0,1,2,2,0,0,defense
FRA-Ligue 1,2021,Nîmes,Baptiste Reynet,FRA,GK,29,1990,38.0,2,1,2,0,0,2,4,50.0,2,1,0,1,1,3,9,2,defense
FRA-Ligue 1,2021,Nîmes,Birger Meling,NOR,DF,25,1994,25.9,49,31,27,15,7,33,50,66.0,17,43,9,34,36,85,70,0,defense
FRA-Ligue 1,2021,Nîmes,Clément Depres,FRA,FW,25,1994,0.2,0,0,0,0,0,0,0,,0,0,0,0,0,0,0,0,defense
FRA-Ligue 1,2021,Nîmes,Florian Miguel,FRA,DF,23,1996,17.1,14,13,12,2,0,9,17,52.9,8,21,13,8,45,59,66,1,defense
FRA-Ligue 1,2021,Nîmes,Gaëtan Paquiez,FRA,DF,26,1994,11.6,21,12,12,7,2,12,29,41.4,17,10,3,7,16,37,28,0,defense
FRA-Ligue 1,2021,Nîmes,Haris Duljević,BIH,"MF,FW",26,1993,8.6,15,9,4,7,4,6,22,27.3,16,3,0,3,8,23,1,0,defense
FRA-Ligue 1,2021,Nîmes,Karim Aribi,ALG,FW,26,1994,3.3,2,2,0,1,1,0,5,0.0,5,1,0,1,0,2,3,0,defense
FRA-Ligue 1,2021,Nîmes,Kelyan Guessoum,FRA,DF,21,1999,12.5,13,7,11,1,1,11,16,68.8,5,8,6,2,24,37,51,0,defense
FRA-Ligue 1,2021,Nîmes,Kévin Denkey,TOG,FW,19,2000,5.8,4,2,0,3,1,0,3,0.0,3,2,0,2,1,5,2,0,defense
FRA-Ligue 1,2021,Nîmes,Lamine Fomba,FRA,MF,22,1998,24.2,66,36,30,25,11,30,65,46.2,35,48,19,29,59,125,39,2,defense
FRA-Ligue 1,2021,Nîmes,Loïck Landre,FRA,DF,28,1992,18.1,14,7,9,5,0,13,28,46.4,15,22,19,3,31,45,52,0,defense
FRA-Ligue 1,2021,Nîmes,Lucas Buadés,FRA,MF,22,1997,0.2,1,0,0,1,0,0,0,,0,0,0,0,0,1,0,0,defense
FRA-Ligue 1,2021,Nîmes,Lucas Deaux,FRA,"MF,DF",31,1988,19.5,47,32,20,22,5,16,49,32.7,33,20,3,17,20,67,30,4,defense
FRA-Ligue 1,2021,Nîmes,Mahamadou Doucouré,MLI,"FW,MF",20,2000,0.5,1,1,1,0,0,1,1,100.0,0,0,0,0,0,1,0,0,defense
FRA-Ligue 1,2021,Nîmes,Marco Majouga,CTA,"FW,MF",19,2001,1.4,1,1,1,0,0,1,3,33.3,2,0,0,0,0,1,0,0,defense
FRA-Ligue 1,2021,Nîmes,Matteo Ahlinvi,BEN,MF,21,1999,10.0,26,20,10,14,2,11,39,28.2,28,6,0,6,2,28,8,0,defense
FRA-Ligue 1,2021,Nîmes,Moussa Koné,SEN,FW,23,1996,19.5,13,6,1,8,4,2,9,22.2,7,7,1,6,2,15,7,0,defense
FRA-Ligue 1,2021,Nîmes,Naomichi Ueda,JPN,DF,25,1994,7.9,4,2,3,1,0,4,6,66.7,2,5,4,1,6,10,30,1,defense
FRA-Ligue 1,2021,Nîmes,Nassim Chadli,FRA,"FW,MF",19,2001,0.3,2,1,2,0,0,0,1,0.0,1,1,0,1,0,2,0,0,defense
FRA-Ligue 1,2021,Nîmes,Niclas Eliasson,SWE,"MF,FW",24,1995,20.0,28,14,9,12,7,11,24,45.8,13,20,1,19,23,51,16,0,defense
FRA-Ligue 1,2021,Nîmes,Nolan Roux,FRA,FW,32,1988,7.2,7,3,1,4,2,3,8,37.5,5,6,0,6,5,12,4,0,defense
FRA-Ligue 1,2021,Nîmes,Pablo Martinez,FRA,DF,31,1989,6.0,10,7,7,3,0,7,7,100.0,0,6,4,2,11,21,28,0,defense
FRA-Ligue 1,2021,Nîmes,Patrick Burner,MTQ,DF,24,1996,14.6,25,11,14,10,1,13,26,50.0,13,10,3,7,24,49,41,1,defense
FRA-Ligue 1,2021,Nîmes,Renaud Ripart,FRA,"MF,FW",27,1993,33.9,52,30,25,19,8,26,84,31.0,58,58,12,46,36,88,53,0,defense
FRA-Ligue 1,2021,Nîmes,Romain Philippoteaux,FRA,"FW,MF",32,1988,2.4,1,1,1,0,0,1,5,20.0,4,2,0,2,2,3,1,0,defense
FRA-Ligue 1,2021,Nîmes,Sami Ben Amar,MAR,MF,22,1998,0.1,0,0,0,0,0,0,0,,0,1,0,1,0,0,0,0,defense
FRA-Ligue 1,2021,Nîmes,Sidy Sarr,SEN,MF,24,1996,5.1,10,6,4,6,0,2,5,40.0,3,1,1,0,7,17,4,0,defense
FRA-Ligue 1,2021,Nîmes,Sofiane Alakouch,MAR,DF,22,1998,16.7,53,33,30,16,7,29,45,64.4,16,17,2,15,21,74,38,0,defense
FRA-Ligue 1,2021,Nîmes,Yassine Benrahou,FRA,MF,21,1999,13.8,16,9,8,6,2,7,25,28.0,18,9,0,9,4,20,5,1,defense
FRA-Ligue 1,2021,Nîmes,Zinedine Ferhat,ALG,"FW,MF",27,1993,32.9,36,21,18,9,9,18,39,46.2,21,22,0,22,32,68,38,0,defense
FRA-Ligue 1,2021,Paris S-G,Abdou Diallo,SEN,DF,24,1996,16.6,16,11,9,5,2,8,13,61.5,5,15,8,7,25,41,36,0,defense
FRA-Ligue 1,2021,Paris S-G,Alessandro Florenzi,ITA,DF,29,1991,17.1,24,16,9,9,6,12,29,41.4,17,7,1,6,17,41,25,0,defense
FRA-Ligue 1,2021,Paris S-G,Ander Herrera,ESP,MF,30,1989,20.6,53,35,17,26,10,30,77,39.0,47,31,5,26,31,84,22,1,defense
FRA-Ligue 1,2021,Paris S-G,Arnaud Kalimuendo,FRA,FW,18,2002,0.8,0,0,0,0,0,0,0,,0,0,0,0,0,0,0,0,defense
FRA-Ligue 1,2021,Paris S-G,Bandiougou Fadiga,FRA,"FW,MF",19,2001,0.7,1,0,1,0,0,0,0,,0,0,0,0,0,1,0,0,defense
FRA-Ligue 1,2021,Paris S-G,Colin Dagba,FRA,DF,21,1998,15.1,23,11,4,17,2,14,19,73.7,5,18,5,13,16,39,18,1,defense
FRA-Ligue 1,2021,Paris S-G,Danilo Pereira,POR,"MF,DF",28,1991,15.9,21,11,6,11,4,6,14,42.9,8,14,6,8,29,50,33,4,defense
FRA-Ligue 1,2021,Paris S-G,Edouard Michut,FRA,MF,17,2003,0.0,0,0,0,0,0,0,0,,0,0,0,0,0,0,0,0,defense
FRA-Ligue 1,2021,Paris S-G,Idrissa Gana Gueye,SEN,MF,30,1989,17.6,63,35,20,34,9,26,50,52.0,24,26,7,19,20,83,9,3,defense
FRA-Ligue 1,2021,Paris S-G,Jesé,ESP,FW,27,1993,0.3,0,0,0,0,0,0,1,0.0,1,0,0,0,0,0,0,0,defense
FRA-Ligue 1,2021,Paris S-G,Juan Bernat,ESP,DF,27,1993,2.2,5,3,0,4,1,3,5,60.0,2,4,0,4,1,6,6,0,defense
FRA-Ligue 1,2021,Paris S-G,Julian Draxler,GER,"MF,FW",26,1993,11.8,13,6,5,6,2,5,20,25.0,15,4,0,4,14,27,0,0,defense
FRA-Ligue 1,2021,Paris S-G,Kays Ruiz,FRA,"FW,MF",17,2002,2.1,1,1,0,1,0,0,4,0.0,4,1,0,1,3,4,2,0,defense
FRA-Ligue 1,2021,Paris S-G,Kenny Nagera,FRA,FW,18,2002,0.0,0,0,0,0,0,0,0,,0,0,0,0,0,0,0,0,defense
FRA-Ligue 1,2021,Paris S-G,Keylor Navas,CRC,GK,33,1986,28.0,0,0,0,0,0,0,0,,0,0,0,0,0,0,10,0,defense
FRA-Ligue 1,2021,Paris S-G,Kylian Mbappé,FRA,FW,21,1998,26.4,4,2,0,1,3,2,9,22.2,7,7,1,6,3,7,4,1,defense
FRA-Ligue 1,2021,Paris S-G,Layvin Kurzawa,FRA,DF,27,1992,14.2,26,19,10,10,6,9,28,32.1,19,20,5,15,28,54,26,1,defense
FRA-Ligue 1,2021,Paris S-G,Leandro Paredes,ARG,MF,26,1994,14.5,30,18,12,15,3,19,39,48.7,20,17,5,12,17,47,13,1,defense
FRA-Ligue 1,2021,Paris S-G,Marcin Bułka,POL,GK,20,1999,1.0,0,0,0,0,0,0,0,,0,0,0,0,0,0,0,1,defense
FRA-Ligue 1,2021,Paris S-G,Marco Verratti,ITA,MF,27,1992,16.6,53,30,17,25,11,24,72,33.3,48,22,5,17,26,79,4,1,defense
FRA-Ligue 1,2021,Paris S-G,Marquinhos,BRA,DF,26,1994,23.6,27,21,14,10,3,15,26,57.7,11,21,9,12,27,54,75,2,defense
FRA-Ligue 1,2021,Paris S-G,Mauro Icardi,ARG,FW,27,1993,12.0,6,2,1,2,3,4,13,30.8,9,3,1,2,3,9,7,0,defense
FRA-Ligue 1,2021,Paris S-G,Mitchel Bakker,NED,DF,20,2000,18.8,38,30,15,14,9,17,26,65.4,9,22,2,20,22,60,20,0,defense
FRA-Ligue 1,2021,Paris S-G,Moise Kean,ITA,FW,20,2000,18.9,11,8,2,6,3,3,12,25.0,9,7,1,6,8,19,10,0,defense
FRA-Ligue 1,2021,Paris S-G,Neymar,BRA,"MF,FW",28,1992,15.7,14,11,1,6,7,8,37,21.6,29,8,0,8,9,23,0,0,defense
FRA-Ligue 1,2021,Paris S-G,Pablo Sarabia,ESP,"FW,MF",28,1992,14.7,15,11,6,6,3,10,38,26.3,28,9,1,8,5,20,8,0,defense
FRA-Ligue 1,2021,Paris S-G,Presnel Kimpembe,FRA,DF,24,1995,25.6,46,28,23,19,4,24,34,70.6,10,19,11,8,30,76,61,4,defense
FRA-Ligue 1,2021,Paris S-G,Rafinha,BRA,"MF,FW",27,1993,15.1,54,26,18,28,8,28,49,57.1,21,18,3,15,13,67,6,0,defense
FRA-Ligue 1,2021,Paris S-G,Sergio Rico,ESP,GK,26,1993,9.0,0,0,0,0,0,0,0,,0,0,0,0,0,0,1,0,defense
FRA-Ligue 1,2021,Paris S-G,Thilo Kehrer,GER,DF,23,1996,18.0,31,26,17,11,3,10,26,38.5,16,16,4,12,15,46,37,1,defense
FRA-Ligue 1,2021,Paris S-G,Timothee Pembele,FRA,DF,17,2002,4.3,8,7,4,4,0,5,14,35.7,9,4,0,4,5,13,8,1,defense
FRA-Ligue 1,2021,Paris S-G,Xavi Simons,NED,MF,17,2003,0.0,0,0,0,0,0,0,0,,0,0,0,0,0,0,0,0,defense
FRA-Ligue 1,2021,Paris S-G,Ángel Di María,ARG,"FW,MF",32,1988,20.6,26,17,6,8,12,11,45,24.4,34,14,1,13,6,32,7,0,defense
FRA-Ligue 1,2021,Reims,Alexis Flips,FRA,"MF,FW",20,2000,0.5,0,0,0,0,0,0,2,0.0,2,0,0,0,0,0,1,0,defense
FRA-Ligue 1,2021,Reims,Anastasios Donis,GRE,MF,23,1996,1.1,4,1,2,0,2,1,1,100.0,0,0,0,0,0,4,0,0,defense
FRA-Ligue 1,2021,Reims,Arber Zeneli,KVX,"MF,FW",25,1995,14.3,20,10,11,1,8,8,22,36.4,14,12,1,11,3,23,8,0,defense
FRA-Ligue 1,2021,Reims,Boulaye Dia,SEN,"FW,MF",23,1996,32.6,23,12,3,11,9,4,22,18.2,18,19,5,14,12,35,37,1,defense
FRA-Ligue 1,2021,Reims,Dario Maresic,AUT,DF,20,1999,5.7,12,7,8,4,0,8,14,57.1,6,7,2,5,10,22,17,1,defense
FRA-Ligue 1,2021,Reims,Dereck Kutesa,SUI,"MF,FW",22,1997,7.6,15,7,7,3,5,5,14,35.7,9,7,1,6,7,22,3,0,defense
FRA-Ligue 1,2021,Reims,Dion Lopy,SEN,MF,18,2002,2.8,1,1,0,1,0,0,0,,0,0,0,0,2,3,1,0,defense
FRA-Ligue 1,2021,Reims,El Bilal Touré,MLI,FW,18,2001,13.8,22,12,3,16,3,8,18,44.4,10,8,3,5,6,28,10,1,defense
FRA-Ligue 1,2021,Reims,Fodé Doucouré,MLI,DF,19,2001,3.7,11,8,7,4,0,4,9,44.4,5,2,0,2,4,15,11,0,defense
FRA-Ligue 1,2021,Reims,Fraser Hornby,SCO,"FW,MF",20,1999,0.4,0,0,0,0,0,0,0,,0,0,0,0,1,1,0,0,defense
FRA-Ligue 1,2021,Reims,Ghislain Konan,CIV,DF,24,1995,29.0,57,32,35,17,5,32,56,57.1,24,25,11,14,30,87,67,0,defense
FRA-Ligue 1,2021,Reims,Hugo Ekitike,FRA,"FW,MF",18,2002,1.0,1,1,0,0,1,0,1,0.0,1,0,0,0,0,1,0,0,defense
FRA-Ligue 1,2021,Reims,Kaj Sierhuis,NED,"FW,MF",22,1998,7.2,7,2,1,2,4,2,9,22.2,7,2,1,1,2,9,5,0,defense
FRA-Ligue 1,2021,Reims,Marshall Munetsi,ZIM,"MF,DF",24,1996,21.4,35,19,19,14,2,21,41,51.2,20,33,25,8,57,92,85,3,defense
FRA-Ligue 1,2021,Reims,Mathieu Cafaro,FRA,"MF,FW",23,1997,23.0,40,17,15,19,6,13,43,30.2,30,11,0,11,17,57,12,0,defense
FRA-Ligue 1,2021,Reims,Moreto Cassamã,GNB,MF,22,1998,22.6,49,36,24,23,2,27,49,55.1,22,19,6,13,36,85,33,4,defense
FRA-Ligue 1,2021,Reims,Mouhamadou Drammeh,FRA,MF,21,1999,1.9,0,0,0,0,0,0,2,0.0,2,0,0,0,2,2,7,0,defense
FRA-Ligue 1,2021,Reims,Moussa Doumbia,MLI,"MF,FW",25,1994,10.0,10,6,4,4,2,4,22,18.2,18,5,1,4,10,20,4,0,defense
FRA-Ligue 1,2021,Reims,Moïse Sakava,CMR,MF,19,2000,0.1,0,0,0,0,0,0,0,,0,0,0,0,0,0,0,0,defense
FRA-Ligue 1,2021,Reims,Nathanael Mbuku,COD,"MF,FW",18,2002,24.6,33,19,9,13,11,8,28,28.6,20,17,0,17,14,47,10,0,defense
FRA-Ligue 1,2021,Reims,Predrag Rajković,SRB,GK,24,1995,36.5,2,1,2,0,0,2,5,40.0,3,1,0,1,2,4,17,3,defense
FRA-Ligue 1,2021,Reims,Thibault De Smet,BEL,DF,22,1998,5.5,11,6,8,3,0,6,15,40.0,9,8,1,7,6,17,16,0,defense
FRA-Ligue 1,2021,Reims,Thomas Foket,BEL,DF,25,1994,36.9,77,43,50,20,7,40,69,58.0,29,28,7,21,69,146,92,2,defense
FRA-Ligue 1,2021,Reims,Tristan Dingomé,CMR,MF,29,1991,0.2,0,0,0,0,0,0,1,0.0,1,0,0,0,0,0,0,0,defense
FRA-Ligue 1,2021,Reims,Valon Berisha,KVX,MF,27,1993,18.3,40,23,19,17,4,11,47,23.4,36,14,2,12,25,65,21,1,defense
FRA-Ligue 1,2021,Reims,Wout Faes,BEL,DF,22,1998,32.2,35,22,26,9,0,20,39,51.3,19,40,31,9,68,103,144,1,defense
FRA-Ligue 1,2021,Reims,Xavier Chavalerin,FRA,MF,29,1991,28.3,92,50,47,38,7,26,74,35.1,48,43,9,34,43,135,29,1,defense
FRA-Ligue 1,2021,Reims,Yehvann Diouf,FRA,GK,20,1999,1.5,0,0,0,0,0,0,0,,0,0,0,0,0,0,0,0,defense
FRA-Ligue 1,2021,Reims,Yunis Abdelhamid,MAR,DF,32,1987,32.1,59,37,36,23,0,26,42,61.9,16,34,15,19,61,120,132,0,defense
FRA-Ligue 1,2021,Rennes,Adrien Hunou,FRA,"FW,MF",26,1994,6.5,6,3,2,2,2,2,8,25.0,6,7,0,7,1,7,2,0,defense
FRA-Ligue 1,2021,Rennes,Adrien Truffert,FRA,"DF,MF",18,2001,21.7,38,18,18,12,8,13,24,54.2,11,26,5,21,18,56,38,1,defense
FRA-Ligue 1,2021,Rennes,Alfred Gomis,SEN,GK,26,1993,22.0,1,1,1,0,0,1,1,100.0,0,0,0,0,3,4,10,1,defense
FRA-Ligue 1,2021,Rennes,Andy Diouf,FRA,FW,17,2003,0.1,0,0,0,0,0,0,0,,0,0,0,0,0,0,0,0,defense
FRA-Ligue 1,2021,Rennes,Benjamin Bourigeaud,FRA,"MF,FW",26,1994,28.4,40,23,17,16,7,21,71,29.6,50,37,1,36,19,59,25,0,defense
FRA-Ligue 1,2021,Rennes,Brandon Soppy,FRA,DF,18,2002,6.2,21,15,16,5,0,10,16,62.5,6,3,0,3,6,27,12,0,defense
FRA-Ligue 1,2021,Rennes,Clément Grenier,FRA,"MF,FW",29,1991,12.0,20,8,9,8,3,7,31,22.6,24,7,0,7,5,25,3,0,defense
FRA-Ligue 1,2021,Rennes,Dalbert Henrique,BRA,DF,26,1993,4.1,7,6,4,2,1,6,8,75.0,2,8,2,6,5,12,8,0,defense
FRA-Ligue 1,2021,Rennes,Damien Da Silva,FRA,DF,32,1988,29.6,22,13,13,8,1,12,18,66.7,6,17,13,4,44,66,99,1,defense
FRA-Ligue 1,2021,Rennes,Daniele Rugani,ITA,DF,26,1994,1.0,0,0,0,0,0,0,1,0.0,1,1,1,0,1,1,1,0,defense
FRA-Ligue 1,2021,Rennes,Edouard Mendy,SEN,GK,28,1992,1.0,0,0,0,0,0,0,0,,0,0,0,0,0,0,0,0,defense
FRA-Ligue 1,2021,Rennes,Eduardo Camavinga,FRA,MF,17,2002,26.7,98,58,39,48,11,38,77,49.4,39,36,2,34,23,121,15,1,defense
FRA-Ligue 1,2021,Rennes,Faitout Maouassa,FRA,DF,22,1998,13.0,20,11,10,8,2,11,19,57.9,8,9,1,8,17,37,36,0,defense
FRA-Ligue 1,2021,Rennes,Flavien Tait,FRA,"MF,FW",27,1993,15.2,26,11,11,12,3,10,32,31.3,22,17,3,14,13,39,2,0,defense
FRA-Ligue 1,2021,Rennes,Georginio Rutter,FRA,"FW,MF",18,2002,0.5,2,2,0,1,1,1,3,33.3,2,2,0,2,0,2,0,0,defense
FRA-Ligue 1,2021,Rennes,Gerzino Nyamsi,FRA,DF,23,1997,9.7,12,10,2,8,2,4,6,66.7,2,8,5,3,10,22,32,1,defense
FRA-Ligue 1,2021,Rennes,Hamari Traoré,MLI,DF,28,1992,33.3,56,38,23,27,6,22,59,37.3,37,31,5,26,76,132,50,0,defense
FRA-Ligue 1,2021,Rennes,James Lea Siliki,CMR,MF,24,1996,2.8,5,2,1,3,1,2,2,100.0,0,3,0,3,1,6,1,1,defense
FRA-Ligue 1,2021,Rennes,Jeremy Doku,BEL,"MF,FW",18,2002,25.7,44,25,9,24,11,11,26,42.3,15,18,1,17,11,55,1,0,defense
FRA-Ligue 1,2021,Rennes,Jonas Martin,FRA,MF,30,1990,5.4,11,9,5,4,2,5,14,35.7,9,11,2,9,13,24,2,1,defense
FRA-Ligue 1,2021,Rennes,Lesley Ugochukwu,FRA,MF,16,2004,0.7,3,1,0,3,0,2,3,66.7,1,1,0,1,0,3,0,0,defense
FRA-Ligue 1,2021,Rennes,M'Baye Niang,SEN,FW,25,1994,4.7,3,2,2,1,0,0,0,,0,2,0,2,1,4,2,0,defense
FRA-Ligue 1,2021,Rennes,Martin Terrier,FRA,"FW,MF",23,1997,27.1,33,15,5,15,13,10,36,27.8,26,23,0,23,16,49,7,0,defense
FRA-Ligue 1,2021,Rennes,Matthis Abline,FRA,FW,17,2003,0.0,0,0,0,0,0,0,0,,0,0,0,0,0,0,0,0,defense
FRA-Ligue 1,2021,Rennes,Nayef Aguerd,MAR,DF,24,1996,35.0,37,30,28,9,0,21,33,63.6,12,34,22,12,47,84,102,0,defense
FRA-Ligue 1,2021,Rennes,Raphinha,BRA,"FW,MF",23,1996,4.5,5,2,1,3,1,1,4,25.0,3,5,0,5,3,8,4,0,defense
FRA-Ligue 1,2021,Rennes,Romain Del Castillo,FRA,"MF,FW",24,1996,7.2,30,11,5,14,11,5,25,20.0,20,6,0,6,3,33,4,1,defense
FRA-Ligue 1,2021,Rennes,Romain Salin,FRA,GK,36,1984,15.0,0,0,0,0,0,0,1,0.0,1,0,0,0,1,1,6,3,defense
FRA-Ligue 1,2021,Rennes,Sacha Boey,FRA,DF,19,2000,1.4,3,3,2,1,0,3,4,75.0,1,0,0,0,2,5,2,0,defense
FRA-Ligue 1,2021,Rennes,Serhou Guirassy,GUI,FW,24,1996,19.6,4,1,1,3,0,1,3,33.3,2,10,1,9,5,9,17,0,defense
FRA-Ligue 1,2021,Rennes,Steven Nzonzi,FRA,MF,31,1988,32.3,34,16,15,16,3,12,31,38.7,19,24,10,14,16,50,26,0,defense
FRA-Ligue 1,2021,Rennes,Yann Gboho,FRA,"MF,FW",19,2001,3.4,6,3,3,1,2,3,8,37.5,5,1,0,1,1,7,3,1,defense
FRA-Ligue 1,2021,Saint-Étienne,Abdoulaye Sidibé,FRA,MF,18,2002,0.1,1,1,1,0,0,1,2,50.0,1,0,0,0,0,1,0,0,defense
FRA-Ligue 1,2021,Saint-Étienne,Adil Aouchiche,FRA,"MF,FW",18,2002,19.2,38,20,12,17,9,13,49,26.5,36,15,1,14,10,48,6,0,defense
FRA-Ligue 1,2021,Saint-Étienne,Aimen Moueffek,FRA,"DF,MF",19,2001,8.3,25,15,16,6,3,13,32,40.6,19,17,2,15,9,34,18,0,defense
FRA-Ligue 1,2021,Saint-Étienne,Anthony Modeste,FRA,"FW,MF",32,1988,3.3,2,1,0,2,0,1,4,25.0,3,3,1,2,0,2,3,0,defense
FRA-Ligue 1,2021,Saint-Étienne,Arnaud Nordin,FRA,"MF,FW",22,1998,19.7,14,8,5,5,4,6,21,28.6,15,13,2,11,9,23,10,0,defense
FRA-Ligue 1,2021,Saint-Étienne,Assane Dioussé,SEN,DF,22,1997,0.0,0,0,0,0,0,0,0,,0,0,0,0,0,0,0,0,defense
FRA-Ligue 1,2021,Saint-Étienne,Baptiste Gabard,FRA,MF,20,2000,1.5,4,3,1,3,0,1,5,20.0,4,4,0,4,1,5,0,0,defense
FRA-Ligue 1,2021,Saint-Étienne,Bilal Benkhedim,FRA,FW,19,2001,0.8,0,0,0,0,0,0,1,0.0,1,1,0,1,0,0,0,0,defense
FRA-Ligue 1,2021,Saint-Étienne,Charles Abi,FRA,"FW,MF",20,2000,10.1,8,2,5,0,3,3,12,25.0,9,6,2,4,4,12,5,0,defense
FRA-Ligue 1,2021,Saint-Étienne,Denis Bouanga,GAB,"MF,FW",25,1994,30.2,52,28,22,24,6,16,58,27.6,42,32,3,29,20,72,36,0,defense
FRA-Ligue 1,2021,Saint-Étienne,Etienne Green,ENG,GK,20,2000,8.0,0,0,0,0,0,0,0,,0,0,0,0,0,0,3,0,defense
FRA-Ligue 1,2021,Saint-Étienne,Gabriel Silva,BRA,DF,29,1991,3.9,7,6,7,0,0,1,2,50.0,1,4,1,3,6,13,8,0,defense
FRA-Ligue 1,2021,Saint-Étienne,Harold Moukoudi,CMR,DF,22,1997,25.3,46,27,37,8,1,28,38,73.7,10,24,10,14,42,88,78,1,defense
FRA-Ligue 1,2021,Saint-Étienne,Jean-Philippe Krasso,CIV,FW,23,1997,2.5,5,3,1,4,0,2,4,50.0,2,5,0,5,1,6,3,0,defense
FRA-Ligue 1,2021,Saint-Étienne,Jessy Moulin,FRA,GK,34,1986,29.0,2,1,2,0,0,2,3,66.7,1,0,0,0,2,4,9,2,defense
FRA-Ligue 1,2021,Saint-Étienne,Kévin Monnet-Paquet,FRA,"MF,FW",31,1988,6.3,11,7,7,2,2,5,10,50.0,5,5,0,5,6,17,7,0,defense
FRA-Ligue 1,2021,Saint-Étienne,Lucas Gourna-Douath,FRA,MF,16,2003,14.7,32,22,18,11,3,15,28,53.6,13,10,0,10,24,56,18,0,defense
FRA-Ligue 1,2021,Saint-Étienne,Mahdi Camara,FRA,"MF,DF",22,1998,36.6,99,67,43,46,10,33,60,55.0,27,50,12,38,78,177,51,0,defense
FRA-Ligue 1,2021,Saint-Étienne,Marvin Tshibuabua,FRA,DF,18,2002,0.5,1,0,1,0,0,0,0,,0,0,0,0,1,2,1,0,defense
FRA-Ligue 1,2021,Saint-Étienne,Mathieu Debuchy,FRA,DF,35,1985,23.4,58,33,37,17,4,40,62,64.5,22,27,9,18,45,103,61,0,defense
FRA-Ligue 1,2021,Saint-Étienne,Mathys Saban,FRA,FW,18,2002,0.1,0,0,0,0,0,0,0,,0,0,0,0,0,0,0,0,defense
FRA-Ligue 1,2021,Saint-Étienne,Maxence Rivera,FRA,"MF,FW",18,2002,2.7,12,10,6,4,2,4,10,40.0,6,5,0,5,1,13,0,0,defense
FRA-Ligue 1,2021,Saint-Étienne,Miguel Trauco,PER,DF,27,1992,22.6,47,29,25,14,8,23,43,53.5,20,19,4,15,30,77,34,1,defense
FRA-Ligue 1,2021,Saint-Étienne,Nelson Sissoko,FRA,DF,23,1997,5.3,12,6,6,3,3,7,12,58.3,5,2,1,1,12,24,16,1,defense
FRA-Ligue 1,2021,Saint-Étienne,Panagiotis Retsos,GRE,DF,21,1998,3.0,5,3,5,0,0,3,7,42.9,4,1,1,0,3,8,12,0,defense
FRA-Ligue 1,2021,Saint-Étienne,Pape Abou Cissé,SEN,DF,24,1995,14.0,15,13,10,5,0,6,10,60.0,4,7,4,3,27,42,87,0,defense
FRA-Ligue 1,2021,Saint-Étienne,Rayan Souici,FRA,DF,22,1998,0.1,0,0,0,0,0,0,0,,0,0,0,0,0,0,0,0,defense
FRA-Ligue 1,2021,Saint-Étienne,Romain Hamouma,FRA,"FW,MF",33,1987,19.7,12,7,5,6,1,4,24,16.7,20,17,1,16,7,19,11,0,defense
FRA-Ligue 1,2021,Saint-Étienne,Ryad Boudebouz,ALG,"MF,FW",30,1990,7.2,9,4,1,7,1,4,8,50.0,4,3,0,3,5,14,5,0,defense
FRA-Ligue 1,2021,Saint-Étienne,Saidou Sow,GUI,DF,18,2002,11.1,23,12,17,6,0,13,19,68.4,6,12,8,4,14,37,39,1,defense
FRA-Ligue 1,2021,Saint-Étienne,Stefan Bajic,FRA,GK,18,2001,1.0,0,0,0,0,0,0,0,,0,0,0,0,0,0,1,0,defense
FRA-Ligue 1,2021,Saint-Étienne,Timothée Kolodziejczak,FRA,DF,28,1991,22.6,28,15,23,5,0,19,27,70.4,8,24,15,9,36,64,80,1,defense
FRA-Ligue 1,2021,Saint-Étienne,Tyron Tormin,FRA,"FW,MF",19,2001,0.2,0,0,0,0,0,0,0,,0,0,0,0,0,0,0,0,defense
FRA-Ligue 1,2021,Saint-Étienne,Wahbi Khazri,TUN,FW,29,1991,13.1,24,15,12,7,5,12,24,50.0,12,10,1,9,4,28,11,0,defense
FRA-Ligue 1,2021,Saint-Étienne,Wesley Fofana,FRA,DF,19,2000,3.5,6,4,6,0,0,3,4,75.0,1,3,3,0,8,14,14,1,defense
FRA-Ligue 1,2021,Saint-Étienne,Yanis Lhery,FRA,MF,17,2003,0.3,0,0,0,0,0,0,0,,0,0,0,0,0,0,0,0,defense
FRA-Ligue 1,2021,Saint-Étienne,Yann M'Vila,FRA,MF,30,1990,0.2,0,0,0,0,0,0,2,0.0,2,0,0,0,1,1,0,0,defense
FRA-Ligue 1,2021,Saint-Étienne,Yvan Neyou,CMR,MF,23,1997,27.1,58,31,24,33,1,25,60,41.7,35,34,5,29,31,89,13,1,defense
FRA-Ligue 1,2021,Saint-Étienne,Yvann Macon,FRA,DF,21,1998,6.0,30,20,20,8,2,7,19,36.8,12,6,2,4,9,39,13,0,defense
FRA-Ligue 1,2021,Saint-Étienne,Zaydou Youssouf,COM,MF,21,1999,13.7,30,15,19,10,1,16,40,40.0,24,15,0,15,25,55,12,1,defense
FRA-Ligue 1,2021,Strasbourg,Abdul Majeed Waris,GHA,"FW,MF",28,1991,6.1,1,1,1,0,0,1,6,16.7,5,0,0,0,2,3,2,0,defense
FRA-Ligue 1,2021,Strasbourg,Adrien Thomasson,FRA,"MF,FW",26,1993,29.2,36,17,8,16,12,12,58,20.7,46,44,5,39,22,58,2,0,defense
FRA-Ligue 1,2021,Strasbourg,Alexander Djiku,GHA,"DF,MF",25,1994,28.4,60,41,45,13,2,32,52,61.5,20,28,10,18,91,151,104,0,defense
FRA-Ligue 1,2021,Strasbourg,Anthony Caci,FRA,DF,23,1997,31.1,80,46,47,27,6,35,69,50.7,34,30,4,26,55,135,65,1,defense
FRA-Ligue 1,2021,Strasbourg,Bingourou Kamara,SEN,GK,23,1996,8.0,1,1,1,0,0,1,3,33.3,2,0,0,0,1,2,2,1,defense
FRA-Ligue 1,2021,Strasbourg,Dimitri Liénard,FRA,MF,32,1988,20.3,39,27,17,19,3,24,55,43.6,31,23,1,22,18,57,10,0,defense
FRA-Ligue 1,2021,Strasbourg,Dion Moise Sahi,CIV,"FW,MF",18,2001,1.0,1,0,0,1,0,1,1,100.0,0,1,0,1,0,1,0,0,defense
FRA-Ligue 1,2021,Strasbourg,Eiji Kawashima,JPN,GK,37,1983,24.0,1,0,1,0,0,1,1,100.0,0,0,0,0,0,1,4,2,defense
FRA-Ligue 1,2021,Strasbourg,Frederic Guilbert,FRA,DF,25,1994,12.4,37,19,23,11,3,21,34,61.8,13,14,1,13,33,70,32,0,defense
FRA-Ligue 1,2021,Strasbourg,Habib Diallo,SEN,FW,25,1995,25.8,11,6,3,6,2,7,18,38.9,11,12,2,10,13,24,12,0,defense
FRA-Ligue 1,2021,Strasbourg,Ibrahima Sissoko,MLI,MF,22,1997,28.7,68,48,25,35,8,28,68,41.2,40,22,5,17,48,116,44,0,defense
FRA-Ligue 1,2021,Strasbourg,Idriss Saadi,ALG,"MF,FW",28,1992,1.4,0,0,0,0,0,0,2,0.0,2,0,0,0,0,0,0,0,defense
FRA-Ligue 1,2021,Strasbourg,Ismael Aaneba,FRA,DF,21,1999,0.1,0,0,0,0,0,0,0,,0,0,0,0,1,1,1,0,defense
FRA-Ligue 1,2021,Strasbourg,Jean-Eudes Aholou,CIV,MF,26,1994,23.8,46,25,18,25,3,19,48,39.6,29,17,5,12,53,99,32,0,defense
FRA-Ligue 1,2021,Strasbourg,Jean-Ricner Bellegarde,FRA,"MF,FW",22,1998,23.2,56,39,22,25,9,14,23,60.9,9,20,2,18,19,75,16,0,defense
FRA-Ligue 1,2021,Strasbourg,Kenny Lala,MAD,DF,28,1991,20.4,22,13,13,8,1,11,22,50.0,11,12,6,6,23,45,33,1,defense
FRA-Ligue 1,2021,Strasbourg,Kévin Zohi,MLI,"FW,MF",23,1996,4.8,9,5,3,4,2,2,6,33.3,4,6,0,6,6,15,3,0,defense
FRA-Ligue 1,2021,Strasbourg,Lamine Koné,CIV,DF,31,1989,11.6,9,6,5,4,0,5,8,62.5,3,4,3,1,15,24,36,0,defense
FRA-Ligue 1,2021,Strasbourg,Lionel Carole,FRA,DF,29,1991,14.9,37,25,18,14,5,16,29,55.2,13,3,1,2,38,75,28,0,defense
FRA-Ligue 1,2021,Strasbourg,Ludovic Ajorque,FRA,FW,26,1994,33.0,30,18,6,18,6,7,31,22.6,24,14,5,9,11,41,54,0,defense
FRA-Ligue 1,2021,Strasbourg,Mahame Siby,MLI,MF,24,1996,0.2,0,0,0,0,0,0,1,0.0,1,0,0,0,0,0,1,0,defense
FRA-Ligue 1,2021,Strasbourg,Matz Sels,BEL,GK,28,1992,6.0,0,0,0,0,0,0,0,,0,0,0,0,0,0,4,0,defense
FRA-Ligue 1,2021,Strasbourg,Mehdi Chahiri,MAR,"FW,MF",24,1996,8.9,18,8,7,5,6,8,20,40.0,12,9,0,9,6,24,5,0,defense
FRA-Ligue 1,2021,Strasbourg,Mohamed Simakan,FRA,DF,20,2000,17.9,32,22,21,6,5,9,18,50.0,9,17,11,6,31,63,41,0,defense
FRA-Ligue 1,2021,Strasbourg,Sanjin Prcić,BIH,MF,26,1993,3.9,3,2,0,3,0,2,5,40.0,3,4,3,1,4,7,2,1,defense
FRA-Ligue 1,2021,Strasbourg,Stefan Mitrović,SRB,DF,30,1990,30.9,36,27,29,7,0,24,37,64.9,13,23,13,10,31,67,108,5,defense
