league,season,team,player,nation,pos,age,born,90s,Tackles Tkl,Tackles TklW,Tackles Def 3rd,Tackles Mid 3rd,Tackles Att 3rd,Challenges Tkl,Challenges Att,Challenges Tkl%,Challenges Lost,Blocks Blocks,Blocks Sh,Blocks Pass,Int,Tkl+Int,Clr,Err,stat_type
FRA-Ligue 1,2022,Ajaccio,Ben Hamed Touré,CIV,FW,18,2003,2.3,4,4,2,2,0,1,5,20.0,4,2,0,2,1,5,4,0,defense
FRA-Ligue 1,2022,Ajaccio,Benjamin Leroy,FRA,GK,33,1989,31.1,0,0,0,0,0,0,2,0.0,2,0,0,0,1,1,16,2,defense
FRA-Ligue 1,2022,Ajaccio,Bevic Moussiti-Oko,CGO,FW,27,1995,7.8,3,1,1,1,1,1,2,50.0,1,5,3,2,2,5,8,0,defense
FRA-Ligue 1,2022,Ajaccio,Clément Vidal,FRA,"DF,MF",22,2000,21.1,25,15,14,11,0,18,38,47.4,20,27,16,11,27,52,73,1,defense
FRA-Ligue 1,2022,Ajaccio,Cyrille Bayala,BFA,MF,26,1996,22.3,53,37,16,20,17,23,48,47.9,25,20,3,17,25,78,21,0,defense
FRA-Ligue 1,2022,Ajaccio,Cédric Avinel,GLP,DF,35,1986,19.9,13,7,8,5,0,8,12,66.7,4,20,13,7,15,28,91,1,defense
FRA-Ligue 1,2022,Ajaccio,Fernand Mayembo,CGO,DF,26,1996,7.9,8,5,6,2,0,4,9,44.4,5,2,0,2,11,19,36,0,defense
FRA-Ligue 1,2022,Ajaccio,Florian Chabrolle,FRA,MF,24,1998,3.7,6,4,1,5,0,2,4,50.0,2,3,0,3,7,13,2,0,defense
FRA-Ligue 1,2022,Ajaccio,François-Joseph Sollacaro,FRA,GK,28,1994,6.0,0,0,0,0,0,0,0,,0,0,0,0,0,0,2,2,defense
FRA-Ligue 1,2022,Ajaccio,Ghjuvanni Quilichini,FRA,GK,19,2002,0.9,0,0,0,0,0,0,0,,0,0,0,0,0,0,1,0,defense
FRA-Ligue 1,2022,Ajaccio,Ismael Diallo,CIV,DF,25,1997,24.2,46,33,35,9,2,35,63,55.6,28,26,12,14,30,76,46,1,defense
FRA-Ligue 1,2022,Ajaccio,Ivane Chegra,FRA,"MF,FW",18,2004,2.1,8,3,6,1,1,4,11,36.4,7,0,0,0,1,9,0,0,defense
FRA-Ligue 1,2022,Ajaccio,Kevin Spadanuda,SUI,"MF,FW",25,1997,11.8,29,18,15,9,5,12,33,36.4,21,18,0,18,11,40,5,0,defense
FRA-Ligue 1,2022,Ajaccio,Kouamé Botué,BFA,"FW,MF",19,2002,2.5,4,2,2,1,1,0,2,0.0,2,1,0,1,0,4,1,0,defense
FRA-Ligue 1,2022,Ajaccio,Mathieu Coutadeur,FRA,MF,36,1986,21.6,23,13,13,10,0,8,28,28.6,20,19,3,16,19,42,21,0,defense
FRA-Ligue 1,2022,Ajaccio,Mehdi Puch-Herrantz,FRA,MF,18,2004,0.5,2,2,0,1,1,1,2,50.0,1,1,0,1,3,5,0,0,defense
FRA-Ligue 1,2022,Ajaccio,Mickaël Alphonse,GLP,DF,33,1989,15.1,35,23,20,11,4,20,33,60.6,13,17,5,12,35,70,44,1,defense
FRA-Ligue 1,2022,Ajaccio,Mickaël Barreto,FRA,MF,31,1991,14.7,32,20,12,17,3,8,45,17.8,37,17,0,17,18,50,11,0,defense
FRA-Ligue 1,2022,Ajaccio,Mohamed Youssouf,COM,DF,34,1988,27.3,72,44,41,24,7,38,61,62.3,23,32,8,24,65,137,70,0,defense
FRA-Ligue 1,2022,Ajaccio,Mounaim El Idrissy,FRA,FW,23,1999,27.7,32,19,5,20,7,10,36,27.8,26,22,0,22,13,45,20,0,defense
FRA-Ligue 1,2022,Ajaccio,Moussa Djitte,SEN,FW,22,1999,1.5,1,0,0,0,1,1,2,50.0,1,0,0,0,0,1,1,0,defense
FRA-Ligue 1,2022,Ajaccio,Moussa Soumano,FRA,FW,17,2005,5.5,2,2,0,1,1,0,6,0.0,6,2,0,2,0,2,0,0,defense
FRA-Ligue 1,2022,Ajaccio,Oumar Gonzalez,CMR,DF,24,1998,28.6,51,28,34,13,4,23,37,62.2,14,32,11,21,52,103,82,0,defense
FRA-Ligue 1,2022,Ajaccio,Paolo Lebas,FRA,MF,19,2003,0.6,0,0,0,0,0,0,0,,0,0,0,0,0,0,0,0,defense
FRA-Ligue 1,2022,Ajaccio,Qazim Laçi,ALB,MF,26,1996,2.4,6,3,2,3,1,4,9,44.4,5,5,0,5,2,8,3,0,defense
FRA-Ligue 1,2022,Ajaccio,Riad Nouri,FRA,"MF,FW",37,1985,18.8,21,12,7,10,4,12,29,41.4,17,8,1,7,15,36,11,0,defense
FRA-Ligue 1,2022,Ajaccio,Romain Hamouma,FRA,"FW,MF",35,1987,12.0,8,3,3,3,2,3,6,50.0,3,8,0,8,2,10,2,0,defense
FRA-Ligue 1,2022,Ajaccio,Ruan Levine,BRA,"MF,FW",23,1999,0.3,2,2,1,1,0,0,0,,0,1,0,1,2,4,0,0,defense
FRA-Ligue 1,2022,Ajaccio,Thomas Mangani,FRA,MF,35,1987,14.8,32,17,14,15,3,18,47,38.3,29,22,3,19,24,56,22,1,defense
FRA-Ligue 1,2022,Ajaccio,Tony Strata,ROU,"MF,DF",17,2004,1.5,4,3,4,0,0,4,5,80.0,1,2,0,2,1,5,7,0,defense
FRA-Ligue 1,2022,Ajaccio,Vincent Marchetti,FRA,MF,25,1997,27.2,55,26,29,19,7,25,68,36.8,43,23,3,20,19,74,31,0,defense
FRA-Ligue 1,2022,Ajaccio,Yanis Cimignani,FRA,"MF,DF",20,2002,3.1,11,5,3,7,1,4,5,80.0,1,5,1,4,2,13,2,0,defense
FRA-Ligue 1,2022,Ajaccio,Yoann Touzghar,TUN,FW,35,1986,5.0,3,2,0,2,1,0,1,0.0,1,0,0,0,0,3,1,0,defense
FRA-Ligue 1,2022,Ajaccio,Youcef Belaïli,ALG,"MF,FW",30,1992,12.8,18,10,3,9,6,8,20,40.0,12,10,1,9,5,23,4,0,defense
FRA-Ligue 1,2022,Ajaccio,Youssouf Koné,MLI,DF,27,1995,10.2,28,19,24,4,0,18,25,72.0,7,9,2,7,12,40,32,1,defense
FRA-Ligue 1,2022,Angers,Abdallah Sima,SEN,FW,21,2001,20.4,22,13,4,15,3,7,19,36.8,12,8,0,8,4,26,19,0,defense
FRA-Ligue 1,2022,Angers,Abdoulaye Bamba,CIV,DF,32,1990,15.2,22,12,15,5,2,16,19,84.2,3,7,3,4,18,40,38,0,defense
FRA-Ligue 1,2022,Angers,Adrien Hunou,FRA,"MF,FW",28,1994,24.8,39,20,17,16,6,16,45,35.6,29,35,0,35,7,46,7,0,defense
FRA-Ligue 1,2022,Angers,Amine Salama,FRA,"FW,MF",22,2000,13.9,11,9,3,7,1,2,12,16.7,10,8,2,6,10,21,2,0,defense
FRA-Ligue 1,2022,Angers,Antonin Bobichon,FRA,MF,26,1995,0.2,0,0,0,0,0,0,0,,0,1,0,1,0,0,0,0,defense
FRA-Ligue 1,2022,Angers,Azzedine Ounahi,MAR,"MF,FW",22,2000,12.5,19,8,5,13,1,10,20,50.0,10,8,0,8,15,34,4,1,defense
FRA-Ligue 1,2022,Angers,Batista Mendy,FRA,"MF,DF",22,2000,31.8,70,30,34,28,8,37,53,69.8,16,38,6,32,21,91,29,2,defense
FRA-Ligue 1,2022,Angers,Cédric Hountondji,BEN,DF,28,1994,34.4,50,36,31,17,2,19,29,65.5,10,44,22,22,59,109,132,1,defense
FRA-Ligue 1,2022,Angers,Faouzi Ghoulam,ALG,DF,31,1991,5.3,3,3,1,1,1,3,5,60.0,2,4,2,2,4,7,12,1,defense
FRA-Ligue 1,2022,Angers,Farid El Melali,ALG,"DF,FW",25,1997,9.0,21,12,7,12,2,11,22,50.0,11,16,0,16,8,29,7,0,defense
FRA-Ligue 1,2022,Angers,Halid Šabanović,BIH,DF,22,1999,7.1,8,6,7,1,0,6,8,75.0,2,8,2,6,8,16,12,0,defense
FRA-Ligue 1,2022,Angers,Himad Abdelli,ALG,"MF,FW",22,1999,23.7,64,38,22,32,10,31,67,46.3,36,30,1,29,28,92,15,0,defense
FRA-Ligue 1,2022,Angers,Ibrahim Amadou,FRA,"DF,MF",29,1993,4.7,10,7,6,3,1,7,11,63.6,4,7,3,4,10,20,20,0,defense
FRA-Ligue 1,2022,Angers,Ibrahima Niane,SEN,FW,23,1999,12.6,6,2,1,4,1,1,6,16.7,5,8,2,6,1,7,9,0,defense
FRA-Ligue 1,2022,Angers,Ilyes Cheti,ALG,DF,27,1995,2.3,6,4,4,0,2,5,8,62.5,3,5,1,4,4,10,7,0,defense
FRA-Ligue 1,2022,Angers,Jason Mbock,FRA,"MF,FW",22,1999,0.3,0,0,0,0,0,0,0,,0,0,0,0,0,0,0,0,defense
FRA-Ligue 1,2022,Angers,Jean Mattéo Bahoya,FRA,"FW,MF",17,2005,3.0,7,3,1,3,3,4,7,57.1,3,4,0,4,0,7,0,0,defense
FRA-Ligue 1,2022,Angers,Justin-Noël Kalumba,FRA,DF,17,2004,6.1,9,5,5,2,2,5,16,31.3,11,4,1,3,4,13,5,0,defense
FRA-Ligue 1,2022,Angers,Lilian Raolisoa,FRA,"DF,MF",22,2000,1.9,11,9,6,3,2,7,10,70.0,3,3,1,2,3,14,5,0,defense
FRA-Ligue 1,2022,Angers,Lois Diony,FRA,FW,29,1992,5.6,1,0,0,1,0,1,3,33.3,2,2,0,2,0,1,1,0,defense
FRA-Ligue 1,2022,Angers,Marin Jakoliš,CRO,FW,25,1996,0.3,1,1,0,0,1,0,0,,0,0,0,0,0,1,0,0,defense
FRA-Ligue 1,2022,Angers,Miha Blažič,SVN,DF,29,1993,22.0,8,6,8,0,0,7,15,46.7,8,25,19,6,22,30,80,1,defense
FRA-Ligue 1,2022,Angers,Nabil Bentaleb,ALG,MF,27,1994,27.7,74,40,31,35,8,36,61,59.0,25,33,11,22,44,118,29,3,defense
FRA-Ligue 1,2022,Angers,Ousmane Camara,FRA,DF,19,2003,5.8,10,6,5,5,0,5,12,41.7,7,4,2,2,11,21,15,0,defense
FRA-Ligue 1,2022,Angers,Paul Bernardoni,FRA,GK,25,1997,27.0,2,0,2,0,0,2,3,66.7,1,1,0,1,1,3,12,1,defense
FRA-Ligue 1,2022,Angers,Pierrick Capelle,FRA,"MF,DF",35,1987,15.9,36,21,17,15,4,22,55,40.0,33,24,3,21,15,51,24,0,defense
FRA-Ligue 1,2022,Angers,Sada Thioub,SEN,"DF,FW",27,1995,11.8,19,10,9,8,2,8,17,47.1,9,13,0,13,7,26,5,1,defense
FRA-Ligue 1,2022,Angers,Sofiane Boufal,MAR,"FW,MF",28,1993,9.3,14,9,7,4,3,3,14,21.4,11,6,0,6,5,19,1,0,defense
FRA-Ligue 1,2022,Angers,Souleyman Doumbia,CIV,"DF,FW",25,1996,19.9,45,31,31,13,1,17,31,54.8,14,20,3,17,27,72,27,1,defense
FRA-Ligue 1,2022,Angers,Waniss Taibi,FRA,MF,20,2002,2.1,9,5,4,4,1,2,4,50.0,2,1,0,1,2,11,2,0,defense
FRA-Ligue 1,2022,Angers,Yahia Fofana,CIV,GK,21,2000,11.0,0,0,0,0,0,0,0,,0,0,0,0,1,1,4,1,defense
FRA-Ligue 1,2022,Angers,Yan Valery,TUN,DF,23,1999,27.7,54,39,28,20,6,20,37,54.1,17,35,15,20,34,88,82,0,defense
FRA-Ligue 1,2022,Angers,Zinédine Ould Khaled,FRA,"MF,FW",22,2000,0.6,1,1,0,1,0,0,1,0.0,1,0,0,0,2,3,0,0,defense
FRA-Ligue 1,2022,Auxerre,Akim Zedadka,ALG,DF,27,1995,17.8,35,21,21,10,4,18,32,56.3,14,17,3,14,23,58,51,1,defense
FRA-Ligue 1,2022,Auxerre,Alexandre Coeff,FRA,DF,30,1992,6.5,10,5,6,4,0,4,9,44.4,5,9,4,5,8,18,35,1,defense
FRA-Ligue 1,2022,Auxerre,Benoît Costil,FRA,GK,35,1987,19.0,2,0,2,0,0,2,4,50.0,2,0,0,0,0,2,5,0,defense
FRA-Ligue 1,2022,Auxerre,Birama Touré,MLI,MF,30,1992,37.8,80,47,35,35,10,34,93,36.6,59,54,9,45,67,147,49,0,defense
FRA-Ligue 1,2022,Auxerre,Brayann Pereira,FRA,DF,19,2003,2.0,6,5,5,1,0,1,5,20.0,4,2,2,0,2,8,8,1,defense
FRA-Ligue 1,2022,Auxerre,Donovan Léon,GUF,GK,29,1992,2.0,0,0,0,0,0,0,0,,0,0,0,0,0,0,1,0,defense
FRA-Ligue 1,2022,Auxerre,Dénys Bain,FRA,DF,29,1993,1.4,4,3,3,1,0,1,2,50.0,1,2,1,1,2,6,4,0,defense
FRA-Ligue 1,2022,Auxerre,Gauthier Hein,FRA,"MF,FW",25,1996,20.8,27,20,13,11,3,18,48,37.5,30,10,0,10,6,33,10,0,defense
FRA-Ligue 1,2022,Auxerre,Gaëtan Charbonnier,FRA,"FW,MF",33,1988,2.8,2,1,0,2,0,0,4,0.0,4,2,0,2,0,2,5,0,defense
FRA-Ligue 1,2022,Auxerre,Gaëtan Perrin,FRA,"MF,FW",26,1996,15.5,17,8,5,6,6,8,30,26.7,22,15,0,15,10,27,9,0,defense
FRA-Ligue 1,2022,Auxerre,Gideon Mensah,GHA,DF,24,1998,25.1,80,44,43,32,5,44,77,57.1,33,33,10,23,38,118,41,0,defense
FRA-Ligue 1,2022,Auxerre,Hamza Sakhi,FRA,MF,26,1996,18.4,44,22,22,17,5,22,42,52.4,20,16,1,15,25,69,9,0,defense
FRA-Ligue 1,2022,Auxerre,Han-Noah Massengo,FRA,MF,21,2001,12.4,27,15,10,15,2,7,16,43.8,9,12,3,9,14,41,7,0,defense
FRA-Ligue 1,2022,Auxerre,Ionuț Radu,ROU,GK,25,1997,17.0,0,0,0,0,0,0,0,,0,0,0,0,0,0,3,3,defense
FRA-Ligue 1,2022,Auxerre,Jubal,BRA,DF,28,1993,35.7,41,26,29,11,1,19,38,50.0,19,57,34,23,53,94,193,0,defense
FRA-Ligue 1,2022,Auxerre,Julian Jeanvier,GUI,DF,30,1992,19.6,32,17,24,8,0,13,22,59.1,9,24,17,7,27,59,96,1,defense
FRA-Ligue 1,2022,Auxerre,Kays Ruiz,FRA,MF,19,2002,0.7,1,1,1,0,0,0,1,0.0,1,2,1,1,3,4,0,0,defense
FRA-Ligue 1,2022,Auxerre,Kenji-Van Boto,MAD,DF,26,1996,2.0,3,2,2,0,1,2,4,50.0,2,0,0,0,1,4,3,0,defense
FRA-Ligue 1,2022,Auxerre,Kévin Danois,FRA,MF,18,2004,0.0,1,1,0,1,0,0,0,,0,0,0,0,1,2,0,0,defense
FRA-Ligue 1,2022,Auxerre,Lassine Sinayoko,MLI,"MF,FW",22,1999,17.4,33,15,14,12,7,21,40,52.5,19,12,0,12,18,51,17,0,defense
FRA-Ligue 1,2022,Auxerre,M'Baye Niang,SEN,FW,27,1994,16.5,13,7,1,8,4,3,13,23.1,10,22,1,21,1,14,20,0,defense
FRA-Ligue 1,2022,Auxerre,Mathias Autret,FRA,"MF,FW",31,1991,14.3,22,10,10,10,2,7,16,43.8,9,14,2,12,12,34,13,0,defense
FRA-Ligue 1,2022,Auxerre,Matthis Abline,FRA,"FW,MF",19,2003,9.0,4,2,0,3,1,0,5,0.0,5,6,1,5,1,5,1,0,defense
FRA-Ligue 1,2022,Auxerre,Nuno da Costa,CPV,"FW,MF",31,1991,22.3,45,23,14,23,8,11,46,23.9,35,21,1,20,20,65,15,0,defense
FRA-Ligue 1,2022,Auxerre,Ousmane Camara,GUI,"FW,MF",20,2001,0.3,1,1,0,0,1,0,0,,0,0,0,0,0,1,0,0,defense
FRA-Ligue 1,2022,Auxerre,Paul Joly,FRA,DF,22,2000,9.6,33,21,21,10,2,19,35,54.3,16,13,2,11,24,57,29,2,defense
FRA-Ligue 1,2022,Auxerre,Quentin Bernard,FRA,DF,33,1989,7.0,9,7,4,2,3,7,15,46.7,8,9,1,8,15,24,17,0,defense
FRA-Ligue 1,2022,Auxerre,Rayan Raveloson,MAD,"DF,MF",25,1997,27.0,38,23,21,16,1,23,33,69.7,10,43,12,31,39,77,70,0,defense
FRA-Ligue 1,2022,Auxerre,Rémy Dugimont,FRA,"FW,MF",36,1986,1.3,2,1,0,1,1,1,2,50.0,1,3,0,3,0,2,5,0,defense
FRA-Ligue 1,2022,Auxerre,Siriki Dembélé,CIV,"MF,FW",25,1996,4.1,10,6,4,3,3,4,12,33.3,8,2,0,2,1,11,2,0,defense
FRA-Ligue 1,2022,Auxerre,Souleymane Touré,FRA,DF,19,2003,17.6,29,13,19,9,1,16,20,80.0,4,32,12,20,26,55,56,1,defense
FRA-Ligue 1,2022,Auxerre,Théo Pellenard,FRA,DF,28,1994,1.1,1,0,1,0,0,1,1,100.0,0,3,1,2,2,3,2,0,defense
FRA-Ligue 1,2022,Auxerre,Youssouf M'Changama,COM,MF,31,1990,12.0,22,11,7,12,3,7,13,53.8,6,6,0,6,15,37,6,1,defense
FRA-Ligue 1,2022,Brest,Achraf Dari,MAR,DF,23,1999,14.6,21,14,15,5,1,14,20,70.0,6,16,10,6,19,40,65,2,defense
FRA-Ligue 1,2022,Brest,Alberth Elis,HON,"MF,FW",26,1996,2.9,4,3,1,2,1,1,7,14.3,6,1,0,1,1,5,2,0,defense
FRA-Ligue 1,2022,Brest,Axel Camblan,FRA,"FW,MF",18,2003,0.8,2,2,1,1,0,0,1,0.0,1,0,0,0,0,2,0,0,defense
FRA-Ligue 1,2022,Brest,Bradley Locko,FRA,DF,20,2002,3.0,4,3,2,1,1,2,3,66.7,1,4,0,4,2,6,13,0,defense
FRA-Ligue 1,2022,Brest,Brendan Chardonnet,FRA,DF,27,1994,27.7,45,27,27,18,0,20,38,52.6,18,40,19,21,63,108,86,1,defense
FRA-Ligue 1,2022,Brest,Christophe Hérelle,MTQ,DF,29,1992,11.8,10,4,7,2,1,4,13,30.8,9,16,11,5,20,30,48,0,defense
FRA-Ligue 1,2022,Brest,Franck Honorat,FRA,"FW,MF",25,1996,28.2,41,29,20,8,13,19,34,55.9,15,22,2,20,21,62,18,0,defense
FRA-Ligue 1,2022,Brest,Félix Lemaréchal,FRA,MF,18,2003,3.2,5,5,2,1,2,0,3,0.0,3,6,0,6,1,6,2,0,defense
FRA-Ligue 1,2022,Brest,Haris Belkebla,ALG,MF,28,1994,29.5,80,48,35,40,5,44,85,51.8,41,32,6,26,52,132,21,3,defense
FRA-Ligue 1,2022,Brest,Hianga Mananga Mbock,FRA,MF,22,1999,0.2,0,0,0,0,0,0,1,0.0,1,0,0,0,0,0,0,0,defense
FRA-Ligue 1,2022,Brest,Hugo Magnetti,FRA,MF,24,1998,18.8,43,27,18,23,2,23,63,36.5,40,21,1,20,25,68,12,0,defense
FRA-Ligue 1,2022,Brest,Irvin Cardona,FRA,"FW,MF",24,1997,2.6,2,0,1,1,0,0,3,0.0,3,3,0,3,2,4,2,0,defense
FRA-Ligue 1,2022,Brest,Islam Slimani,ALG,FW,34,1988,11.0,5,3,2,2,1,0,3,0.0,3,2,0,2,1,6,11,0,defense
FRA-Ligue 1,2022,Brest,Jean-Kevin Duverne,HAI,DF,25,1997,27.9,72,38,44,24,4,42,73,57.5,31,33,5,28,28,100,65,1,defense
FRA-Ligue 1,2022,Brest,Jere Uronen,FIN,DF,28,1994,3.3,8,5,4,4,0,7,12,58.3,5,6,2,4,7,15,5,0,defense
FRA-Ligue 1,2022,Brest,Joaquín Blázquez,ARG,GK,21,2001,1.0,0,0,0,0,0,0,0,,0,0,0,0,0,0,2,0,defense
FRA-Ligue 1,2022,Brest,Jérémy Le Douaron,FRA,"MF,FW",24,1998,23.0,15,9,5,9,1,3,27,11.1,24,29,2,27,11,26,30,0,defense
FRA-Ligue 1,2022,Brest,Karamoko Dembélé,ENG,"FW,MF",19,2003,2.0,2,0,1,1,0,2,2,100.0,0,1,0,1,1,3,0,0,defense
FRA-Ligue 1,2022,Brest,Kenny Lala,MAD,DF,30,1991,15.7,36,19,19,15,2,22,38,57.9,16,15,5,10,21,57,28,0,defense
FRA-Ligue 1,2022,Brest,Lilian Brassier,FRA,DF,22,1999,34.4,42,30,31,8,3,23,32,71.9,9,42,19,23,53,95,132,1,defense
FRA-Ligue 1,2022,Brest,Mahdi Camara,FRA,MF,24,1998,20.2,63,36,18,38,7,25,43,58.1,18,35,4,31,40,103,16,0,defense
FRA-Ligue 1,2022,Brest,Marco Bizot,NED,GK,31,1991,37.0,0,0,0,0,0,0,1,0.0,1,1,0,1,0,0,24,4,defense
FRA-Ligue 1,2022,Brest,Mathias Pereira Lage,POR,"MF,FW",25,1996,14.0,20,7,5,14,1,11,29,37.9,18,10,1,9,14,34,12,0,defense
FRA-Ligue 1,2022,Brest,Noah Fadiga,SEN,DF,22,1999,14.5,30,21,18,9,3,14,26,53.8,12,17,7,10,26,56,18,0,defense
FRA-Ligue 1,2022,Brest,Pierre Lees-Melou,FRA,MF,29,1993,30.7,97,55,55,37,5,57,123,46.3,66,48,13,35,52,149,46,1,defense
FRA-Ligue 1,2022,Brest,Romain Del Castillo,FRA,"MF,FW",26,1996,15.8,39,24,13,17,9,16,36,44.4,20,14,1,13,11,50,5,0,defense
FRA-Ligue 1,2022,Brest,Steve Mounié,BEN,FW,27,1994,18.4,13,5,1,7,5,5,14,35.7,9,18,7,11,3,16,20,0,defense
FRA-Ligue 1,2022,Brest,Taïryk Arconte,FRA,FW,18,2003,1.4,1,1,0,0,1,0,3,0.0,3,1,0,1,0,1,2,0,defense
FRA-Ligue 1,2022,Brest,Youcef Belaïli,ALG,"FW,MF",30,1992,4.0,5,2,3,2,0,2,7,28.6,5,2,0,2,1,6,1,0,defense
FRA-Ligue 1,2022,Clermont Foot,Alidu Seidu,GHA,DF,22,2000,27.3,52,31,35,14,3,31,51,60.8,20,28,14,14,52,104,50,2,defense
FRA-Ligue 1,2022,Clermont Foot,Arial Mendy,SEN,DF,27,1994,2.5,4,2,3,0,1,2,2,100.0,0,2,0,2,4,8,4,0,defense
FRA-Ligue 1,2022,Clermont Foot,Aïman Maurer,MAR,MF,17,2004,5.6,2,1,1,1,0,1,10,10.0,9,1,0,1,3,5,5,0,defense
FRA-Ligue 1,2022,Clermont Foot,Baila Diallo,FRA,"DF,MF",21,2001,1.0,1,0,1,0,0,0,0,,0,1,1,0,0,1,1,0,defense
FRA-Ligue 1,2022,Clermont Foot,Brandon Baiye,BEL,MF,21,2000,0.6,3,2,2,1,0,2,3,66.7,1,1,0,1,1,4,3,0,defense
FRA-Ligue 1,2022,Clermont Foot,Cheick Konaté,MLI,DF,18,2004,6.4,19,12,10,7,2,13,22,59.1,9,7,1,6,13,32,8,1,defense
FRA-Ligue 1,2022,Clermont Foot,Elba Rashani,KVX,"MF,FW",29,1993,24.0,39,26,13,19,7,13,39,33.3,26,27,2,25,21,60,19,0,defense
FRA-Ligue 1,2022,Clermont Foot,Florent Ogier,FRA,DF,33,1989,18.9,33,16,20,12,1,22,39,56.4,17,22,13,9,18,51,64,1,defense
FRA-Ligue 1,2022,Clermont Foot,Grejohn Kyei,FRA,FW,26,1995,24.8,16,7,2,9,5,4,13,30.8,9,14,3,11,6,22,22,0,defense
FRA-Ligue 1,2022,Clermont Foot,Jason Berthomier,FRA,MF,32,1990,0.3,0,0,0,0,0,0,0,,0,0,0,0,0,0,0,0,defense
FRA-Ligue 1,2022,Clermont Foot,Jean-Claude Billong,CMR,MF,28,1993,0.3,0,0,0,0,0,0,0,,0,1,1,0,1,1,0,0,defense
FRA-Ligue 1,2022,Clermont Foot,Jim Allevinah,GAB,"DF,FW",27,1995,24.9,39,24,24,11,4,19,62,30.6,43,24,2,22,24,63,26,1,defense
FRA-Ligue 1,2022,Clermont Foot,Jodel Dossou,BEN,"MF,DF",30,1992,2.9,7,4,3,2,2,4,4,100.0,0,2,1,1,1,8,0,0,defense
FRA-Ligue 1,2022,Clermont Foot,Johan Gastien,FRA,MF,34,1988,28.9,62,34,30,23,9,38,111,34.2,73,37,7,30,36,98,25,1,defense
FRA-Ligue 1,2022,Clermont Foot,Jérémie Bela,ANG,"DF,MF",29,1993,8.3,6,4,2,1,3,3,4,75.0,1,10,1,9,9,15,8,0,defense
FRA-Ligue 1,2022,Clermont Foot,Komnen Andrić,SRB,FW,27,1995,16.1,13,5,2,7,4,2,15,13.3,13,8,1,7,8,21,13,0,defense
FRA-Ligue 1,2022,Clermont Foot,Mateusz Wieteska,POL,DF,25,1997,34.6,41,23,28,13,0,19,33,57.6,14,44,28,16,56,97,97,4,defense
FRA-Ligue 1,2022,Clermont Foot,Maxime Gonalons,FRA,MF,33,1989,16.1,52,32,25,21,6,25,53,47.2,28,21,1,20,20,72,7,1,defense
FRA-Ligue 1,2022,Clermont Foot,Maximiliano Caufriez,BEL,DF,25,1997,24.7,40,24,31,8,1,20,28,71.4,8,33,18,15,34,74,70,0,defense
FRA-Ligue 1,2022,Clermont Foot,Mehdi Zeffane,ALG,"DF,MF",30,1992,7.3,12,7,5,7,0,4,21,19.0,17,14,6,8,22,34,12,0,defense
FRA-Ligue 1,2022,Clermont Foot,Mory Diaw,SEN,GK,29,1993,37.0,0,0,0,0,0,0,4,0.0,4,0,0,0,2,2,13,5,defense
FRA-Ligue 1,2022,Clermont Foot,Muhammed Cham,AUT,MF,21,2000,21.9,30,15,15,4,11,13,35,37.1,22,13,0,13,7,37,5,0,defense
FRA-Ligue 1,2022,Clermont Foot,Neto Borges,BRA,DF,25,1996,31.5,75,45,45,20,10,46,75,61.3,29,45,11,34,41,116,62,1,defense
FRA-Ligue 1,2022,Clermont Foot,Ouparine Djoco,GNB,GK,24,1998,1.0,0,0,0,0,0,0,0,,0,0,0,0,0,0,1,0,defense
FRA-Ligue 1,2022,Clermont Foot,Saîf-Eddine Khaoui,TUN,MF,27,1995,22.5,47,28,14,25,8,15,47,31.9,32,17,2,15,33,80,8,0,defense
FRA-Ligue 1,2022,Clermont Foot,Souleymane Cissé,FRA,DF,19,2002,0.4,1,1,1,0,0,1,1,100.0,0,1,1,0,1,2,2,0,defense
FRA-Ligue 1,2022,Clermont Foot,Yanis Massolin,FRA,MF,19,2002,0.7,2,1,1,0,1,0,1,0.0,1,1,0,1,2,4,0,0,defense
FRA-Ligue 1,2022,Clermont Foot,Yohann Magnin,FRA,MF,25,1997,26.7,89,54,37,45,7,54,106,50.9,52,50,12,38,25,114,46,0,defense
FRA-Ligue 1,2022,Lens,Adam Buksa,POL,"FW,MF",26,1996,1.1,1,0,0,0,1,0,3,0.0,3,0,0,0,0,1,0,0,defense
FRA-Ligue 1,2022,Lens,Adrien Thomasson,FRA,"MF,FW",28,1993,14.2,24,17,8,11,5,12,45,26.7,33,25,2,23,4,28,17,0,defense
FRA-Ligue 1,2022,Lens,Alexis Claude-Maurice,FRA,"MF,FW",24,1998,6.7,14,9,5,8,1,6,16,37.5,10,6,0,6,2,16,1,0,defense
FRA-Ligue 1,2022,Lens,Angelo Fulgini,FRA,"MF,FW",25,1996,9.5,14,7,2,4,8,5,14,35.7,9,11,0,11,8,22,2,0,defense
FRA-Ligue 1,2022,Lens,Brice Samba,FRA,GK,28,1994,37.0,1,0,1,0,0,1,2,50.0,1,1,0,1,0,1,12,2,defense
FRA-Ligue 1,2022,Lens,Christopher Wooh,CMR,MF,20,2001,0.0,0,0,0,0,0,0,1,0.0,1,0,0,0,0,0,1,0,defense
FRA-Ligue 1,2022,Lens,David Costa,POR,"MF,FW",21,2001,15.6,13,7,1,10,2,7,19,36.8,12,19,1,18,11,24,6,0,defense
FRA-Ligue 1,2022,Lens,Deiver Machado,COL,"DF,MF",28,1993,24.3,45,26,18,20,7,21,34,61.8,13,21,4,17,21,66,27,0,defense
FRA-Ligue 1,2022,Lens,Facundo Medina,ARG,DF,23,1999,30.9,31,20,16,15,0,13,35,37.1,22,25,9,16,26,57,62,1,defense
FRA-Ligue 1,2022,Lens,Florian Sotoca,FRA,"MF,FW",31,1990,33.9,39,19,11,17,11,15,40,37.5,25,41,2,39,29,68,51,0,defense
FRA-Ligue 1,2022,Lens,Gaël Kakuta,COD,FW,31,1991,0.2,0,0,0,0,0,0,0,,0,0,0,0,0,0,1,0,defense
FRA-Ligue 1,2022,Lens,Ignatius Ganago,CMR,FW,23,1999,0.7,0,0,0,0,0,0,0,,0,0,0,0,0,0,1,0,defense
FRA-Ligue 1,2022,Lens,Ismaël Boura,COM,"DF,FW",21,2000,1.0,6,4,4,2,0,5,6,83.3,1,2,1,1,2,8,3,0,defense
FRA-Ligue 1,2022,Lens,Jean Onana,CMR,"MF,DF",22,2000,9.0,28,17,8,17,3,10,22,45.5,12,15,5,10,18,46,20,0,defense
FRA-Ligue 1,2022,Lens,Jean-Louis Leca,FRA,GK,36,1985,1.0,0,0,0,0,0,0,0,,0,0,0,0,0,0,0,1,defense
FRA-Ligue 1,2022,Lens,Jimmy Cabot,FRA,"DF,MF",28,1994,5.7,20,12,10,8,2,12,26,46.2,14,5,0,5,4,24,12,0,defense
FRA-Ligue 1,2022,Lens,Jonathan Gradit,FRA,DF,29,1992,31.4,62,40,30,25,7,31,53,58.5,22,40,26,14,38,100,83,0,defense
FRA-Ligue 1,2022,Lens,Julien Le Cardinal,FRA,DF,24,1997,1.8,6,4,5,0,1,4,6,66.7,2,3,0,3,2,8,5,0,defense
FRA-Ligue 1,2022,Lens,Kevin Danso,AUT,DF,23,1998,35.9,37,19,25,11,1,19,30,63.3,11,48,34,14,33,70,124,0,defense
FRA-Ligue 1,2022,Lens,Loïs Openda,BEL,FW,22,2000,28.0,11,9,2,6,3,2,13,15.4,11,9,0,9,2,13,6,0,defense
FRA-Ligue 1,2022,Lens,Massadio Haïdara,MLI,"DF,MF",29,1992,18.6,24,16,9,9,6,12,24,50.0,12,26,9,17,36,60,39,1,defense
FRA-Ligue 1,2022,Lens,Patrick Berg,NOR,"MF,FW",24,1997,0.3,0,0,0,0,0,0,1,0.0,1,0,0,0,1,1,0,0,defense
FRA-Ligue 1,2022,Lens,Przemysław Frankowski,POL,"DF,MF",27,1995,31.5,77,51,37,31,9,39,80,48.8,41,38,6,32,41,118,42,2,defense
FRA-Ligue 1,2022,Lens,Rémy Labeau Lascary,GLP,"FW,MF",19,2003,1.4,4,2,4,0,0,0,0,,0,4,0,4,1,5,0,0,defense
FRA-Ligue 1,2022,Lens,Salis Abdul Samed,GHA,MF,22,2000,32.2,46,26,18,23,5,29,52,55.8,23,38,9,29,36,82,26,0,defense
FRA-Ligue 1,2022,Lens,Seko Fofana,CIV,MF,27,1995,34.1,28,13,8,18,2,15,39,38.5,24,17,4,13,19,47,14,0,defense
FRA-Ligue 1,2022,Lens,Steven Fortes,CPV,DF,30,1992,0.1,0,0,0,0,0,0,0,,0,0,0,0,0,0,0,0,defense
FRA-Ligue 1,2022,Lens,Wesley Saïd,FRA,"FW,MF",27,1995,7.2,4,1,1,2,1,2,6,33.3,4,4,0,4,1,5,2,0,defense
FRA-Ligue 1,2022,Lens,Łukasz Poręba,POL,MF,22,2000,2.9,5,4,2,1,2,2,3,66.7,1,3,0,3,4,9,2,0,defense
FRA-Ligue 1,2022,Lille,Adam Ounas,ALG,"FW,MF",25,1996,11.8,20,11,4,10,6,8,13,61.5,5,16,0,16,7,27,5,0,defense
FRA-Ligue 1,2022,Lille,Akim Zedadka,ALG,"DF,MF",27,1995,3.9,1,1,1,0,0,0,2,0.0,2,3,0,3,2,3,6,0,defense
FRA-Ligue 1,2022,Lille,Alan Virginius,FRA,FW,19,2003,2.9,3,2,1,1,1,0,4,0.0,4,0,0,0,2,5,1,0,defense
FRA-Ligue 1,2022,Lille,Alexsandro Ribeiro,BRA,DF,22,1999,17.9,32,18,24,7,1,19,28,67.9,9,11,2,9,25,57,59,1,defense
FRA-Ligue 1,2022,Lille,Amine Messoussa,FRA,FW,17,2004,0.0,0,0,0,0,0,0,0,,0,0,0,0,0,0,0,0,defense
FRA-Ligue 1,2022,Lille,André Gomes,POR,MF,29,1993,18.1,37,19,12,17,8,19,52,36.5,33,20,5,15,9,46,16,1,defense
FRA-Ligue 1,2022,Lille,Angel Gomes,ENG,MF,21,2000,31.3,41,19,12,21,8,18,49,36.7,31,22,2,20,13,54,11,1,defense
FRA-Ligue 1,2022,Lille,Bafodé Diakité,FRA,DF,21,2001,29.5,54,35,23,24,7,32,57,56.1,25,37,8,29,17,71,58,0,defense
FRA-Ligue 1,2022,Lille,Benjamin André,FRA,MF,31,1990,32.4,128,74,51,60,17,65,121,53.7,56,50,8,42,47,175,60,0,defense
FRA-Ligue 1,2022,Lille,Carlos Baleba,CMR,MF,18,2004,5.3,13,11,2,9,2,9,14,64.3,5,13,3,10,1,14,3,2,defense
FRA-Ligue 1,2022,Lille,Edon Zhegrova,KVX,"FW,MF",23,1999,11.7,18,12,6,7,5,12,20,60.0,8,9,0,9,2,20,2,0,defense
FRA-Ligue 1,2022,Lille,Gabriel Gudmundsson,SWE,"DF,FW",23,1999,9.3,19,11,7,10,2,12,22,54.5,10,11,2,9,10,29,20,0,defense
FRA-Ligue 1,2022,Lille,Ismaily,BRA,DF,32,1990,19.8,41,18,16,16,9,17,32,53.1,15,25,5,20,21,62,39,0,defense
FRA-Ligue 1,2022,Lille,Jonas Martin,FRA,MF,32,1990,3.1,9,7,4,5,0,5,14,35.7,9,3,1,2,7,16,3,0,defense
FRA-Ligue 1,2022,Lille,Jonathan Bamba,CIV,FW,26,1996,30.9,37,17,12,14,11,14,45,31.1,31,36,1,35,22,59,14,0,defense
FRA-Ligue 1,2022,Lille,Jonathan David,CAN,FW,22,2000,35.2,24,17,6,11,7,10,27,37.0,17,20,2,18,8,32,13,0,defense
FRA-Ligue 1,2022,Lille,José Fonte,POR,DF,38,1983,28.8,23,17,18,4,1,10,21,47.6,11,27,14,13,25,48,112,2,defense
FRA-Ligue 1,2022,Lille,Leny Yoro,FRA,DF,16,2005,8.5,11,5,8,3,0,4,9,44.4,5,6,1,5,18,29,27,1,defense
FRA-Ligue 1,2022,Lille,Lucas Chevalier,FRA,GK,20,2001,32.0,2,1,2,0,0,2,2,100.0,0,1,0,1,2,4,7,2,defense
FRA-Ligue 1,2022,Lille,Léo Jardim,BRA,GK,27,1995,6.0,0,0,0,0,0,0,1,0.0,1,0,0,0,0,0,0,1,defense
FRA-Ligue 1,2022,Lille,Mohamed Lamine Bayo,GUI,"FW,MF",24,1998,7.2,3,3,0,2,1,0,12,0.0,12,3,1,2,0,3,1,0,defense
FRA-Ligue 1,2022,Lille,Rémy Cabella,FRA,"MF,FW",32,1990,28.1,64,37,21,28,15,29,64,45.3,35,41,5,36,17,81,7,1,defense
FRA-Ligue 1,2022,Lille,Simon Ramet,FRA,DF,19,2003,0.0,0,0,0,0,0,0,0,,0,0,0,0,0,0,0,0,defense
FRA-Ligue 1,2022,Lille,Tiago Djaló,POR,DF,22,2000,22.4,31,21,23,7,1,13,20,65.0,7,17,11,6,23,54,60,1,defense
FRA-Ligue 1,2022,Lille,Timothy Weah,USA,"DF,FW",22,2000,19.4,24,14,13,9,2,16,29,55.2,13,17,3,14,23,47,18,0,defense
FRA-Ligue 1,2022,Lille,Yusuf Yazıcı,TUR,MF,25,1997,2.2,0,0,0,0,0,0,0,,0,2,0,2,0,0,1,0,defense
FRA-Ligue 1,2022,Lorient,Adil Aouchiche,FRA,MF,20,2002,2.8,5,2,3,1,1,1,9,11.1,8,1,0,1,4,9,1,0,defense
FRA-Ligue 1,2022,Lorient,Adrian Grbić,AUT,"MF,FW",25,1996,0.3,0,0,0,0,0,0,1,0.0,1,3,0,3,0,0,0,0,defense
FRA-Ligue 1,2022,Lorient,Armand Lauriente,FRA,FW,23,1998,3.0,8,7,3,4,1,3,7,42.9,4,5,1,4,4,12,1,0,defense
FRA-Ligue 1,2022,Lorient,Ayman Kari,FRA,"MF,DF",17,2004,1.1,0,0,0,0,0,0,0,,0,4,0,4,3,3,0,0,defense
FRA-Ligue 1,2022,Lorient,Bamba Dieng,SEN,FW,22,2000,8.3,19,10,5,12,2,3,11,27.3,8,6,0,6,2,21,6,0,defense
FRA-Ligue 1,2022,Lorient,Bamo Meïté,CIV,DF,20,2001,16.7,18,8,13,4,1,7,16,43.8,9,33,23,10,16,34,70,0,defense
FRA-Ligue 1,2022,Lorient,Bonke Innocent,NGA,MF,26,1996,13.1,28,17,13,14,1,11,36,30.6,25,22,5,17,26,54,31,0,defense
FRA-Ligue 1,2022,Lorient,Chrislain Matsima,FRA,"DF,MF",20,2002,2.5,0,0,0,0,0,0,0,,0,3,3,0,2,2,7,0,defense
FRA-Ligue 1,2022,Lorient,Dango Ouattara,BFA,"FW,MF",20,2002,17.2,41,26,20,11,10,15,28,53.6,13,24,6,18,19,60,21,0,defense
FRA-Ligue 1,2022,Lorient,Darlin Yongwa,CMR,DF,21,2000,8.7,13,11,7,5,1,4,15,26.7,11,13,1,12,5,18,11,0,defense
FRA-Ligue 1,2022,Lorient,Eli Junior Kroupi,FRA,"FW,MF",16,2006,0.1,0,0,0,0,0,0,1,0.0,1,0,0,0,1,1,0,0,defense
FRA-Ligue 1,2022,Lorient,Enzo Le Fée,FRA,MF,22,2000,33.6,108,64,52,40,16,43,113,38.1,70,50,5,45,34,142,38,1,defense
FRA-Ligue 1,2022,Lorient,Gedeon Kalulu,COD,DF,24,1997,27.1,64,34,43,14,7,30,48,62.5,18,32,3,29,28,92,79,2,defense
FRA-Ligue 1,2022,Lorient,Ibrahima Koné,MLI,FW,23,1999,17.5,24,13,3,13,8,5,11,45.5,6,13,0,13,4,28,18,0,defense
FRA-Ligue 1,2022,Lorient,Igor Carioca,BRA,DF,25,1996,5.1,18,11,12,2,4,12,21,57.1,9,7,0,7,5,23,17,0,defense
FRA-Ligue 1,2022,Lorient,Jean-Victor Makengo,FRA,MF,24,1998,11.8,16,8,5,10,1,6,20,30.0,14,8,5,3,10,26,13,1,defense
FRA-Ligue 1,2022,Lorient,Julien Laporte,FRA,DF,28,1993,18.4,22,16,18,3,1,16,22,72.7,6,33,27,6,18,40,108,2,defense
FRA-Ligue 1,2022,Lorient,Julien Ponceau,FRA,MF,21,2000,18.4,28,19,10,14,4,10,32,31.3,22,27,3,24,14,42,12,0,defense
FRA-Ligue 1,2022,Lorient,Laurent Abergel,FRA,MF,29,1993,26.0,92,52,59,30,3,39,92,42.4,53,47,8,39,34,126,39,0,defense
FRA-Ligue 1,2022,Lorient,Montassar Talbi,TUN,DF,24,1998,38.0,53,25,40,13,0,22,35,62.9,13,55,34,21,40,93,190,3,defense
FRA-Ligue 1,2022,Lorient,Quentin Boisgard,FRA,MF,25,1997,2.0,6,2,1,4,1,3,4,75.0,1,3,1,2,4,10,2,0,defense
FRA-Ligue 1,2022,Lorient,Romain Faivre,FRA,"MF,FW",24,1998,13.8,13,8,5,4,4,5,25,20.0,20,11,0,11,1,14,4,0,defense
FRA-Ligue 1,2022,Lorient,Siriné Doucouré,MLI,"FW,MF",20,2002,1.5,2,2,2,0,0,1,2,50.0,1,0,0,0,1,3,0,0,defense
FRA-Ligue 1,2022,Lorient,Stéphane Diarra,FRA,"FW,MF",23,1998,11.8,25,17,14,9,2,11,29,37.9,18,13,1,12,22,47,9,0,defense
FRA-Ligue 1,2022,Lorient,Terem Moffi,NGA,FW,23,1999,15.4,8,5,1,4,3,3,5,60.0,2,11,3,8,3,11,10,0,defense
FRA-Ligue 1,2022,Lorient,Théo Le Bris,FRA,"MF,DF",19,2002,16.1,31,19,17,11,3,15,33,45.5,18,21,2,19,18,49,31,0,defense
FRA-Ligue 1,2022,Lorient,Vincent Le Goff,FRA,DF,32,1989,37.0,75,32,56,16,3,45,62,72.6,17,29,9,20,41,116,105,1,defense
FRA-Ligue 1,2022,Lorient,Vito Mannone,ITA,GK,34,1988,17.9,0,0,0,0,0,0,0,,0,0,0,0,0,0,4,3,defense
FRA-Ligue 1,2022,Lorient,Yoann Cathline,FRA,"FW,MF",20,2002,12.1,19,12,7,6,6,5,12,41.7,7,10,1,9,8,27,16,1,defense
FRA-Ligue 1,2022,Lorient,Yvon Mvogo,SUI,GK,28,1994,20.1,0,0,0,0,0,0,0,,0,0,0,0,2,2,6,3,defense
FRA-Ligue 1,2022,Lyon,Alexandre Lacazette,FRA,FW,31,1991,32.5,43,23,7,17,19,10,29,34.5,19,23,3,20,15,58,4,0,defense
FRA-Ligue 1,2022,Lyon,Amin Sarr,SWE,FW,21,2001,6.0,9,6,1,4,4,1,4,25.0,3,2,0,2,0,9,4,0,defense
FRA-Ligue 1,2022,Lyon,Anthony Lopes,POR,GK,31,1990,31.3,1,0,1,0,0,1,4,25.0,3,0,0,0,3,4,10,0,defense
FRA-Ligue 1,2022,Lyon,Bradley Barcola,FRA,"FW,MF",19,2002,16.0,25,16,8,10,7,8,39,20.5,31,29,0,29,19,44,10,0,defense
FRA-Ligue 1,2022,Lyon,Castello Lukeba,FRA,DF,19,2002,33.2,39,23,27,8,4,21,31,67.7,10,42,24,18,75,114,105,1,defense
FRA-Ligue 1,2022,Lyon,Corentin Tolisso,FRA,MF,27,1994,22.6,44,27,16,23,5,25,66,37.9,41,25,5,20,24,68,23,1,defense
FRA-Ligue 1,2022,Lyon,Damien Da Silva,FRA,DF,34,1988,3.8,8,7,5,3,0,3,3,100.0,0,4,3,1,5,13,12,0,defense
FRA-Ligue 1,2022,Lyon,Dejan Lovren,CRO,DF,33,1989,16.2,25,19,20,5,0,20,29,69.0,9,20,10,10,26,51,70,1,defense
FRA-Ligue 1,2022,Lyon,Henrique,BRA,"DF,FW",28,1994,4.0,9,4,3,2,4,6,13,46.2,7,3,1,2,5,14,8,0,defense
FRA-Ligue 1,2022,Lyon,Houssem Aouar,ALG,MF,24,1998,5.8,12,5,5,5,2,3,9,33.3,6,12,2,10,8,20,3,0,defense
FRA-Ligue 1,2022,Lyon,Jeff Reine-Adélaïde,FRA,MF,24,1998,3.7,8,5,1,5,2,5,9,55.6,4,4,0,4,6,14,0,0,defense
FRA-Ligue 1,2022,Lyon,Jeffinho,BRA,FW,22,1999,5.0,17,4,4,9,4,6,15,40.0,9,6,0,6,1,18,0,0,defense
FRA-Ligue 1,2022,Lyon,Johann Lepenant,FRA,MF,19,2002,21.5,58,34,24,27,7,32,86,37.2,54,29,5,24,28,86,17,3,defense
FRA-Ligue 1,2022,Lyon,Jérôme Boateng,GER,DF,33,1988,4.8,3,0,2,1,0,2,6,33.3,4,8,5,3,6,9,16,0,defense
FRA-Ligue 1,2022,Lyon,Karl Toko Ekambi,CMR,"FW,MF",29,1992,15.0,9,9,2,4,3,4,15,26.7,11,12,2,10,9,18,6,0,defense
FRA-Ligue 1,2022,Lyon,Lucas Paquetá,BRA,MF,24,1997,1.8,5,4,0,5,0,1,3,33.3,2,2,0,2,1,6,3,0,defense
FRA-Ligue 1,2022,Lyon,Malo Gusto,FRA,DF,19,2003,17.7,42,26,23,11,8,21,43,48.8,22,22,5,17,28,70,23,1,defense
FRA-Ligue 1,2022,Lyon,Mamadou Sarr,FRA,MF,16,2005,0.1,0,0,0,0,0,0,0,,0,0,0,0,0,0,0,0,defense
FRA-Ligue 1,2022,Lyon,Maxence Caqueret,FRA,MF,22,2000,30.7,87,54,27,38,22,43,109,39.4,66,45,3,42,39,126,27,0,defense
FRA-Ligue 1,2022,Lyon,Mohamed El Arouch,FRA,MF,18,2004,0.0,1,1,1,0,0,0,0,,0,0,0,0,0,1,0,0,defense
FRA-Ligue 1,2022,Lyon,Moussa Dembélé,FRA,"FW,MF",26,1996,9.7,8,4,3,3,2,4,7,57.1,3,5,0,5,2,10,6,0,defense
FRA-Ligue 1,2022,Lyon,Nicolás Tagliafico,ARG,DF,29,1992,33.2,91,53,36,41,14,50,78,64.1,28,45,11,34,57,148,47,0,defense
FRA-Ligue 1,2022,Lyon,Rayan Cherki,FRA,"MF,FW",18,2003,20.8,14,8,2,5,7,8,23,34.8,15,6,0,6,5,19,1,0,defense
FRA-Ligue 1,2022,Lyon,Romain Faivre,FRA,MF,24,1998,3.3,6,3,2,2,2,1,3,33.3,2,3,0,3,0,6,0,0,defense
FRA-Ligue 1,2022,Lyon,Rémy Riou,FRA,GK,34,1987,6.7,1,0,1,0,0,1,1,100.0,0,0,0,0,0,1,3,0,defense
FRA-Ligue 1,2022,Lyon,Sael Kumbedi,FRA,DF,17,2005,14.7,47,27,27,13,7,20,38,52.6,18,23,7,16,10,57,16,0,defense
FRA-Ligue 1,2022,Lyon,Sinaly Diomande,CIV,DF,21,2001,21.7,42,24,26,15,1,31,49,63.3,18,26,13,13,49,91,75,1,defense
FRA-Ligue 1,2022,Lyon,Tetê,BRA,"FW,MF",22,2000,12.3,21,10,8,5,8,10,19,52.6,9,9,0,9,13,34,2,0,defense
FRA-Ligue 1,2022,Lyon,Thiago Mendes,BRA,"MF,DF",30,1992,22.9,48,27,24,21,3,30,40,75.0,10,28,8,20,47,95,51,4,defense
FRA-Ligue 1,2022,Marseille,Alexis Sánchez,CHI,"FW,MF",33,1988,29.8,27,17,5,16,6,3,24,12.5,21,14,0,14,5,32,6,0,defense
FRA-Ligue 1,2022,Marseille,Amine Harit,MAR,"MF,FW",25,1997,5.7,6,4,0,3,3,3,8,37.5,5,4,1,3,4,10,6,0,defense
FRA-Ligue 1,2022,Marseille,Arkadiusz Milik,POL,FW,28,1994,1.4,1,1,0,0,1,0,1,0.0,1,0,0,0,0,1,2,0,defense
FRA-Ligue 1,2022,Marseille,Azzedine Ounahi,MAR,"MF,FW",22,2000,1.3,2,1,1,1,0,0,2,0.0,2,1,0,1,0,2,0,0,defense
FRA-Ligue 1,2022,Marseille,Bamba Dieng,SEN,"FW,MF",22,2000,2.2,4,4,2,1,1,3,4,75.0,1,5,1,4,0,4,0,0,defense
FRA-Ligue 1,2022,Marseille,Cengiz Ünder,TUR,"MF,DF",25,1997,27.7,37,19,15,13,9,13,34,38.2,21,18,2,16,18,55,13,0,defense
FRA-Ligue 1,2022,Marseille,Chancel Mbemba,COD,DF,27,1994,31.7,43,26,24,17,2,22,31,71.0,9,25,12,13,42,85,89,0,defense
FRA-Ligue 1,2022,Marseille,Cédric Bakambu,COD,MF,31,1991,0.7,2,1,2,0,0,2,2,100.0,0,0,0,0,0,2,0,0,defense
FRA-Ligue 1,2022,Marseille,Dimitri Payet,FRA,"MF,FW",35,1987,9.3,6,4,2,2,2,3,11,27.3,8,4,0,4,0,6,4,0,defense
FRA-Ligue 1,2022,Marseille,Duje Ćaleta-Car,CRO,DF,25,1996,0.1,0,0,0,0,0,0,0,,0,0,0,0,0,0,1,0,defense
FRA-Ligue 1,2022,Marseille,Eric Bailly,CIV,DF,28,1994,6.0,13,10,6,6,1,7,7,100.0,0,15,12,3,12,25,18,1,defense
FRA-Ligue 1,2022,Marseille,François Mughe,CMR,MF,18,2004,0.1,0,0,0,0,0,0,0,,0,0,0,0,0,0,0,0,defense
FRA-Ligue 1,2022,Marseille,Gerson,BRA,MF,25,1997,4.6,6,4,1,4,1,3,5,60.0,2,5,0,5,2,8,4,0,defense
FRA-Ligue 1,2022,Marseille,Issa Kaboré,BFA,DF,21,2001,11.4,33,19,10,18,5,21,32,65.6,11,11,1,10,12,45,21,1,defense
FRA-Ligue 1,2022,Marseille,Jonathan Clauss,FRA,DF,29,1992,28.8,46,28,21,16,9,23,52,44.2,29,29,4,25,31,77,40,2,defense
FRA-Ligue 1,2022,Marseille,Jordan Veretout,FRA,MF,29,1993,31.8,56,35,17,32,7,25,53,47.2,28,22,7,15,36,92,40,2,defense
FRA-Ligue 1,2022,Marseille,Leonardo Balerdi,ARG,DF,23,1999,29.3,57,37,43,12,2,32,45,71.1,13,48,29,19,63,120,91,1,defense
FRA-Ligue 1,2022,Marseille,Luis Javier Suárez,COL,FW,24,1997,3.3,4,1,1,2,1,1,4,25.0,3,1,0,1,3,7,6,0,defense
FRA-Ligue 1,2022,Marseille,Mattéo Guendouzi,FRA,MF,23,1999,23.4,39,18,9,21,9,14,38,36.8,24,12,5,7,21,60,18,0,defense
FRA-Ligue 1,2022,Marseille,Nuno Tavares,POR,"DF,MF",22,2000,26.1,56,30,19,24,13,28,56,50.0,28,32,4,28,15,71,25,0,defense
FRA-Ligue 1,2022,Marseille,Pape Gueye,SEN,"MF,DF",23,1999,5.5,18,7,10,7,1,7,15,46.7,8,9,2,7,9,27,2,0,defense
FRA-Ligue 1,2022,Marseille,Pau López,ESP,GK,27,1994,32.5,0,0,0,0,0,0,1,0.0,1,0,0,0,0,0,5,1,defense
FRA-Ligue 1,2022,Marseille,Rubén Blanco,ESP,GK,27,1995,5.5,0,0,0,0,0,0,0,,0,0,0,0,0,0,1,0,defense
FRA-Ligue 1,2022,Marseille,Ruslan Malinovskyi,UKR,"MF,FW",29,1993,13.6,21,11,3,12,6,10,26,38.5,16,13,1,12,3,24,9,0,defense
FRA-Ligue 1,2022,Marseille,Salim Ben Seghir,FRA,MF,19,2003,0.0,0,0,0,0,0,0,0,,0,1,0,1,0,0,0,0,defense
FRA-Ligue 1,2022,Marseille,Samuel Gigot,FRA,DF,28,1993,20.9,46,24,22,21,3,12,15,80.0,3,24,7,17,45,91,85,1,defense
FRA-Ligue 1,2022,Marseille,Sead Kolašinac,BIH,DF,29,1993,24.6,52,36,24,22,6,24,37,64.9,13,19,2,17,43,95,35,1,defense
FRA-Ligue 1,2022,Marseille,Souleymane Touré,FRA,DF,19,2003,0.8,2,1,1,1,0,1,2,50.0,1,1,0,1,0,2,5,0,defense
FRA-Ligue 1,2022,Marseille,Valentin Rongier,FRA,MF,27,1994,33.7,93,59,33,47,13,41,77,53.2,36,50,11,39,54,147,38,1,defense
FRA-Ligue 1,2022,Marseille,Vitinha,POR,FW,22,2000,5.2,15,7,0,6,9,3,11,27.3,8,3,0,3,2,17,6,0,defense
FRA-Ligue 1,2022,Monaco,Aleksandr Golovin,RUS,"MF,FW",26,1996,27.4,62,36,19,32,11,28,72,38.9,44,28,1,27,37,99,10,0,defense
FRA-Ligue 1,2022,Monaco,Alexander Nübel,GER,GK,25,1996,38.0,0,0,0,0,0,0,1,0.0,1,0,0,0,1,1,10,3,defense
FRA-Ligue 1,2022,Monaco,Axel Disasi,FRA,DF,24,1998,37.0,30,20,13,13,4,13,27,48.1,14,51,31,20,56,86,112,2,defense
FRA-Ligue 1,2022,Monaco,Benoît Badiashile,FRA,DF,21,2001,9.3,10,8,6,4,0,5,10,50.0,5,9,6,3,17,27,40,1,defense
FRA-Ligue 1,2022,Monaco,Breel Embolo,SUI,FW,25,1997,20.7,15,9,2,7,6,5,10,50.0,5,14,3,11,5,20,12,0,defense
FRA-Ligue 1,2022,Monaco,Caio Henrique Oliveira Silva,BRA,DF,25,1997,32.2,74,51,42,28,4,44,76,57.9,32,28,8,20,26,100,68,1,defense
FRA-Ligue 1,2022,Monaco,Chrislain Matsima,FRA,DF,20,2002,5.0,11,6,7,2,2,4,7,57.1,3,5,5,0,9,20,16,0,defense
FRA-Ligue 1,2022,Monaco,Edan Diop,FRA,"DF,FW",17,2004,2.5,13,8,3,3,7,7,15,46.7,8,7,1,6,4,17,1,0,defense
FRA-Ligue 1,2022,Monaco,Eliesse Ben Seghir,MAR,"FW,MF",17,2005,11.7,18,10,4,12,2,4,12,33.3,8,18,1,17,4,22,1,0,defense
FRA-Ligue 1,2022,Monaco,Eliot Matazo,BEL,MF,20,2002,13.1,26,12,11,13,2,11,26,42.3,15,18,4,14,15,41,11,1,defense
FRA-Ligue 1,2022,Monaco,Gelson Martins,POR,"MF,FW",27,1995,3.8,15,8,6,4,5,4,13,30.8,9,4,1,3,3,18,2,0,defense
FRA-Ligue 1,2022,Monaco,Guillermo Maripán,CHI,DF,28,1994,24.0,46,26,26,20,0,17,33,51.5,16,39,27,12,38,84,87,0,defense
FRA-Ligue 1,2022,Monaco,Ismail Jakobs,SEN,"DF,FW",22,1999,12.4,11,5,7,3,1,5,12,41.7,7,9,1,8,9,20,18,0,defense
FRA-Ligue 1,2022,Monaco,Jean Lucas,BRA,MF,24,1998,3.2,9,5,3,5,1,6,12,50.0,6,2,1,1,4,13,2,0,defense
FRA-Ligue 1,2022,Monaco,Kevin Volland,GER,"FW,MF",30,1992,7.1,8,4,1,5,2,2,8,25.0,6,8,0,8,2,10,0,0,defense
FRA-Ligue 1,2022,Monaco,Krépin Diatta,SEN,"MF,FW",23,1999,23.0,30,21,4,17,9,13,32,40.6,19,29,1,28,17,47,12,0,defense
FRA-Ligue 1,2022,Monaco,Maghnes Akliouche,FRA,"MF,FW",20,2002,4.5,7,4,4,3,0,2,8,25.0,6,2,0,2,3,10,2,0,defense
FRA-Ligue 1,2022,Monaco,Malang Sarr,FRA,DF,23,1999,8.0,6,3,5,1,0,1,5,20.0,4,11,7,4,15,21,29,2,defense
FRA-Ligue 1,2022,Monaco,Mohamed Camara,MLI,MF,22,2000,24.4,83,45,38,39,6,48,92,52.2,44,45,6,39,27,110,14,1,defense
FRA-Ligue 1,2022,Monaco,Myron Boadu,NED,FW,21,2001,3.3,3,3,0,2,1,1,7,14.3,6,1,0,1,0,3,1,0,defense
FRA-Ligue 1,2022,Monaco,Ruben Aguilar,FRA,DF,29,1993,13.0,19,9,7,7,5,8,22,36.4,14,13,1,12,18,37,28,1,defense
FRA-Ligue 1,2022,Monaco,Sofiane Diop,FRA,MF,22,2000,0.7,0,0,0,0,0,0,0,,0,0,0,0,1,1,0,0,defense
FRA-Ligue 1,2022,Monaco,Soungoutou Magassa,FRA,MF,18,2003,0.9,4,1,2,2,0,2,4,50.0,2,3,0,3,1,5,1,0,defense
FRA-Ligue 1,2022,Monaco,Takumi Minamino,JPN,"MF,FW",27,1995,8.0,15,8,5,7,3,7,35,20.0,28,14,0,14,6,21,4,0,defense
FRA-Ligue 1,2022,Monaco,Vanderson,BRA,"DF,MF",21,2001,24.6,84,48,36,34,14,44,75,58.7,31,36,9,27,48,132,36,1,defense
FRA-Ligue 1,2022,Monaco,Wissam Ben Yedder,FRA,FW,31,1990,23.5,16,9,2,5,9,4,13,30.8,9,15,0,15,4,20,0,0,defense
FRA-Ligue 1,2022,Monaco,Youssouf Fofana,FRA,MF,23,1999,34.3,81,41,31,42,8,38,74,51.4,36,50,6,44,56,137,32,1,defense
FRA-Ligue 1,2022,Montpellier,Arnaud Nordin,FRA,FW,24,1998,26.7,26,14,10,12,4,12,28,42.9,16,19,1,18,14,40,7,0,defense
FRA-Ligue 1,2022,Montpellier,Arnaud Souquet,FRA,"DF,FW",30,1992,4.0,22,16,13,7,2,11,14,78.6,3,8,3,5,4,26,4,0,defense
FRA-Ligue 1,2022,Montpellier,Axel Gueguin,FRA,"FW,MF",17,2005,0.3,0,0,0,0,0,0,0,,0,1,0,1,0,0,0,0,defense
FRA-Ligue 1,2022,Montpellier,Benjamin Lecomte,FRA,GK,31,1991,19.0,0,0,0,0,0,0,2,0.0,2,0,0,0,0,0,6,0,defense
FRA-Ligue 1,2022,Montpellier,Bingourou Kamara,SEN,GK,25,1996,4.5,0,0,0,0,0,0,0,,0,0,0,0,0,0,2,0,defense
FRA-Ligue 1,2022,Montpellier,Boubakar Kouyaté,MLI,DF,25,1997,14.0,31,18,18,11,2,19,35,54.3,16,24,14,10,34,65,73,1,defense
FRA-Ligue 1,2022,Montpellier,Béni Makouana,CGO,"FW,MF",19,2002,2.2,1,0,0,1,0,0,2,0.0,2,3,1,2,0,1,1,0,defense
FRA-Ligue 1,2022,Montpellier,Cheikh Faye,SEN,FW,23,1999,0.4,0,0,0,0,0,0,0,,0,0,0,0,1,1,0,0,defense
FRA-Ligue 1,2022,Montpellier,Christopher Jullien,FRA,DF,29,1993,29.9,46,28,29,14,3,28,51,54.9,23,35,18,17,43,89,114,1,defense
FRA-Ligue 1,2022,Montpellier,Elye Wahi,FRA,FW,19,2003,27.9,9,3,2,3,4,5,14,35.7,9,14,2,12,3,12,5,0,defense
FRA-Ligue 1,2022,Montpellier,Enzo Tchato,CMR,DF,19,2002,12.2,26,17,14,11,1,13,22,59.1,9,17,2,15,7,33,33,0,defense
FRA-Ligue 1,2022,Montpellier,Faitout Maouassa,FRA,"FW,DF",24,1998,21.4,52,32,26,20,6,18,41,43.9,23,31,3,28,20,72,23,0,defense
FRA-Ligue 1,2022,Montpellier,Falaye Sacko,MLI,DF,27,1995,28.7,46,25,25,15,6,32,51,62.7,19,43,14,29,33,79,75,1,defense
FRA-Ligue 1,2022,Montpellier,Issiaga Sylla,GUI,DF,28,1994,14.5,28,16,19,8,1,15,31,48.4,16,19,3,16,32,60,35,0,defense
FRA-Ligue 1,2022,Montpellier,Jonas Omlin,SUI,GK,28,1994,13.0,1,0,1,0,0,0,0,,0,0,0,0,0,1,8,1,defense
FRA-Ligue 1,2022,Montpellier,Jordan Ferri,FRA,MF,30,1992,30.4,55,35,32,19,4,30,89,33.7,59,22,6,16,26,81,21,0,defense
FRA-Ligue 1,2022,Montpellier,Joris Chotard,FRA,MF,20,2001,27.3,64,34,37,23,4,40,78,51.3,38,40,11,29,40,104,42,1,defense
FRA-Ligue 1,2022,Montpellier,Khalil Fayad,FRA,MF,18,2004,8.0,30,14,12,16,2,12,21,57.1,9,8,1,7,9,39,4,0,defense
FRA-Ligue 1,2022,Montpellier,Léo Leroy,FRA,MF,22,2000,13.2,53,38,24,26,3,31,57,54.4,26,25,2,23,14,67,8,0,defense
FRA-Ligue 1,2022,Montpellier,Mamadou Sakho,FRA,DF,32,1990,8.5,9,5,4,5,0,3,5,60.0,2,17,12,5,8,17,35,1,defense
FRA-Ligue 1,2022,Montpellier,Matis Carvalho,POR,GK,23,1999,1.5,0,0,0,0,0,0,0,,0,0,0,0,1,1,0,0,defense
FRA-Ligue 1,2022,Montpellier,Maxime Estève,FRA,DF,20,2002,18.3,24,13,17,5,2,12,17,70.6,5,28,17,11,34,58,90,0,defense
FRA-Ligue 1,2022,Montpellier,Nicolas Cozza,FRA,DF,23,1999,14.2,38,21,27,9,2,26,38,68.4,12,11,5,6,21,59,35,1,defense
FRA-Ligue 1,2022,Montpellier,Pedro Mendes,POR,DF,31,1990,0.1,0,0,0,0,0,0,0,,0,0,0,0,0,0,0,1,defense
FRA-Ligue 1,2022,Montpellier,Sacha Delaye,FRA,"FW,MF",20,2002,0.2,1,0,0,0,1,1,1,100.0,0,0,0,0,0,1,0,0,defense
FRA-Ligue 1,2022,Montpellier,Stephy Mavididi,ENG,FW,24,1998,14.3,24,19,12,8,4,13,27,48.1,14,21,1,20,4,28,10,0,defense
FRA-Ligue 1,2022,Montpellier,Thibault Tamas,FRA,DF,21,2001,0.1,0,0,0,0,0,0,0,,0,0,0,0,1,1,0,0,defense
FRA-Ligue 1,2022,Montpellier,Théo Sainte-Luce,FRA,DF,23,1998,5.9,13,11,8,5,0,7,14,50.0,7,7,2,5,10,23,11,0,defense
FRA-Ligue 1,2022,Montpellier,Téji Savanier,FRA,MF,30,1991,28.3,46,30,16,19,11,23,70,32.9,47,30,2,28,30,76,12,1,defense
FRA-Ligue 1,2022,Montpellier,Valère Germain,FRA,"FW,MF",32,1990,7.6,13,11,3,5,5,4,12,33.3,8,8,0,8,6,19,12,0,defense
FRA-Ligue 1,2022,Montpellier,Wahbi Khazri,TUN,"FW,MF",31,1991,18.2,26,13,13,7,6,6,25,24.0,19,17,1,16,9,35,20,0,defense
FRA-Ligue 1,2022,Nantes,Abdoul Kader Bamba,FRA,"FW,MF",28,1994,0.9,0,0,0,0,0,0,2,0.0,2,3,1,2,0,0,1,0,defense
FRA-Ligue 1,2022,Nantes,Alban Lafont,FRA,GK,23,1999,37.0,0,0,0,0,0,0,1,0.0,1,0,0,0,0,0,20,4,defense
FRA-Ligue 1,2022,Nantes,Andrei Girotto,BRA,"DF,MF",30,1992,35.0,122,73,71,45,6,74,132,56.1,58,55,24,31,73,195,176,1,defense
FRA-Ligue 1,2022,Nantes,Andy Delort,ALG,FW,30,1991,5.2,5,4,1,2,2,2,6,33.3,4,3,0,3,0,5,2,0,defense
FRA-Ligue 1,2022,Nantes,Charles Traore,MLI,DF,30,1992,5.4,8,5,5,2,1,5,7,71.4,2,9,2,7,10,18,12,0,defense
FRA-Ligue 1,2022,Nantes,Dennis Appiah,FRA,"DF,MF",30,1992,8.8,21,11,14,7,0,10,27,37.0,17,13,5,8,10,31,16,0,defense
FRA-Ligue 1,2022,Nantes,Evann Guessand,CIV,"FW,MF",21,2001,14.0,24,16,8,13,3,6,12,50.0,6,17,1,16,9,33,6,0,defense
FRA-Ligue 1,2022,Nantes,Fabien Centonze,FRA,DF,26,1996,18.8,58,37,30,22,6,30,42,71.4,12,24,7,17,44,102,55,1,defense
FRA-Ligue 1,2022,Nantes,Florent Mollet,FRA,MF,30,1991,12.1,14,6,5,4,5,7,24,29.2,17,12,1,11,10,24,11,0,defense
FRA-Ligue 1,2022,Nantes,Fábio,BRA,"DF,MF",32,1990,2.5,4,2,1,2,1,4,6,66.7,2,2,0,2,3,7,11,0,defense
FRA-Ligue 1,2022,Nantes,Ignatius Ganago,CMR,"FW,MF",23,1999,16.9,9,7,2,3,4,4,7,57.1,3,13,1,12,2,11,12,0,defense
FRA-Ligue 1,2022,Nantes,Jaouen Hadjam,ALG,DF,19,2003,8.9,27,21,13,9,5,16,25,64.0,9,10,3,7,12,39,12,0,defense
FRA-Ligue 1,2022,Nantes,Jean-Charles Castelletto,CMR,DF,27,1995,28.5,43,26,29,12,2,22,36,61.1,14,35,22,13,58,101,90,0,defense
FRA-Ligue 1,2022,Nantes,João Victor,BRA,DF,24,1998,9.4,19,11,9,7,3,12,22,54.5,10,11,1,10,15,34,30,0,defense
FRA-Ligue 1,2022,Nantes,Lohann Doucet,FRA,"MF,FW",19,2002,1.0,3,0,2,0,1,3,4,75.0,1,2,0,2,2,5,4,0,defense
FRA-Ligue 1,2022,Nantes,Ludovic Blas,FRA,"MF,FW",24,1997,31.3,47,30,17,19,11,17,49,34.7,32,26,1,25,19,66,8,0,defense
FRA-Ligue 1,2022,Nantes,Marcus Coco,FRA,"FW,MF",26,1996,7.1,24,15,11,9,4,11,23,47.8,12,13,3,10,14,38,7,0,defense
FRA-Ligue 1,2022,Nantes,Mohamed Achi,FRA,FW,20,2002,0.4,1,1,1,0,0,1,1,100.0,0,0,0,0,0,1,0,0,defense
FRA-Ligue 1,2022,Nantes,Moses Simon,NGA,"FW,MF",27,1995,26.1,18,9,6,7,5,7,15,46.7,8,14,1,13,11,29,3,0,defense
FRA-Ligue 1,2022,Nantes,Mostafa Mohamed,EGY,FW,24,1997,21.5,18,13,5,7,6,9,20,45.0,11,23,1,22,10,28,33,0,defense
FRA-Ligue 1,2022,Nantes,Moussa Sissoko,FRA,MF,32,1989,21.3,26,16,16,7,3,12,18,66.7,6,22,5,17,16,42,17,0,defense
FRA-Ligue 1,2022,Nantes,Nathan Zeze,FRA,DF,17,2005,0.7,3,2,2,1,0,1,1,100.0,0,0,0,0,0,3,1,0,defense
FRA-Ligue 1,2022,Nantes,Nicolas Pallois,FRA,DF,34,1987,24.6,69,44,51,16,2,42,70,60.0,28,35,18,17,30,99,131,2,defense
FRA-Ligue 1,2022,Nantes,Pedro Chirivella,ESP,MF,25,1997,22.5,33,22,12,15,6,17,44,38.6,27,24,1,23,20,53,7,0,defense
FRA-Ligue 1,2022,Nantes,Quentin Merlin,FRA,DF,20,2002,19.9,31,19,19,8,4,18,38,47.4,20,27,4,23,24,55,30,0,defense
FRA-Ligue 1,2022,Nantes,Rémy Descamps,FRA,GK,26,1996,1.0,0,0,0,0,0,0,0,,0,0,0,0,0,0,0,0,defense
FRA-Ligue 1,2022,Nantes,Samuel Moutoussamy,COD,MF,25,1996,26.7,64,34,27,28,9,26,76,34.2,50,23,2,21,24,88,15,0,defense
FRA-Ligue 1,2022,Nantes,Stredair Appuah,FRA,"DF,MF",18,2004,0.7,2,1,0,2,0,0,0,,0,2,0,2,1,3,0,0,defense
FRA-Ligue 1,2022,Nantes,Sébastien Corchia,FRA,DF,31,1990,8.7,16,6,10,2,4,11,22,50.0,11,9,3,6,14,30,21,0,defense
FRA-Ligue 1,2022,Nice,Aaron Ramsey,WAL,MF,31,1990,17.6,47,25,18,19,10,16,39,41.0,23,25,4,21,17,64,18,1,defense
FRA-Ligue 1,2022,Nice,Alexis Beka Beka,FRA,"MF,DF",21,2001,6.1,16,5,6,9,1,4,15,26.7,11,9,1,8,12,28,6,0,defense
FRA-Ligue 1,2022,Nice,Alexis Claude-Maurice,FRA,FW,24,1998,0.7,3,2,2,1,0,3,3,100.0,0,0,0,0,2,5,1,0,defense
FRA-Ligue 1,2022,Nice,Amine Gouiri,ALG,"FW,MF",22,2000,2.5,1,1,1,0,0,0,1,0.0,1,1,0,1,0,1,3,0,defense
FRA-Ligue 1,2022,Nice,Andréa Dacourt,FRA,MF,17,2005,0.0,0,0,0,0,0,0,0,,0,0,0,0,0,0,0,0,defense
FRA-Ligue 1,2022,Nice,Andy Delort,ALG,FW,30,1991,8.7,2,0,1,1,0,1,2,50.0,1,0,0,0,1,3,7,0,defense
FRA-Ligue 1,2022,Nice,Antoine Mendy,SEN,DF,18,2004,5.8,22,13,16,5,1,9,15,60.0,6,6,1,5,2,24,16,0,defense
FRA-Ligue 1,2022,Nice,Ayoub Amraoui,MAR,"DF,FW",18,2004,3.3,6,5,3,3,0,2,5,40.0,3,1,0,1,4,10,4,0,defense
FRA-Ligue 1,2022,Nice,Badredine Bouanani,ALG,"FW,MF",17,2004,9.6,13,9,2,7,4,7,14,50.0,7,4,0,4,1,14,2,0,defense
FRA-Ligue 1,2022,Nice,Bilal Brahimi,ALG,"FW,MF",22,2000,8.9,8,5,2,5,1,1,7,14.3,6,4,0,4,4,12,0,0,defense
FRA-Ligue 1,2022,Nice,Calvin Stengs,NED,FW,23,1998,2.4,2,2,1,0,1,1,2,50.0,1,0,0,0,0,2,0,0,defense
FRA-Ligue 1,2022,Nice,Dante,BRA,DF,38,1983,36.7,70,40,45,21,4,36,59,61.0,23,52,31,21,47,117,125,2,defense
FRA-Ligue 1,2022,Nice,Flavius Daniliuc,AUT,DF,21,2001,1.0,2,0,2,0,0,1,1,100.0,0,4,1,3,0,2,1,0,defense
FRA-Ligue 1,2022,Nice,Gaëtan Laborde,FRA,FW,28,1994,27.8,45,25,13,17,15,18,40,45.0,22,27,2,25,9,54,13,0,defense
FRA-Ligue 1,2022,Nice,Hicham Boudaoui,ALG,MF,22,1999,20.8,67,32,31,30,6,35,53,66.0,18,34,5,29,36,103,16,0,defense
FRA-Ligue 1,2022,Nice,Jean-Clair Todibo,FRA,DF,22,1999,31.9,76,48,54,19,3,41,56,73.2,15,41,19,22,41,117,110,2,defense
FRA-Ligue 1,2022,Nice,Joe Bryan,ENG,"MF,DF",28,1993,2.0,5,4,3,2,0,4,4,100.0,0,2,0,2,1,6,1,0,defense
FRA-Ligue 1,2022,Nice,Jordan Lotomba,SUI,DF,23,1998,27.3,65,38,33,24,8,31,48,64.6,17,38,11,27,32,97,53,0,defense
FRA-Ligue 1,2022,Nice,Kasper Schmeichel,DEN,GK,35,1986,36.0,1,0,1,0,0,1,4,25.0,3,1,0,1,1,2,11,1,defense
FRA-Ligue 1,2022,Nice,Khéphren Thuram,FRA,MF,21,2001,28.3,51,25,22,23,6,19,43,44.2,24,33,13,20,38,89,34,0,defense
FRA-Ligue 1,2022,Nice,Marcin Bułka,POL,GK,22,1999,2.0,0,0,0,0,0,0,1,0.0,1,0,0,0,1,1,0,0,defense
FRA-Ligue 1,2022,Nice,Mario Lemina,GAB,"MF,DF",28,1993,9.3,32,21,11,14,7,12,18,66.7,6,13,5,8,11,43,20,0,defense
FRA-Ligue 1,2022,Nice,Mattia Viti,ITA,DF,20,2002,7.0,4,2,1,1,2,2,5,40.0,3,9,3,6,8,12,22,0,defense
FRA-Ligue 1,2022,Nice,Melvin Bard,FRA,DF,21,2000,27.3,96,60,61,29,6,59,89,66.3,30,35,4,31,64,160,40,1,defense
FRA-Ligue 1,2022,Nice,Nicolas Pépé,CIV,"FW,MF",27,1995,16.6,25,13,14,5,6,11,25,44.0,14,17,0,17,3,28,1,0,defense
FRA-Ligue 1,2022,Nice,Pablo Rosario,NED,"MF,DF",25,1997,19.6,46,26,22,20,4,18,34,52.9,16,15,5,10,23,69,32,1,defense
FRA-Ligue 1,2022,Nice,Rareş Ilie,ROU,"MF,FW",19,2003,1.6,3,3,0,1,2,2,4,50.0,2,2,0,2,1,4,1,0,defense
FRA-Ligue 1,2022,Nice,Reda Belahyane,MAR,MF,18,2004,2.0,8,6,5,3,0,3,5,60.0,2,5,1,4,2,10,0,0,defense
FRA-Ligue 1,2022,Nice,Ross Barkley,ENG,"MF,FW",28,1993,10.7,16,9,7,4,5,7,13,53.8,6,7,2,5,8,24,6,0,defense
FRA-Ligue 1,2022,Nice,Sofiane Diop,FRA,"MF,FW",22,2000,13.6,23,11,12,6,5,7,20,35.0,13,14,2,12,16,39,5,0,defense
FRA-Ligue 1,2022,Nice,Terem Moffi,NGA,FW,23,1999,14.8,12,6,0,6,6,2,12,16.7,10,3,0,3,2,14,5,0,defense
FRA-Ligue 1,2022,Nice,Théo Trinker,FRA,MF,21,2001,0.0,0,0,0,0,0,0,0,,0,0,0,0,0,0,0,0,defense
FRA-Ligue 1,2022,Nice,Youcef Atal,ALG,"DF,MF",26,1996,8.7,38,22,18,15,5,23,32,71.9,9,9,0,9,14,52,13,0,defense
FRA-Ligue 1,2022,Nice,Youssouf Ndayishimiye,BDI,"MF,DF",23,1998,6.3,13,9,8,5,0,6,11,54.5,5,8,5,3,12,25,22,1,defense
FRA-Ligue 1,2022,Paris S-G,Achraf Hakimi,MAR,"DF,MF",23,1998,22.8,54,34,19,20,15,31,59,52.5,28,34,2,32,16,70,19,0,defense
FRA-Ligue 1,2022,Paris S-G,Alexandre Letellier,FRA,GK,31,1990,0.1,0,0,0,0,0,0,0,,0,0,0,0,0,0,0,0,defense
FRA-Ligue 1,2022,Paris S-G,Carlos Soler,ESP,MF,25,1997,13.2,20,12,6,10,4,10,19,52.6,9,12,4,8,4,24,6,0,defense
FRA-Ligue 1,2022,Paris S-G,Danilo Pereira,POR,"DF,MF",30,1991,26.8,32,17,15,14,3,19,26,73.1,7,26,19,7,36,68,59,1,defense
FRA-Ligue 1,2022,Paris S-G,El Chadaille Bitshiabu,FRA,DF,17,2005,6.5,10,7,7,2,1,3,12,25.0,9,9,7,2,9,19,13,3,defense
FRA-Ligue 1,2022,Paris S-G,Fabián Ruiz Peña,ESP,MF,26,1996,21.0,62,28,25,30,7,43,79,54.4,36,24,1,23,18,80,23,1,defense
FRA-Ligue 1,2022,Paris S-G,Gianluigi Donnarumma,ITA,GK,23,1999,37.9,1,0,1,0,0,1,2,50.0,1,0,0,0,0,1,12,4,defense
FRA-Ligue 1,2022,Paris S-G,Hugo Ekitike,FRA,FW,20,2002,12.8,12,4,1,10,1,4,12,33.3,8,12,0,12,9,21,3,0,defense
FRA-Ligue 1,2022,Paris S-G,Ilyes Housni,FRA,FW,17,2005,0.1,1,1,1,0,0,1,1,100.0,0,0,0,0,0,1,0,0,defense
FRA-Ligue 1,2022,Paris S-G,Ismaël Gharbi,ESP,"MF,FW",18,2004,0.6,0,0,0,0,0,0,2,0.0,2,2,0,2,3,3,0,0,defense
FRA-Ligue 1,2022,Paris S-G,Juan Bernat,ESP,"DF,MF",29,1993,18.3,32,16,18,9,5,21,39,53.8,18,11,2,9,9,41,22,1,defense
FRA-Ligue 1,2022,Paris S-G,Kylian Mbappé,FRA,FW,23,1998,31.3,10,4,0,5,5,5,16,31.3,11,5,0,5,5,15,6,0,defense
FRA-Ligue 1,2022,Paris S-G,Leandro Paredes,ARG,MF,28,1994,0.6,1,1,1,0,0,1,1,100.0,0,2,1,1,1,2,0,0,defense
FRA-Ligue 1,2022,Paris S-G,Lionel Messi,ARG,"FW,MF",35,1987,31.5,26,18,1,13,12,11,27,40.7,16,11,0,11,2,28,0,0,defense
FRA-Ligue 1,2022,Paris S-G,Marco Verratti,ITA,MF,29,1992,24.4,76,49,34,36,6,38,89,42.7,51,42,6,36,27,103,11,3,defense
FRA-Ligue 1,2022,Paris S-G,Marquinhos,BRA,DF,28,1994,30.2,33,25,18,12,3,18,26,69.2,8,43,27,16,23,56,83,2,defense
FRA-Ligue 1,2022,Paris S-G,Neymar,BRA,"MF,FW",30,1992,17.2,22,14,6,9,7,9,19,47.4,10,7,1,6,4,26,1,1,defense
FRA-Ligue 1,2022,Paris S-G,Nordi Mukiele,FRA,DF,24,1997,12.6,31,23,16,6,9,19,29,65.5,10,22,9,13,14,45,16,0,defense
FRA-Ligue 1,2022,Paris S-G,Nuno Mendes,POR,DF,20,2002,17.2,45,30,29,12,4,30,41,73.2,11,19,3,16,17,62,18,0,defense
FRA-Ligue 1,2022,Paris S-G,Pablo Sarabia,ESP,"FW,MF",30,1992,4.1,5,4,2,2,1,1,7,14.3,6,3,0,3,2,7,0,0,defense
FRA-Ligue 1,2022,Paris S-G,Presnel Kimpembe,FRA,DF,26,1995,8.1,17,8,9,6,2,9,13,69.2,4,12,7,5,13,30,9,1,defense
FRA-Ligue 1,2022,Paris S-G,Renato Sanches,POR,MF,24,1997,8.0,8,1,1,3,4,5,14,35.7,9,13,3,10,9,17,4,0,defense
FRA-Ligue 1,2022,Paris S-G,Sergio Ramos,ESP,DF,36,1986,30.0,34,26,14,18,2,23,44,52.3,21,29,13,16,34,68,93,3,defense
FRA-Ligue 1,2022,Paris S-G,Timothee Pembele,FRA,DF,19,2002,2.9,5,5,3,1,1,2,4,50.0,2,2,0,2,4,9,2,0,defense
FRA-Ligue 1,2022,Paris S-G,Vitinha,POR,MF,22,2000,27.2,58,25,21,27,10,27,83,32.5,56,27,4,23,25,83,15,0,defense
FRA-Ligue 1,2022,Paris S-G,Warren Zaïre-Emery,FRA,"MF,DF",16,2006,10.3,17,10,5,10,2,8,29,27.6,21,11,0,11,12,29,17,0,defense
FRA-Ligue 1,2022,Reims,Alexis Flips,FRA,"FW,MF",22,2000,22.0,51,30,18,17,16,27,64,42.2,37,35,5,30,24,75,12,0,defense
FRA-Ligue 1,2022,Reims,Andrew Gravillon,GLP,DF,24,1998,11.5,16,8,9,6,1,8,13,61.5,5,18,9,9,21,37,36,0,defense
FRA-Ligue 1,2022,Reims,Arber Zeneli,KVX,"FW,MF",27,1995,11.1,9,3,3,3,3,5,12,41.7,7,8,0,8,2,11,2,0,defense
FRA-Ligue 1,2022,Reims,Azor Matusiwa,NED,MF,24,1998,27.6,66,41,30,29,7,36,61,59.0,25,37,11,26,46,112,52,0,defense
FRA-Ligue 1,2022,Reims,Bradley Locko,FRA,DF,20,2002,11.8,31,16,21,4,6,15,27,55.6,12,17,4,13,20,51,21,0,defense
FRA-Ligue 1,2022,Reims,Check Keita,FRA,DF,19,2003,7.6,12,9,9,3,0,4,9,44.4,5,6,5,1,5,17,24,1,defense
FRA-Ligue 1,2022,Reims,Dion Lopy,SEN,MF,20,2002,15.3,45,24,22,16,7,23,62,37.1,39,27,3,24,22,67,18,0,defense
FRA-Ligue 1,2022,Reims,El Bilal Touré,MLI,FW,20,2001,1.0,0,0,0,0,0,0,0,,0,2,0,2,0,0,1,0,defense
FRA-Ligue 1,2022,Reims,Emmanuel Agbadou,CIV,DF,25,1997,26.5,71,49,53,16,2,42,65,64.6,23,30,14,16,32,103,107,3,defense
FRA-Ligue 1,2022,Reims,Fallou Fall,SEN,DF,18,2004,0.4,0,0,0,0,0,0,1,0.0,1,3,3,0,0,0,4,0,defense
FRA-Ligue 1,2022,Reims,Folarin Balogun,USA,FW,21,2001,33.3,9,5,1,5,3,2,20,10.0,18,20,1,19,3,12,15,0,defense
FRA-Ligue 1,2022,Reims,Ibrahim Diakité,GUI,DF,18,2003,1.5,3,3,3,0,0,2,3,66.7,1,0,0,0,5,8,6,0,defense
FRA-Ligue 1,2022,Reims,Jens Cajuste,SWE,MF,22,1999,17.0,46,25,25,14,7,25,48,52.1,23,30,6,24,18,64,22,0,defense
FRA-Ligue 1,2022,Reims,Junya Ito,JPN,FW,29,1993,32.4,40,20,14,15,11,13,53,24.5,40,29,1,28,8,48,4,1,defense
FRA-Ligue 1,2022,Reims,Kaj Sierhuis,NED,"FW,MF",24,1998,2.4,3,3,1,0,2,0,5,0.0,5,3,1,2,1,4,2,0,defense
FRA-Ligue 1,2022,Reims,Kamory Doumbia,MLI,MF,19,2003,12.8,31,16,9,14,8,12,37,32.4,25,17,1,16,13,44,3,0,defense
FRA-Ligue 1,2022,Reims,Mamadou Diakhon,FRA,FW,16,2005,0.2,2,0,2,0,0,0,1,0.0,1,1,0,1,1,3,0,0,defense
FRA-Ligue 1,2022,Reims,Marshall Munetsi,ZIM,MF,26,1996,30.0,58,27,13,31,14,20,48,41.7,28,37,11,26,26,84,41,1,defense
FRA-Ligue 1,2022,Reims,Martin Adeline,FRA,"MF,FW",18,2003,1.2,3,3,2,1,0,3,4,75.0,1,3,1,2,3,6,3,0,defense
FRA-Ligue 1,2022,Reims,Maxime Busi,BEL,DF,22,1999,11.6,21,16,9,11,1,13,29,44.8,16,14,6,8,14,35,24,0,defense
FRA-Ligue 1,2022,Reims,Mitchell van Bergen,NED,"FW,DF",22,1999,10.1,18,8,6,7,5,8,20,40.0,12,8,2,6,6,24,11,0,defense
FRA-Ligue 1,2022,Reims,Mohamed Toure,AUS,"FW,MF",18,2004,0.3,0,0,0,0,0,0,0,,0,0,0,0,0,0,0,0,defense
FRA-Ligue 1,2022,Reims,Myziane Maolida,COM,"MF,FW",23,1999,2.6,8,3,2,5,1,5,12,41.7,7,1,0,1,2,10,0,0,defense
FRA-Ligue 1,2022,Reims,Nathanael Mbuku,COD,"FW,MF",20,2002,0.7,2,1,2,0,0,2,2,100.0,0,0,0,0,0,2,0,0,defense
FRA-Ligue 1,2022,Reims,Noah Holm,NOR,"FW,MF",21,2001,2.2,6,4,2,2,2,2,5,40.0,3,0,0,0,0,6,5,0,defense
FRA-Ligue 1,2022,Reims,Patrick Pentz,AUT,GK,25,1997,7.0,0,0,0,0,0,0,0,,0,0,0,0,0,0,1,0,defense
FRA-Ligue 1,2022,Reims,Rafik Guitane,FRA,FW,23,1999,0.0,0,0,0,0,0,0,0,,0,0,0,0,0,0,1,0,defense
FRA-Ligue 1,2022,Reims,Samuel Koeberlé,FRA,MF,17,2004,0.0,0,0,0,0,0,0,0,,0,0,0,0,0,0,0,0,defense
FRA-Ligue 1,2022,Reims,Thibault De Smet,BEL,DF,24,1998,19.5,24,17,10,14,0,11,37,29.7,26,28,5,23,20,44,40,1,defense
FRA-Ligue 1,2022,Reims,Thomas Foket,BEL,DF,27,1994,22.0,35,22,18,11,6,17,46,37.0,29,21,7,14,33,68,29,2,defense
FRA-Ligue 1,2022,Reims,Valentin Atangana Edoa,FRA,MF,16,2005,1.9,8,3,4,2,2,3,6,50.0,3,2,1,1,0,8,1,0,defense
FRA-Ligue 1,2022,Reims,Wout Faes,BEL,DF,24,1998,3.0,1,1,1,0,0,1,2,50.0,1,6,3,3,7,8,19,0,defense
FRA-Ligue 1,2022,Reims,Yehvann Diouf,FRA,GK,22,1999,31.0,2,0,2,0,0,1,3,33.3,2,0,0,0,1,3,13,5,defense
FRA-Ligue 1,2022,Reims,Yunis Abdelhamid,MAR,DF,34,1987,37.0,82,50,47,33,2,39,52,75.0,13,65,27,38,64,146,116,1,defense
FRA-Ligue 1,2022,Rennes,Adrien Truffert,FRA,DF,20,2001,21.7,62,32,36,17,9,31,46,67.4,15,32,8,24,22,84,55,0,defense
FRA-Ligue 1,2022,Rennes,Alan Do Marcolino,GAB,FW,20,2002,0.2,0,0,0,0,0,0,0,,0,0,0,0,0,0,1,0,defense
FRA-Ligue 1,2022,Rennes,Amine Gouiri,ALG,"FW,MF",22,2000,28.0,42,25,14,16,12,14,33,42.4,19,21,0,21,12,54,10,0,defense
FRA-Ligue 1,2022,Rennes,Arnaud Kalimuendo,FRA,FW,20,2002,20.5,15,8,3,6,6,5,20,25.0,15,15,2,13,2,17,9,0,defense
FRA-Ligue 1,2022,Rennes,Arthur Theate,BEL,DF,22,2000,34.7,29,19,17,8,4,17,30,56.7,13,26,14,12,30,59,114,3,defense
FRA-Ligue 1,2022,Rennes,Baptiste Santamaria,FRA,MF,27,1995,20.1,41,22,13,23,5,21,41,51.2,20,21,5,16,21,62,23,0,defense
FRA-Ligue 1,2022,Rennes,Benjamin Bourigeaud,FRA,"MF,FW",28,1994,34.1,45,29,16,23,6,21,65,32.3,44,38,3,35,31,76,32,0,defense
FRA-Ligue 1,2022,Rennes,Birger Meling,NOR,DF,27,1994,13.4,24,15,9,12,3,12,25,48.0,13,18,2,16,23,47,26,0,defense
FRA-Ligue 1,2022,Rennes,Christopher Wooh,CMR,DF,20,2001,11.2,16,7,8,8,0,9,11,81.8,2,11,5,6,6,22,49,0,defense
FRA-Ligue 1,2022,Rennes,Djed Spence,ENG,DF,21,2000,6.4,14,6,8,2,4,11,18,61.1,7,10,3,7,4,18,15,0,defense
FRA-Ligue 1,2022,Rennes,Doğan Alemdar,TUR,GK,19,2002,4.5,0,0,0,0,0,0,0,,0,0,0,0,0,0,1,1,defense
FRA-Ligue 1,2022,Rennes,Désiré Doué,FRA,"MF,FW",17,2005,12.4,37,18,10,23,4,13,32,40.6,19,17,1,16,13,50,3,0,defense
FRA-Ligue 1,2022,Rennes,Flavien Tait,FRA,MF,29,1993,18.7,30,15,8,17,5,19,42,45.2,23,16,4,12,20,50,12,0,defense
FRA-Ligue 1,2022,Rennes,Gaëtan Laborde,FRA,FW,28,1994,2.8,1,1,1,0,0,0,1,0.0,1,1,0,1,0,1,1,0,defense
FRA-Ligue 1,2022,Rennes,Guela Doué,CIV,"FW,MF",19,2002,0.1,0,0,0,0,0,0,0,,0,0,0,0,0,0,0,0,defense
FRA-Ligue 1,2022,Rennes,Hamari Traoré,MLI,DF,30,1992,28.1,48,32,26,15,7,28,52,53.8,24,33,7,26,38,86,64,0,defense
FRA-Ligue 1,2022,Rennes,Ibrahim Salah,MAR,"FW,MF",20,2001,2.5,8,1,5,3,0,2,15,13.3,13,3,0,3,2,10,0,0,defense
FRA-Ligue 1,2022,Rennes,Jeanuël Belocian,FRA,DF,17,2005,5.6,10,7,3,5,2,5,9,55.6,4,6,3,3,6,16,11,0,defense
FRA-Ligue 1,2022,Rennes,Jeremy Doku,BEL,"MF,FW",20,2002,14.3,25,16,6,13,6,12,24,50.0,12,10,0,10,5,30,2,0,defense
FRA-Ligue 1,2022,Rennes,Joe Rodon,WAL,DF,24,1997,15.7,11,7,9,2,0,4,10,40.0,6,16,12,4,9,20,54,1,defense
FRA-Ligue 1,2022,Rennes,Kamaldeen Sulemana,GHA,"FW,MF",20,2002,3.6,6,3,1,4,1,1,5,20.0,4,2,0,2,4,10,2,0,defense
FRA-Ligue 1,2022,Rennes,Karl Toko Ekambi,CMR,"FW,MF",29,1992,10.8,3,1,1,1,1,3,9,33.3,6,5,0,5,9,12,3,0,defense
FRA-Ligue 1,2022,Rennes,Lesley Ugochukwu,FRA,MF,18,2004,14.8,36,19,13,20,3,16,24,66.7,8,24,10,14,21,57,16,0,defense
FRA-Ligue 1,2022,Rennes,Lorenz Assignon,TOG,DF,22,2000,2.9,6,2,4,2,0,2,4,50.0,2,6,0,6,2,8,9,0,defense
FRA-Ligue 1,2022,Rennes,Lovro Majer,CRO,"MF,FW",24,1998,18.5,34,23,16,13,5,8,29,27.6,21,21,1,20,21,55,5,1,defense
FRA-Ligue 1,2022,Rennes,Loïc Bade,FRA,DF,22,2000,1.0,1,1,1,0,0,0,0,,0,0,0,0,1,2,3,0,defense
FRA-Ligue 1,2022,Rennes,Martin Terrier,FRA,"FW,MF",25,1997,14.7,25,11,7,9,9,13,24,54.2,11,15,2,13,14,39,6,0,defense
FRA-Ligue 1,2022,Rennes,Matthis Abline,FRA,"FW,MF",19,2003,1.2,1,1,0,0,1,1,1,100.0,0,1,0,1,2,3,1,0,defense
FRA-Ligue 1,2022,Rennes,Serhou Guirassy,GUI,MF,26,1996,0.3,0,0,0,0,0,0,0,,0,0,0,0,0,0,0,0,defense
FRA-Ligue 1,2022,Rennes,Steve Mandanda,FRA,GK,37,1985,33.5,0,0,0,0,0,0,2,0.0,2,0,0,0,0,0,9,3,defense
FRA-Ligue 1,2022,Rennes,Warmed Omari,COM,DF,22,2000,15.1,20,11,14,6,0,14,28,50.0,14,13,7,6,17,37,43,1,defense
FRA-Ligue 1,2022,Rennes,Xeka,POR,MF,27,1994,6.1,10,3,6,3,1,7,16,43.8,9,11,2,9,6,16,8,0,defense
FRA-Ligue 1,2022,Strasbourg,Adrien Thomasson,FRA,MF,28,1993,10.4,19,9,8,6,5,9,30,30.0,21,18,0,18,3,22,2,0,defense
FRA-Ligue 1,2022,Strasbourg,Alexander Djiku,GHA,DF,27,1994,29.7,53,36,37,16,0,26,46,56.5,20,45,19,26,66,119,151,3,defense
FRA-Ligue 1,2022,Strasbourg,Colin Dagba,FRA,"DF,MF",23,1998,10.6,32,20,17,10,5,19,26,73.1,7,18,2,16,17,49,19,0,defense
FRA-Ligue 1,2022,Strasbourg,Dany Jean,HAI,"DF,MF",19,2002,0.1,0,0,0,0,0,0,1,0.0,1,1,0,1,0,0,0,0,defense
FRA-Ligue 1,2022,Strasbourg,Dimitri Liénard,FRA,"DF,MF",34,1988,17.1,46,29,20,18,8,34,57,59.6,23,28,4,24,16,62,24,0,defense
FRA-Ligue 1,2022,Strasbourg,Eduard Sobol,UKR,DF,27,1995,9.7,19,10,10,6,3,9,13,69.2,4,10,1,9,8,27,19,0,defense
FRA-Ligue 1,2022,Strasbourg,Franci Bouebari,FRA,DF,18,2003,0.8,3,0,1,2,0,3,5,60.0,2,0,0,0,2,5,2,0,defense
FRA-Ligue 1,2022,Strasbourg,Frederic Guilbert,FRA,DF,27,1994,16.2,47,29,18,23,6,25,43,58.1,18,24,3,21,43,90,33,1,defense
FRA-Ligue 1,2022,Strasbourg,Gerzino Nyamsi,FRA,DF,25,1997,17.5,28,20,14,12,2,10,12,83.3,2,19,11,8,10,38,63,1,defense
FRA-Ligue 1,2022,Strasbourg,Habib Diallo,SEN,FW,27,1995,32.0,18,10,8,7,3,6,16,37.5,10,19,4,15,12,30,26,0,defense
FRA-Ligue 1,2022,Strasbourg,Habib Diarra,SEN,"MF,FW",18,2004,18.1,24,16,10,11,3,15,29,51.7,14,17,1,16,11,35,13,0,defense
FRA-Ligue 1,2022,Strasbourg,Ibrahima Sissoko,MLI,MF,24,1997,14.6,40,22,18,17,5,22,42,52.4,20,20,6,14,10,50,19,0,defense
FRA-Ligue 1,2022,Strasbourg,Ismaël Doukouré,FRA,"DF,MF",19,2003,25.5,48,24,23,21,4,20,34,58.8,14,26,8,18,27,75,54,0,defense
FRA-Ligue 1,2022,Strasbourg,Jean-Eudes Aholou,CIV,MF,28,1994,14.4,34,20,10,20,4,12,31,38.7,19,25,0,25,24,58,15,0,defense
FRA-Ligue 1,2022,Strasbourg,Jean-Ricner Bellegarde,FRA,"MF,FW",24,1998,26.9,47,25,15,21,11,11,25,44.0,14,26,3,23,26,73,22,0,defense
FRA-Ligue 1,2022,Strasbourg,Karol Fila,POL,DF,24,1998,0.5,0,0,0,0,0,0,0,,0,0,0,0,1,1,1,0,defense
FRA-Ligue 1,2022,Strasbourg,Kévin Gameiro,FRA,FW,35,1987,23.3,20,10,6,10,4,8,28,28.6,20,10,1,9,9,29,0,0,defense
FRA-Ligue 1,2022,Strasbourg,Lebo Mothiba,RSA,"FW,MF",26,1996,4.8,1,0,1,0,0,0,1,0.0,1,6,1,5,0,1,4,0,defense
FRA-Ligue 1,2022,Strasbourg,Lucas Perrin,FRA,DF,23,1998,19.6,44,27,28,14,2,25,49,51.0,24,13,5,8,36,80,53,0,defense
FRA-Ligue 1,2022,Strasbourg,Ludovic Ajorque,FRA,FW,28,1994,8.6,5,4,1,4,0,3,9,33.3,6,3,1,2,2,7,7,0,defense
FRA-Ligue 1,2022,Strasbourg,Marvin Senaya,TOG,DF,21,2001,0.1,0,0,0,0,0,0,1,0.0,1,1,0,1,0,0,1,0,defense
FRA-Ligue 1,2022,Strasbourg,Matz Sels,BEL,GK,30,1992,38.0,4,3,4,0,0,4,4,100.0,0,0,0,0,4,8,23,0,defense
FRA-Ligue 1,2022,Strasbourg,Maxime Le Marchand,FRA,DF,32,1989,22.4,39,24,23,14,2,19,31,61.3,12,22,14,8,37,76,74,0,defense
FRA-Ligue 1,2022,Strasbourg,Morgan Sanson,FRA,MF,27,1994,15.8,36,25,10,16,10,17,56,30.4,39,21,1,20,22,58,9,0,defense
FRA-Ligue 1,2022,Strasbourg,Nordine Kandil,FRA,"MF,FW",20,2001,1.1,3,2,1,2,0,0,3,0.0,3,2,0,2,1,4,1,0,defense
FRA-Ligue 1,2022,Strasbourg,Ronaël Pierre-Gabriel,FRA,DF,24,1998,7.3,25,18,11,12,2,15,17,88.2,2,16,3,13,9,34,22,0,defense
FRA-Ligue 1,2022,Strasbourg,Sanjin Prcić,BIH,MF,28,1993,18.1,27,12,6,16,5,19,31,61.3,12,22,7,15,25,52,22,0,defense
FRA-Ligue 1,2022,Strasbourg,Thomas Delaine,FRA,"DF,MF",30,1992,11.9,28,14,16,6,6,13,26,50.0,13,8,3,5,16,44,9,0,defense
FRA-Ligue 1,2022,Strasbourg,Yuito Suzuki,JPN,"FW,MF",20,2001,0.4,0,0,0,0,0,0,0,,0,3,0,3,0,0,0,0,defense
FRA-Ligue 1,2022,Toulouse,Ado Onaiwu,JPN,FW,26,1995,12.0,11,6,4,4,3,5,13,38.5,8,5,1,4,2,13,5,0,defense
FRA-Ligue 1,2022,Toulouse,Anthony Rouault,FRA,DF,21,2001,36.8,66,37,54,10,2,30,58,51.7,28,52,26,26,56,122,126,4,defense
FRA-Ligue 1,2022,Toulouse,Branco van den Boomen,NED,MF,27,1995,32.1,71,36,26,32,13,36,89,40.4,53,27,4,23,10,81,27,2,defense
FRA-Ligue 1,2022,Toulouse,Brecht Dejaegere,BEL,MF,31,1991,20.1,40,23,10,20,10,15,51,29.4,36,25,5,20,14,54,11,0,defense
FRA-Ligue 1,2022,Toulouse,Christian Mawissa,FRA,DF,17,2005,1.1,2,0,1,1,0,1,3,33.3,2,0,0,0,3,5,1,0,defense
FRA-Ligue 1,2022,Toulouse,Denis Genreau,AUS,MF,23,1999,7.3,35,13,16,12,7,13,31,41.9,18,16,1,15,8,43,9,0,defense
FRA-Ligue 1,2022,Toulouse,Fares Chaïbi,ALG,"FW,MF",19,2002,26.0,31,18,8,15,8,17,50,34.0,33,38,5,33,19,50,36,1,defense
FRA-Ligue 1,2022,Toulouse,Gabriel Suazo,CHI,DF,24,1997,14.0,38,22,20,15,3,29,63,46.0,34,21,5,16,22,60,24,1,defense
FRA-Ligue 1,2022,Toulouse,Issiaga Sylla,GUI,DF,28,1994,15.2,28,15,14,9,5,15,34,44.1,19,15,5,10,38,66,38,0,defense
FRA-Ligue 1,2022,Toulouse,Kévin Keben Biakolo,CMR,DF,18,2004,4.0,3,2,2,0,1,0,4,0.0,4,1,0,1,5,8,9,0,defense
FRA-Ligue 1,2022,Toulouse,Logan Costa,CPV,DF,21,2001,4.6,9,4,7,1,1,6,9,66.7,3,6,3,3,4,13,12,0,defense
FRA-Ligue 1,2022,Toulouse,Maxime Dupé,FRA,GK,29,1993,38.0,0,0,0,0,0,0,0,,0,0,0,0,0,0,9,3,defense
FRA-Ligue 1,2022,Toulouse,Mikkel Desler,DEN,DF,27,1995,25.1,71,38,36,27,8,43,67,64.2,24,35,6,29,36,107,48,2,defense
FRA-Ligue 1,2022,Toulouse,Moussa Diarra,MLI,DF,21,2000,13.6,20,9,9,9,2,9,15,60.0,6,25,10,15,19,39,27,1,defense
FRA-Ligue 1,2022,Toulouse,Naatan Skyttä,FIN,MF,20,2002,0.3,0,0,0,0,0,0,0,,0,0,0,0,1,1,0,0,defense
FRA-Ligue 1,2022,Toulouse,Nathan N'Goumou,CMR,FW,22,2000,1.0,3,2,2,1,0,1,1,100.0,0,2,0,2,2,5,0,0,defense
FRA-Ligue 1,2022,Toulouse,Oliver Zandén,SWE,"DF,MF",20,2001,1.6,2,1,1,0,1,2,5,40.0,3,0,0,0,1,3,7,0,defense
FRA-Ligue 1,2022,Toulouse,Rafael Ratão,BRA,"FW,MF",26,1995,20.6,52,36,29,16,7,27,73,37.0,46,34,0,34,21,73,7,0,defense
FRA-Ligue 1,2022,Toulouse,Rasmus Nicolaisen,DEN,DF,25,1997,33.3,48,21,34,14,0,29,46,63.0,17,58,45,13,50,98,152,0,defense
FRA-Ligue 1,2022,Toulouse,Rhys Healey,WAL,FW,27,1994,0.7,0,0,0,0,0,0,0,,0,0,0,0,0,0,0,0,defense
FRA-Ligue 1,2022,Toulouse,Saïd Hamulic,BIH,FW,21,2000,1.2,0,0,0,0,0,0,0,,0,0,0,0,0,0,0,0,defense
FRA-Ligue 1,2022,Toulouse,Stijn Spierings,NED,MF,26,1996,34.7,95,67,37,49,9,43,101,42.6,58,49,11,38,53,148,44,0,defense
FRA-Ligue 1,2022,Toulouse,Theocharis Tsingaras,GRE,MF,21,2000,0.1,0,0,0,0,0,0,0,,0,0,0,0,0,0,0,0,defense
FRA-Ligue 1,2022,Toulouse,Thijs Dallinga,NED,FW,21,2000,26.1,8,6,2,2,4,1,13,7.7,12,17,3,14,3,11,20,0,defense
FRA-Ligue 1,2022,Toulouse,Veljko Birmančević,SRB,"FW,MF",24,1998,4.9,13,7,5,4,4,7,21,33.3,14,12,2,10,7,20,1,0,defense
FRA-Ligue 1,2022,Toulouse,Vincent Sierro,SUI,MF,26,1995,7.4,19,11,9,9,1,11,29,37.9,18,12,3,9,4,23,11,1,defense
FRA-Ligue 1,2022,Toulouse,Waren Kamanzi,NOR,DF,21,2000,7.4,16,9,9,5,2,13,19,68.4,6,8,2,6,8,24,9,0,defense
FRA-Ligue 1,2022,Toulouse,Yanis Begraoui,MAR,"FW,MF",21,2001,0.7,2,0,1,0,1,1,2,50.0,1,0,0,0,1,3,0,0,defense
FRA-Ligue 1,2022,Toulouse,Zakaria Aboukhlal,MAR,"FW,MF",22,2000,27.5,33,23,13,9,11,14,45,31.1,31,18,1,17,22,55,23,0,defense
FRA-Ligue 1,2022,Troyes,Abdu Conté,POR,DF,24,1998,14.6,25,17,14,8,3,12,22,54.5,10,13,6,7,6,31,25,0,defense
FRA-Ligue 1,2022,Troyes,Adil Rami,FRA,DF,36,1985,17.7,19,14,13,5,1,17,32,53.1,15,23,16,7,25,44,75,3,defense
FRA-Ligue 1,2022,Troyes,Alexis Tibidi,FRA,"FW,MF",18,2003,0.8,1,1,1,0,0,0,0,,0,0,0,0,0,1,0,0,defense
FRA-Ligue 1,2022,Troyes,Amar Ahmed,SWE,FW,18,2004,0.2,1,1,0,1,0,0,1,0.0,1,0,0,0,1,2,0,0,defense
FRA-Ligue 1,2022,Troyes,Andreas Bruus,DEN,"DF,FW",23,1999,18.1,12,6,9,3,0,8,20,40.0,12,13,2,11,17,29,24,0,defense
FRA-Ligue 1,2022,Troyes,Ante Palaversa,CRO,MF,22,2000,0.3,1,1,1,0,0,0,0,,0,0,0,0,1,2,0,0,defense
FRA-Ligue 1,2022,Troyes,Derek Mazou-Sacko,FRA,MF,17,2004,0.2,0,0,0,0,0,0,1,0.0,1,1,0,1,1,1,1,0,defense
FRA-Ligue 1,2022,Troyes,Erik Palmer-Brown,USA,DF,25,1997,35.5,42,27,31,10,1,18,33,54.5,15,56,29,27,26,68,166,1,defense
FRA-Ligue 1,2022,Troyes,Florian Tardieu,FRA,MF,30,1992,11.2,31,20,19,12,0,12,31,38.7,19,19,4,15,23,54,15,0,defense
FRA-Ligue 1,2022,Troyes,Gauthier Gallon,FRA,GK,29,1993,29.6,2,2,2,0,0,2,4,50.0,2,0,0,0,2,4,17,0,defense
FRA-Ligue 1,2022,Troyes,Ike Ugbo,CAN,"FW,MF",23,1998,9.9,5,2,2,2,1,3,11,27.3,8,8,2,6,2,7,4,0,defense
FRA-Ligue 1,2022,Troyes,Jackson Porozo,ECU,DF,21,2000,18.0,32,20,24,7,1,13,31,41.9,18,24,17,7,33,65,75,0,defense
FRA-Ligue 1,2022,Troyes,Jeff Reine-Adélaïde,FRA,MF,24,1998,2.6,3,2,2,1,0,1,2,50.0,1,2,0,2,2,5,1,0,defense
FRA-Ligue 1,2022,Troyes,Jordan Dongmo,CMR,MF,21,2001,0.2,1,0,0,1,0,1,1,100.0,0,0,0,0,0,1,0,0,defense
FRA-Ligue 1,2022,Troyes,Kyliane Dong,FRA,"MF,FW",17,2004,2.4,3,1,0,2,1,1,2,50.0,1,1,0,1,1,4,0,0,defense
FRA-Ligue 1,2022,Troyes,Lucien Agoume,FRA,MF,20,2002,12.2,42,25,18,15,9,17,33,51.5,16,14,5,9,27,69,24,0,defense
FRA-Ligue 1,2022,Troyes,Mama Samba Baldé,GNB,FW,26,1995,29.6,46,21,14,21,11,13,28,46.4,15,30,3,27,10,56,13,0,defense
FRA-Ligue 1,2022,Troyes,Marlos Moreno,COL,"MF,DF",25,1996,0.1,2,2,2,0,0,2,3,66.7,1,1,1,0,0,2,0,0,defense
FRA-Ligue 1,2022,Troyes,Mateusz Lis,POL,GK,25,1997,8.3,0,0,0,0,0,0,1,0.0,1,1,0,1,0,0,3,0,defense
FRA-Ligue 1,2022,Troyes,Mathis Hamdi,FRA,DF,18,2003,0.8,0,0,0,0,0,0,1,0.0,1,0,0,0,1,1,1,0,defense
FRA-Ligue 1,2022,Troyes,Papa Ndiaga Yade,MTN,"DF,MF",22,2000,6.3,10,6,6,2,2,7,22,31.8,15,10,2,8,8,18,10,0,defense
FRA-Ligue 1,2022,Troyes,Renaud Ripart,FRA,"FW,MF",29,1993,14.7,40,23,14,20,6,19,52,36.5,33,29,2,27,7,47,5,0,defense
FRA-Ligue 1,2022,Troyes,Rominigue Kouamé,MLI,MF,25,1996,29.6,44,27,28,14,2,17,41,41.5,24,32,11,21,49,93,46,1,defense
FRA-Ligue 1,2022,Troyes,Rony Lopes,POR,"MF,FW",26,1995,26.1,24,12,6,15,3,7,31,22.6,24,14,2,12,9,33,10,0,defense
FRA-Ligue 1,2022,Troyes,Rudy Kohon,FRA,DF,18,2004,0.7,4,3,4,0,0,2,2,100.0,0,1,0,1,1,5,2,0,defense
FRA-Ligue 1,2022,Troyes,Tanguy Zoukrou,FRA,DF,19,2003,5.7,14,7,8,6,0,10,14,71.4,4,18,11,7,2,16,24,0,defense
FRA-Ligue 1,2022,Troyes,Thierno Balde,FRA,"DF,MF",20,2002,23.9,27,14,19,4,4,18,30,60.0,12,15,3,12,23,50,39,0,defense
FRA-Ligue 1,2022,Troyes,Tristan Dingomé,CMR,MF,31,1991,1.1,1,1,0,1,0,0,2,0.0,2,0,0,0,0,1,0,0,defense
FRA-Ligue 1,2022,Troyes,Wilson Odobert,FRA,"MF,FW",17,2004,19.6,20,14,10,7,3,9,25,36.0,16,11,0,11,15,35,5,0,defense
FRA-Ligue 1,2022,Troyes,Xavier Chavalerin,FRA,MF,31,1991,27.0,82,50,39,30,13,27,71,38.0,44,31,8,23,41,123,24,0,defense
FRA-Ligue 1,2022,Troyes,Yasser Larouci,ALG,"DF,MF",21,2001,20.0,23,13,13,8,2,15,24,62.5,9,15,1,14,26,49,46,0,defense
FRA-Ligue 1,2022,Troyes,Yoann Salmier,GUF,DF,29,1992,29.4,51,29,34,12,5,21,35,60.0,14,34,19,15,39,90,124,0,defense
