league,season,team,player,nation,pos,age,born,90s,Tackles Tkl,Tackles TklW,Tackles Def 3rd,Tackles Mid 3rd,Tackles Att 3rd,Challenges Tkl,Challenges Att,Challenges Tkl%,Challenges Lost,Blocks Blocks,Blocks Sh,Blocks Pass,Int,Tkl+Int,Clr,Err,stat_type
ENG-Premier League,2020,Arsenal,Alexandre Lacazette,FRA,FW,29,1991,21.4,18,10,4,11,3,4,22,18.2,18,20,1,19,12,30,13,0,defense
ENG-Premier League,2020,Arsenal,Bernd Leno,GER,GK,28,1992,34.8,1,0,1,0,0,1,1,100.0,0,1,0,1,0,1,11,2,defense
ENG-Premier League,2020,Arsenal,Bukayo Saka,ENG,"FW,MF",18,2001,28.4,25,16,10,13,2,11,40,27.5,29,21,2,19,25,50,24,0,defense
ENG-Premier League,2020,Arsenal,Calum Chambers,ENG,DF,25,1995,8.4,7,3,3,2,2,3,8,37.5,5,6,2,4,10,17,37,0,defense
ENG-Premier League,2020,Arsenal,Cédric Soares,POR,DF,28,1991,8.3,12,8,6,4,2,6,21,28.6,15,6,1,5,8,20,16,1,defense
ENG-Premier League,2020,Arsenal,Dani Ceballos,ESP,MF,23,1996,17.9,37,22,20,11,6,21,51,41.2,30,23,6,17,35,72,14,1,defense
ENG-Premier League,2020,Arsenal,David Luiz,BRA,DF,33,1987,15.5,12,9,5,7,0,4,4,100.0,0,16,9,7,16,28,50,2,defense
ENG-Premier League,2020,Arsenal,Eddie Nketiah,ENG,FW,21,1999,4.7,3,1,0,2,1,0,2,0.0,2,6,0,6,0,3,5,0,defense
ENG-Premier League,2020,Arsenal,Emile Smith Rowe,ENG,"MF,FW",20,2000,16.0,14,7,5,5,4,6,17,35.3,11,15,1,14,10,24,12,0,defense
ENG-Premier League,2020,Arsenal,Gabriel Magalhães,BRA,DF,22,1997,22.2,25,15,19,5,1,13,19,68.4,6,27,19,8,26,51,74,2,defense
ENG-Premier League,2020,Arsenal,Gabriel Martinelli,BRA,FW,19,2001,6.5,7,1,2,3,2,4,10,40.0,6,6,0,6,8,15,4,0,defense
ENG-Premier League,2020,Arsenal,Granit Xhaka,SUI,"MF,DF",27,1992,28.0,50,26,18,17,15,30,58,51.7,28,23,7,16,24,74,38,3,defense
ENG-Premier League,2020,Arsenal,Héctor Bellerín,ESP,"DF,MF",25,1995,23.2,29,19,14,12,3,12,41,29.3,29,26,8,18,33,62,33,0,defense
ENG-Premier League,2020,Arsenal,Joe Willock,ENG,MF,20,1999,2.6,6,3,1,4,1,3,7,42.9,4,6,1,5,3,9,0,0,defense
ENG-Premier League,2020,Arsenal,Kieran Tierney,SCO,DF,23,1997,25.5,27,15,5,14,8,11,31,35.5,20,31,10,21,16,43,63,0,defense
ENG-Premier League,2020,Arsenal,Martin Ødegaard,NOR,MF,21,1998,9.6,9,3,2,6,1,4,14,28.6,10,2,0,2,2,11,5,0,defense
ENG-Premier League,2020,Arsenal,Mathew Ryan,AUS,GK,28,1992,3.0,0,0,0,0,0,0,0,,0,0,0,0,0,0,1,0,defense
ENG-Premier League,2020,Arsenal,Mohamed Elneny,EGY,MF,28,1992,17.2,14,6,7,7,0,7,28,25.0,21,11,4,7,24,38,20,2,defense
ENG-Premier League,2020,Arsenal,Nicolas Pépé,CIV,FW,25,1995,18.0,20,15,8,6,6,8,23,34.8,15,16,1,15,12,32,19,0,defense
ENG-Premier League,2020,Arsenal,Pablo Marí,ESP,DF,26,1993,10.0,15,9,12,3,0,5,10,50.0,5,8,7,1,9,24,30,2,defense
ENG-Premier League,2020,Arsenal,Pierre-Emerick Aubameyang,GAB,FW,31,1989,25.9,12,8,7,4,1,3,20,15.0,17,18,0,18,7,19,17,0,defense
ENG-Premier League,2020,Arsenal,Reiss Nelson,ENG,"FW,MF",20,1999,0.8,1,0,0,0,1,0,0,,0,0,0,0,1,2,1,0,defense
ENG-Premier League,2020,Arsenal,Rob Holding,ENG,DF,24,1995,28.4,43,20,28,13,2,17,35,48.6,18,37,27,10,24,67,120,0,defense
ENG-Premier League,2020,Arsenal,Rúnar Alex Rúnarsson,ISL,GK,25,1995,0.2,0,0,0,0,0,0,0,,0,0,0,0,0,0,0,0,defense
ENG-Premier League,2020,Arsenal,Sead Kolašinac,BIH,DF,27,1993,1.0,0,0,0,0,0,0,0,,0,0,0,0,1,1,0,0,defense
ENG-Premier League,2020,Arsenal,Shkodran Mustafi,GER,DF,28,1992,0.5,1,1,1,0,0,1,1,100.0,0,1,0,1,0,1,3,0,defense
ENG-Premier League,2020,Arsenal,Thomas Partey,GHA,MF,27,1993,17.0,44,21,16,24,4,24,56,42.9,32,17,5,12,23,67,18,0,defense
ENG-Premier League,2020,Arsenal,Willian,BRA,FW,31,1988,15.6,13,7,6,6,1,6,16,37.5,10,13,0,13,8,21,8,0,defense
ENG-Premier League,2020,Aston Villa,Ahmed Elmohamady,EGY,DF,32,1987,9.3,17,13,12,4,1,9,14,64.3,5,6,3,3,17,34,26,0,defense
ENG-Premier League,2020,Aston Villa,Anwar El Ghazi,NED,FW,25,1995,17.9,16,13,6,7,3,7,23,30.4,16,11,0,11,6,22,11,0,defense
ENG-Premier League,2020,Aston Villa,Bertrand Traoré,BFA,FW,24,1995,25.7,26,10,8,10,8,10,34,29.4,24,23,1,22,15,41,14,1,defense
ENG-Premier League,2020,Aston Villa,Carney Chukwuemeka,ENG,"MF,FW",16,2003,0.2,2,2,1,0,1,1,3,33.3,2,0,0,0,0,2,0,0,defense
ENG-Premier League,2020,Aston Villa,Conor Hourihane,IRL,MF,29,1991,2.5,0,0,0,0,0,0,2,0.0,2,3,0,3,0,0,2,0,defense
ENG-Premier League,2020,Aston Villa,Douglas Luiz,BRA,MF,22,1998,30.9,49,18,22,26,1,20,58,34.5,38,52,17,35,43,92,44,2,defense
ENG-Premier League,2020,Aston Villa,Emiliano Martínez,ARG,GK,27,1992,38.0,3,3,3,0,0,3,4,75.0,1,0,0,0,2,5,10,2,defense
ENG-Premier League,2020,Aston Villa,Ezri Konsa,ENG,DF,22,1997,35.5,25,13,18,6,1,9,13,69.2,4,53,47,6,29,54,162,1,defense
ENG-Premier League,2020,Aston Villa,Jack Grealish,ENG,"FW,MF",24,1995,24.3,31,14,8,16,7,15,24,62.5,9,20,3,17,12,43,5,3,defense
ENG-Premier League,2020,Aston Villa,Jacob Ramsey,ENG,MF,19,2001,7.0,10,5,3,4,3,2,12,16.7,10,13,6,7,4,14,5,0,defense
ENG-Premier League,2020,Aston Villa,Jaden Philogene Bidace,ENG,FW,18,2002,0.0,0,0,0,0,0,0,0,,0,0,0,0,0,0,0,0,defense
ENG-Premier League,2020,Aston Villa,John McGinn,SCO,MF,25,1994,37.0,61,37,23,31,7,27,84,32.1,57,38,6,32,43,104,23,2,defense
ENG-Premier League,2020,Aston Villa,Keinan Davis,ENG,"FW,MF",22,1998,3.1,2,1,1,0,1,0,1,0.0,1,1,0,1,0,2,2,0,defense
ENG-Premier League,2020,Aston Villa,Kortney Hause,ENG,DF,25,1995,7.0,4,2,3,1,0,0,3,0.0,3,4,2,2,8,12,53,0,defense
ENG-Premier League,2020,Aston Villa,Marvelous Nakamba,ZIM,MF,26,1994,8.3,22,14,10,11,1,7,12,58.3,5,16,5,11,17,39,9,1,defense
ENG-Premier League,2020,Aston Villa,Matt Targett,ENG,DF,24,1995,37.8,83,39,52,20,11,56,88,63.6,32,40,14,26,55,138,102,1,defense
ENG-Premier League,2020,Aston Villa,Matty Cash,POL,DF,22,1997,26.4,71,40,43,22,6,41,74,55.4,33,50,11,39,60,131,95,0,defense
ENG-Premier League,2020,Aston Villa,Morgan Sanson,FRA,MF,25,1994,3.3,7,4,4,2,1,1,4,25.0,3,5,0,5,4,11,1,0,defense
ENG-Premier League,2020,Aston Villa,Neil Taylor,WAL,DF,31,1989,0.2,1,1,1,0,0,0,0,,0,1,0,1,0,1,0,0,defense
ENG-Premier League,2020,Aston Villa,Ollie Watkins,ENG,FW,24,1995,37.0,29,17,5,16,8,10,33,30.3,23,21,2,19,7,36,24,0,defense
ENG-Premier League,2020,Aston Villa,Ross Barkley,ENG,MF,26,1993,17.0,6,2,2,4,0,3,15,20.0,12,9,1,8,5,11,6,1,defense
ENG-Premier League,2020,Aston Villa,Trézéguet,EGY,FW,25,1994,13.0,33,18,14,15,4,13,45,28.9,32,13,1,12,19,52,17,0,defense
ENG-Premier League,2020,Aston Villa,Tyrone Mings,ENG,DF,27,1993,35.5,32,16,23,7,2,16,24,66.7,8,59,40,19,41,73,172,3,defense
ENG-Premier League,2020,Aston Villa,Wesley Moraes,BRA,FW,23,1996,0.2,0,0,0,0,0,0,1,0.0,1,0,0,0,0,0,0,0,defense
ENG-Premier League,2020,Brighton,Aaron Connolly,IRL,FW,20,2000,8.8,6,3,1,3,2,0,2,0.0,2,4,0,4,0,6,2,0,defense
ENG-Premier League,2020,Brighton,Adam Lallana,ENG,"MF,FW",32,1988,17.7,28,13,11,13,4,8,39,20.5,31,18,3,15,15,43,13,0,defense
ENG-Premier League,2020,Brighton,Adam Webster,ENG,DF,25,1995,28.8,29,16,15,10,4,12,25,48.0,13,29,16,13,47,76,92,3,defense
ENG-Premier League,2020,Brighton,Alexis Mac Allister,ARG,"MF,FW",21,1998,12.4,26,12,6,16,4,11,38,28.9,27,25,4,21,9,35,4,0,defense
ENG-Premier League,2020,Brighton,Alireza Jahanbakhsh,IRN,"FW,MF",26,1993,5.9,9,7,3,5,1,2,12,16.7,10,8,0,8,8,17,1,0,defense
ENG-Premier League,2020,Brighton,Andi Zeqiri,SUI,"FW,DF",21,1999,1.9,3,2,0,2,1,1,2,50.0,1,1,0,1,0,3,2,0,defense
ENG-Premier League,2020,Brighton,Ben White,ENG,"DF,MF",22,1997,35.5,49,26,21,24,4,24,57,42.1,33,46,22,24,62,111,56,0,defense
ENG-Premier League,2020,Brighton,Bernardo,BRA,"DF,MF",25,1995,2.3,10,8,8,1,1,4,6,66.7,2,2,0,2,1,11,1,0,defense
ENG-Premier League,2020,Brighton,Dan Burn,ENG,DF,28,1992,22.9,50,26,33,14,3,27,53,50.9,26,30,7,23,31,81,75,0,defense
ENG-Premier League,2020,Brighton,Danny Welbeck,ENG,FW,29,1990,17.2,12,6,2,6,4,7,19,36.8,12,17,0,17,7,19,13,0,defense
ENG-Premier League,2020,Brighton,Davy Pröpper,NED,MF,28,1991,2.4,6,5,0,6,0,2,5,40.0,3,3,0,3,1,7,0,0,defense
ENG-Premier League,2020,Brighton,Jakub Moder,POL,"DF,MF",21,1999,7.2,15,7,5,7,3,7,20,35.0,13,12,1,11,3,18,9,0,defense
ENG-Premier League,2020,Brighton,Jayson Molumby,IRL,MF,20,1999,0.0,0,0,0,0,0,0,0,,0,0,0,0,0,0,0,0,defense
ENG-Premier League,2020,Brighton,José Izquierdo,COL,DF,28,1992,0.1,0,0,0,0,0,0,0,,0,0,0,0,0,0,0,0,defense
ENG-Premier League,2020,Brighton,Joël Veltman,NED,DF,28,1992,25.3,67,33,34,25,8,29,57,50.9,28,24,5,19,33,100,64,0,defense
ENG-Premier League,2020,Brighton,Leandro Trossard,BEL,"MF,FW",25,1994,29.0,33,14,11,16,6,10,36,27.8,26,34,2,32,26,59,7,1,defense
ENG-Premier League,2020,Brighton,Lewis Dunk,ENG,DF,28,1991,32.6,30,15,20,8,2,16,23,69.6,7,29,20,9,32,62,106,0,defense
ENG-Premier League,2020,Brighton,Mathew Ryan,AUS,GK,28,1992,11.0,1,0,1,0,0,0,0,,0,0,0,0,0,1,4,0,defense
ENG-Premier League,2020,Brighton,Neal Maupay,FRA,"FW,MF",23,1996,27.9,20,8,9,7,4,4,24,16.7,20,20,0,20,13,33,6,0,defense
ENG-Premier League,2020,Brighton,Pascal Groß,GER,"MF,DF",29,1991,27.6,45,24,24,15,6,24,53,45.3,29,25,4,21,23,68,18,1,defense
ENG-Premier League,2020,Brighton,Percy Tau,RSA,FW,26,1994,1.1,1,1,1,0,0,0,2,0.0,2,1,0,1,0,1,1,0,defense
ENG-Premier League,2020,Brighton,Reda Khadra,GER,MF,19,2001,0.1,0,0,0,0,0,0,0,,0,0,0,0,0,0,0,0,defense
ENG-Premier League,2020,Brighton,Robert Sánchez,ESP,GK,22,1997,27.0,1,0,1,0,0,1,1,100.0,0,1,0,1,1,2,11,2,defense
ENG-Premier League,2020,Brighton,Solly March,ENG,"DF,MF",26,1994,18.6,49,23,24,15,10,18,34,52.9,16,30,5,25,22,71,30,0,defense
ENG-Premier League,2020,Brighton,Steven Alzate,COL,MF,21,1998,10.0,17,8,10,4,3,6,15,40.0,9,8,1,7,8,25,10,0,defense
ENG-Premier League,2020,Brighton,Tariq Lamptey,GHA,"DF,MF",19,2000,9.8,17,9,7,6,4,6,13,46.2,7,8,1,7,19,36,12,1,defense
ENG-Premier League,2020,Brighton,Yves Bissouma,MLI,MF,23,1996,34.6,104,68,50,48,6,33,67,49.3,34,42,6,36,64,168,67,0,defense
ENG-Premier League,2020,Burnley,Ashley Barnes,ENG,FW,30,1989,14.8,12,6,2,6,4,3,13,23.1,10,14,2,12,5,17,11,0,defense
ENG-Premier League,2020,Burnley,Ashley Westwood,ENG,MF,30,1990,37.9,23,15,6,12,5,10,42,23.8,32,26,9,17,44,67,33,0,defense
ENG-Premier League,2020,Burnley,Bailey Peacock-Farrell,NIR,GK,23,1996,4.0,0,0,0,0,0,0,0,,0,0,0,0,0,0,0,0,defense
ENG-Premier League,2020,Burnley,Ben Mee,ENG,DF,30,1989,29.9,32,15,16,14,2,14,29,48.3,15,54,45,9,43,75,148,2,defense
ENG-Premier League,2020,Burnley,Charlie Taylor,ENG,DF,26,1993,27.0,48,28,30,15,3,25,46,54.3,21,36,19,17,29,77,87,2,defense
ENG-Premier League,2020,Burnley,Chris Wood,NZL,FW,28,1991,30.5,12,7,2,4,6,5,18,27.8,13,14,3,11,1,13,21,0,defense
ENG-Premier League,2020,Burnley,Dale Stephens,ENG,MF,31,1989,2.9,11,6,2,7,2,3,6,50.0,3,3,0,3,8,19,2,0,defense
ENG-Premier League,2020,Burnley,Dwight McNeil,ENG,MF,20,1999,34.1,47,24,24,18,5,18,56,32.1,38,44,6,38,32,79,32,1,defense
ENG-Premier League,2020,Burnley,Erik Pieters,NED,"DF,MF",31,1988,14.1,30,21,18,9,3,19,39,48.7,20,30,9,21,12,42,34,0,defense
ENG-Premier League,2020,Burnley,Jack Cork,ENG,MF,31,1989,15.0,26,10,5,17,4,11,31,35.5,20,15,4,11,16,42,20,0,defense
ENG-Premier League,2020,Burnley,James Tarkowski,ENG,DF,27,1992,36.0,66,39,52,11,3,25,49,51.0,24,54,42,12,44,110,163,1,defense
ENG-Premier League,2020,Burnley,Jay Rodriguez,ENG,FW,31,1989,14.1,25,16,5,15,5,13,28,46.4,15,25,4,21,2,27,7,0,defense
ENG-Premier League,2020,Burnley,Jimmy Dunne,IRL,DF,22,1997,3.0,3,3,2,1,0,1,2,50.0,1,3,2,1,6,9,16,1,defense
ENG-Premier League,2020,Burnley,Joel Mumbongo,SWE,FW,21,1999,0.4,0,0,0,0,0,0,0,,0,1,0,1,0,0,0,0,defense
ENG-Premier League,2020,Burnley,Josh Benson,ENG,MF,20,1999,2.9,5,1,3,0,2,1,6,16.7,5,3,0,3,3,8,2,0,defense
ENG-Premier League,2020,Burnley,Josh Brownhill,ENG,MF,24,1995,31.3,45,27,9,29,7,15,44,34.1,29,33,11,22,69,114,39,0,defense
ENG-Premier League,2020,Burnley,Jóhann Berg Guðmundsson,ISL,MF,29,1990,15.1,19,11,6,9,4,11,23,47.8,12,11,2,9,17,36,19,0,defense
ENG-Premier League,2020,Burnley,Kevin Long,IRL,DF,29,1990,7.1,11,6,9,2,0,7,9,77.8,2,11,7,4,6,17,24,0,defense
ENG-Premier League,2020,Burnley,Lewis Richardson,ENG,"FW,MF",17,2003,0.0,0,0,0,0,0,0,0,,0,0,0,0,0,0,0,0,defense
ENG-Premier League,2020,Burnley,Matthew Lowton,ENG,DF,31,1989,34.0,54,32,31,22,1,32,73,43.8,41,36,13,23,56,110,91,1,defense
ENG-Premier League,2020,Burnley,Matěj Vydra,CZE,FW,28,1992,15.2,9,5,2,4,3,1,8,12.5,7,8,1,7,6,15,5,0,defense
ENG-Premier League,2020,Burnley,Nick Pope,ENG,GK,28,1992,32.0,1,1,1,0,0,0,1,0.0,1,0,0,0,2,3,29,2,defense
ENG-Premier League,2020,Burnley,Phil Bardsley,SCO,DF,35,1985,3.0,6,5,4,2,0,3,6,50.0,3,3,1,2,6,12,12,0,defense
ENG-Premier League,2020,Burnley,Robbie Brady,IRL,MF,28,1992,11.7,22,15,12,6,4,12,35,34.3,23,16,0,16,9,31,29,1,defense
ENG-Premier League,2020,Burnley,Will Norris,ENG,GK,26,1993,2.0,0,0,0,0,0,0,0,,0,0,0,0,0,0,0,0,defense
ENG-Premier League,2020,Chelsea,Andreas Christensen,DEN,DF,24,1996,15.2,11,6,8,3,0,0,8,0.0,8,19,14,5,20,31,51,1,defense
ENG-Premier League,2020,Chelsea,Antonio Rüdiger,GER,DF,27,1993,19.0,31,23,16,14,1,12,15,80.0,3,17,10,7,18,49,51,0,defense
ENG-Premier League,2020,Chelsea,Ben Chilwell,ENG,DF,23,1996,25.4,42,22,16,22,4,15,33,45.5,18,28,3,25,24,66,58,0,defense
ENG-Premier League,2020,Chelsea,Billy Gilmour,SCO,MF,19,2001,2.9,4,2,1,2,1,2,7,28.6,5,3,2,1,3,7,1,0,defense
ENG-Premier League,2020,Chelsea,Callum Hudson-Odoi,ENG,"FW,DF",19,2000,11.8,23,15,11,7,5,8,21,38.1,13,15,1,14,6,29,6,0,defense
ENG-Premier League,2020,Chelsea,Christian Pulisic,USA,"FW,MF",21,1998,19.3,19,11,8,10,1,8,21,38.1,13,25,2,23,12,31,9,0,defense
ENG-Premier League,2020,Chelsea,César Azpilicueta,ESP,DF,30,1989,24.3,53,28,22,24,7,19,37,51.4,18,30,5,25,28,81,62,2,defense
ENG-Premier League,2020,Chelsea,Edouard Mendy,SEN,GK,28,1992,30.5,0,0,0,0,0,0,1,0.0,1,0,0,0,1,1,9,3,defense
ENG-Premier League,2020,Chelsea,Emerson Palmieri,ITA,DF,25,1994,1.0,3,3,2,0,1,1,3,33.3,2,0,0,0,1,4,6,0,defense
ENG-Premier League,2020,Chelsea,Fikayo Tomori,ENG,DF,22,1997,0.5,2,1,2,0,0,0,0,,0,1,1,0,2,4,8,0,defense
ENG-Premier League,2020,Chelsea,Hakim Ziyech,MAR,"MF,FW",27,1993,13.0,14,10,5,7,2,5,19,26.3,14,9,1,8,10,24,2,0,defense
ENG-Premier League,2020,Chelsea,Jorginho,ITA,MF,28,1991,22.3,57,30,22,31,4,31,76,40.8,45,33,5,28,40,97,21,3,defense
ENG-Premier League,2020,Chelsea,Kai Havertz,GER,"MF,FW",21,1999,16.9,18,9,6,10,2,6,27,22.2,21,25,0,25,4,22,22,1,defense
ENG-Premier League,2020,Chelsea,Kepa Arrizabalaga,ESP,GK,25,1994,6.5,0,0,0,0,0,0,1,0.0,1,0,0,0,0,0,0,3,defense
ENG-Premier League,2020,Chelsea,Kurt Zouma,FRA,DF,25,1994,22.5,16,10,8,6,2,4,8,50.0,4,13,9,4,28,44,93,0,defense
ENG-Premier League,2020,Chelsea,Marcos Alonso,ESP,DF,29,1990,10.7,13,3,6,4,3,7,14,50.0,7,12,1,11,12,25,30,0,defense
ENG-Premier League,2020,Chelsea,Mason Mount,ENG,MF,21,1999,32.1,75,35,22,38,15,25,69,36.2,44,40,2,38,31,106,14,0,defense
ENG-Premier League,2020,Chelsea,Mateo Kovačić,CRO,MF,26,1994,20.2,46,28,19,24,3,17,32,53.1,15,18,1,17,15,61,11,2,defense
ENG-Premier League,2020,Chelsea,N'Golo Kanté,FRA,MF,29,1991,23.8,79,42,39,35,5,27,56,48.2,29,42,4,38,59,138,34,0,defense
ENG-Premier League,2020,Chelsea,Olivier Giroud,FRA,FW,33,1986,8.3,4,2,0,1,3,1,7,14.3,6,4,1,3,5,9,10,0,defense
ENG-Premier League,2020,Chelsea,Reece James,ENG,DF,20,1999,26.4,55,35,24,22,9,21,44,47.7,23,36,7,29,17,72,52,0,defense
ENG-Premier League,2020,Chelsea,Ross Barkley,ENG,"FW,MF",26,1993,0.5,0,0,0,0,0,0,0,,0,0,0,0,0,0,0,0,defense
ENG-Premier League,2020,Chelsea,Ruben Loftus-Cheek,ENG,FW,24,1996,0.7,0,0,0,0,0,0,0,,0,0,0,0,0,0,0,0,defense
ENG-Premier League,2020,Chelsea,Tammy Abraham,ENG,FW,22,1997,11.6,7,5,3,3,1,1,7,14.3,6,6,0,6,5,12,17,0,defense
ENG-Premier League,2020,Chelsea,Thiago Silva,BRA,DF,35,1984,21.5,20,12,11,8,1,14,21,66.7,7,21,13,8,33,53,86,1,defense
ENG-Premier League,2020,Chelsea,Timo Werner,GER,"FW,MF",24,1996,28.9,20,9,6,11,3,7,43,16.3,36,23,1,22,8,28,8,0,defense
ENG-Premier League,2020,Chelsea,Willy Caballero,ARG,GK,38,1981,1.0,0,0,0,0,0,0,0,,0,0,0,0,0,0,0,0,defense
ENG-Premier League,2020,Crystal Palace,Andros Townsend,ENG,"MF,FW",29,1991,25.1,78,41,45,20,13,30,79,38.0,49,48,2,46,41,119,19,0,defense
ENG-Premier League,2020,Crystal Palace,Cheikhou Kouyaté,SEN,DF,30,1989,34.7,58,37,44,12,2,25,43,58.1,18,42,26,16,32,90,125,2,defense
ENG-Premier League,2020,Crystal Palace,Christian Benteke,BEL,FW,29,1990,20.2,15,7,1,7,7,2,9,22.2,7,17,6,11,4,19,39,0,defense
ENG-Premier League,2020,Crystal Palace,Eberechi Eze,ENG,MF,22,1998,28.4,27,14,11,13,3,16,35,45.7,19,19,3,16,24,51,9,1,defense
ENG-Premier League,2020,Crystal Palace,Gary Cahill,ENG,DF,34,1985,20.0,13,9,10,3,0,7,11,63.6,4,27,22,5,13,26,88,0,defense
ENG-Premier League,2020,Crystal Palace,Jack Butland,ENG,GK,27,1993,1.0,0,0,0,0,0,0,0,,0,0,0,0,0,0,0,0,defense
ENG-Premier League,2020,Crystal Palace,James McArthur,SCO,MF,32,1987,16.3,57,32,25,27,5,15,39,38.5,24,28,3,25,23,80,31,0,defense
ENG-Premier League,2020,Crystal Palace,James McCarthy,IRL,MF,29,1990,9.1,16,12,9,7,0,8,21,38.1,13,15,7,8,8,24,12,0,defense
ENG-Premier League,2020,Crystal Palace,James Tomkins,ENG,DF,31,1989,6.1,4,2,4,0,0,3,4,75.0,1,4,3,1,4,8,45,0,defense
ENG-Premier League,2020,Crystal Palace,Jaïro Riedewald,NED,MF,23,1996,20.2,34,15,13,17,4,16,36,44.4,20,39,7,32,29,63,25,0,defense
ENG-Premier League,2020,Crystal Palace,Jean-Philippe Mateta,FRA,FW,23,1997,2.5,1,1,0,1,0,1,3,33.3,2,1,0,1,0,1,2,0,defense
ENG-Premier League,2020,Crystal Palace,Jeffrey Schlupp,GHA,MF,27,1992,15.9,29,16,14,12,3,6,23,26.1,17,24,8,16,22,51,16,0,defense
ENG-Premier League,2020,Crystal Palace,Joel Ward,ENG,DF,30,1989,25.1,43,25,29,14,0,24,42,57.1,18,27,8,19,41,84,87,2,defense
ENG-Premier League,2020,Crystal Palace,Jordan Ayew,GHA,"FW,MF",28,1991,23.3,38,26,8,16,14,16,44,36.4,28,28,2,26,16,54,12,0,defense
ENG-Premier League,2020,Crystal Palace,Luka Milivojević,SRB,MF,29,1991,26.2,65,34,25,31,9,42,77,54.5,35,29,6,23,35,100,47,2,defense
ENG-Premier League,2020,Crystal Palace,Mamadou Sakho,FRA,DF,30,1990,3.1,3,2,1,2,0,3,3,100.0,0,3,2,1,3,6,11,0,defense
ENG-Premier League,2020,Crystal Palace,Martin Kelly,ENG,DF,30,1990,0.0,1,0,1,0,0,1,1,100.0,0,0,0,0,0,1,0,0,defense
ENG-Premier League,2020,Crystal Palace,Michy Batshuayi,BEL,FW,26,1993,8.1,5,3,1,2,2,1,9,11.1,8,5,1,4,4,9,5,0,defense
ENG-Premier League,2020,Crystal Palace,Nathaniel Clyne,ENG,DF,29,1991,12.7,17,10,8,8,1,9,16,56.3,7,7,2,5,18,35,25,1,defense
ENG-Premier League,2020,Crystal Palace,Patrick van Aanholt,NED,DF,29,1990,19.7,35,22,18,17,0,19,43,44.2,24,18,6,12,30,65,40,2,defense
ENG-Premier League,2020,Crystal Palace,Scott Dann,ENG,DF,33,1987,15.0,6,4,5,1,0,4,11,36.4,7,16,14,2,18,24,59,1,defense
ENG-Premier League,2020,Crystal Palace,Tyrick Mitchell,ENG,DF,20,1999,19.0,64,35,48,9,7,23,40,57.5,17,29,10,19,21,85,62,1,defense
ENG-Premier League,2020,Crystal Palace,Vicente Guaita,ESP,GK,33,1987,37.0,1,1,1,0,0,1,1,100.0,0,0,0,0,1,2,11,1,defense
ENG-Premier League,2020,Crystal Palace,Wilfried Zaha,CIV,FW,27,1992,29.0,26,18,8,15,3,11,30,36.7,19,21,0,21,9,35,4,0,defense
ENG-Premier League,2020,Everton,Abdoulaye Doucouré,MLI,MF,27,1993,27.1,52,32,25,19,8,14,43,32.6,29,24,7,17,39,91,31,1,defense
ENG-Premier League,2020,Everton,Alex Iwobi,NGA,"FW,MF",24,1996,17.1,27,10,10,14,3,13,25,52.0,12,20,1,19,16,43,14,0,defense
ENG-Premier League,2020,Everton,Allan,BRA,MF,29,1991,22.8,80,45,39,37,4,28,95,29.5,67,31,12,19,19,99,25,1,defense
ENG-Premier League,2020,Everton,André Gomes,POR,MF,27,1993,17.4,35,23,16,16,3,17,58,29.3,41,19,1,18,10,45,12,1,defense
ENG-Premier League,2020,Everton,Anthony Gordon,ENG,"FW,MF",19,2001,1.0,3,3,3,0,0,0,2,0.0,2,1,0,1,1,4,3,0,defense
ENG-Premier League,2020,Everton,Ben Godfrey,ENG,DF,22,1998,29.8,55,33,37,15,3,27,41,65.9,14,56,37,19,33,88,120,0,defense
ENG-Premier League,2020,Everton,Bernard,BRA,"MF,FW",27,1992,5.1,8,3,3,3,2,7,15,46.7,8,5,0,5,8,16,6,0,defense
ENG-Premier League,2020,Everton,Cenk Tosun,TUR,FW,29,1991,0.5,0,0,0,0,0,0,1,0.0,1,0,0,0,0,0,0,0,defense
ENG-Premier League,2020,Everton,Dominic Calvert-Lewin,ENG,FW,23,1997,31.9,17,8,1,8,8,6,12,50.0,6,22,6,16,6,23,33,0,defense
ENG-Premier League,2020,Everton,Fabian Delph,ENG,"MF,DF",30,1989,3.0,5,2,3,2,0,1,3,33.3,2,2,0,2,4,9,8,1,defense
ENG-Premier League,2020,Everton,Gylfi Sigurðsson,ISL,"MF,FW",30,1989,25.0,30,20,9,14,7,13,44,29.5,31,31,2,29,34,64,21,1,defense
ENG-Premier League,2020,Everton,James Rodríguez,COL,"FW,MF",29,1991,19.6,28,17,8,15,5,11,46,23.9,35,17,0,17,15,43,3,0,defense
ENG-Premier League,2020,Everton,Jean-Philippe Gbamin,CIV,MF,24,1995,0.1,1,0,0,1,0,0,0,,0,1,0,1,0,1,1,0,defense
ENG-Premier League,2020,Everton,Jonjoe Kenny,ENG,DF,23,1997,0.9,2,1,1,0,1,2,2,100.0,0,0,0,0,1,3,3,0,defense
ENG-Premier League,2020,Everton,Jordan Pickford,ENG,GK,26,1994,30.5,0,0,0,0,0,0,2,0.0,2,2,0,2,3,3,16,4,defense
ENG-Premier League,2020,Everton,Joshua King,NOR,"MF,FW",28,1992,1.6,4,1,2,1,1,0,0,,0,3,0,3,1,5,1,0,defense
ENG-Premier League,2020,Everton,João Virgínia,POR,GK,20,1999,0.5,0,0,0,0,0,0,0,,0,0,0,0,0,0,0,0,defense
ENG-Premier League,2020,Everton,Lucas Digne,FRA,"DF,MF",27,1993,29.8,63,38,40,16,7,29,54,53.7,25,42,4,38,31,94,87,0,defense
ENG-Premier League,2020,Everton,Mason Holgate,ENG,DF,23,1996,25.4,56,36,31,18,7,20,50,40.0,30,37,13,24,35,91,90,3,defense
ENG-Premier League,2020,Everton,Michael Keane,ENG,DF,27,1993,33.2,28,15,20,8,0,14,31,45.2,17,46,33,13,51,79,161,0,defense
ENG-Premier League,2020,Everton,Moise Kean,ITA,"FW,MF",20,2000,0.2,0,0,0,0,0,0,0,,0,0,0,0,0,0,0,0,defense
ENG-Premier League,2020,Everton,Nathan Broadhead,WAL,FW,22,1998,0.0,1,1,0,1,0,0,0,,0,0,0,0,0,1,0,0,defense
ENG-Premier League,2020,Everton,Niels Nkounkou,FRA,"DF,FW",19,2000,0.9,4,3,1,2,1,3,8,37.5,5,4,0,4,0,4,4,0,defense
ENG-Premier League,2020,Everton,Richarlison,BRA,FW,23,1997,31.8,50,32,21,22,7,16,51,31.4,35,28,3,25,14,64,36,1,defense
ENG-Premier League,2020,Everton,Robin Olsen,SWE,GK,30,1990,7.0,0,0,0,0,0,0,0,,0,0,0,0,0,0,4,1,defense
ENG-Premier League,2020,Everton,Séamus Coleman,IRL,"DF,MF",31,1988,17.9,39,26,21,14,4,21,30,70.0,9,22,6,16,13,52,37,2,defense
ENG-Premier League,2020,Everton,Theo Walcott,ENG,FW,31,1989,0.1,0,0,0,0,0,0,0,,0,0,0,0,0,0,0,0,defense
ENG-Premier League,2020,Everton,Tom Davies,ENG,MF,22,1998,15.8,31,18,17,12,2,16,39,41.0,23,15,9,6,34,65,21,2,defense
ENG-Premier League,2020,Everton,Yerry Mina,COL,DF,25,1994,21.5,21,14,17,4,0,8,12,66.7,4,30,23,7,24,45,110,1,defense
ENG-Premier League,2020,Fulham,Aboubakar Kamara,MTN,"FW,MF",25,1995,3.5,2,2,1,1,0,0,5,0.0,5,6,0,6,1,3,0,0,defense
ENG-Premier League,2020,Fulham,Ademola Lookman,NGA,"FW,MF",22,1997,30.5,35,11,18,9,8,13,44,29.5,31,31,1,30,20,55,9,0,defense
ENG-Premier League,2020,Fulham,Aleksandar Mitrović,SRB,FW,25,1994,15.6,7,4,0,3,4,2,8,25.0,6,12,3,9,3,10,8,0,defense
ENG-Premier League,2020,Fulham,Alphonse Areola,FRA,GK,27,1993,36.0,1,0,1,0,0,1,5,20.0,4,0,0,0,1,2,13,3,defense
ENG-Premier League,2020,Fulham,Andre-Frank Zambo Anguissa,CMR,MF,24,1995,28.7,78,37,27,38,13,27,68,39.7,41,35,6,29,56,134,17,2,defense
ENG-Premier League,2020,Fulham,Antonee Robinson,USA,DF,22,1997,24.0,45,28,24,16,5,27,44,61.4,17,21,4,17,37,82,68,0,defense
ENG-Premier League,2020,Fulham,Bobby Reid,JAM,"MF,FW",27,1993,26.4,31,15,17,10,4,18,39,46.2,21,19,5,14,21,52,39,0,defense
ENG-Premier League,2020,Fulham,Denis Odoi,GHA,DF,32,1988,3.0,3,3,2,1,0,1,4,25.0,3,3,1,2,5,8,5,0,defense
ENG-Premier League,2020,Fulham,Fabio Carvalho,POR,"MF,FW",17,2002,2.8,9,6,4,4,1,5,9,55.6,4,2,0,2,1,10,1,1,defense
ENG-Premier League,2020,Fulham,Harrison Reed,ENG,MF,25,1995,25.0,63,38,28,28,7,29,73,39.7,44,34,11,23,50,113,31,1,defense
ENG-Premier League,2020,Fulham,Ivan Cavaleiro,POR,FW,26,1993,27.5,23,14,9,11,3,12,34,35.3,22,25,1,24,19,42,14,0,defense
ENG-Premier League,2020,Fulham,Joachim Andersen,DEN,DF,24,1996,30.3,33,19,18,11,4,15,28,53.6,13,24,13,11,44,77,151,1,defense
ENG-Premier League,2020,Fulham,Joe Bryan,ENG,"DF,MF",26,1993,7.4,15,8,7,5,3,7,12,58.3,5,8,2,6,14,29,16,0,defense
ENG-Premier League,2020,Fulham,Josh Maja,NGA,FW,21,1998,9.0,7,4,0,3,4,4,10,40.0,6,3,1,2,4,11,1,0,defense
ENG-Premier League,2020,Fulham,Josh Onomah,ENG,MF,23,1997,4.2,11,8,1,6,4,0,5,0.0,5,4,2,2,2,13,1,0,defense
ENG-Premier League,2020,Fulham,Kenny Tete,NED,"DF,MF",24,1995,16.5,48,30,27,16,5,10,18,55.6,8,14,5,9,27,75,49,0,defense
ENG-Premier League,2020,Fulham,Marek Rodák,SVK,GK,23,1996,2.0,0,0,0,0,0,0,0,,0,0,0,0,0,0,0,0,defense
ENG-Premier League,2020,Fulham,Mario Lemina,GAB,MF,26,1993,18.9,62,35,25,30,7,23,44,52.3,21,26,5,21,30,92,21,0,defense
ENG-Premier League,2020,Fulham,Maxime Le Marchand,FRA,DF,30,1989,1.4,2,2,2,0,0,2,2,100.0,0,0,0,0,0,2,3,0,defense
ENG-Premier League,2020,Fulham,Michael Hector,JAM,DF,28,1992,2.9,3,2,1,2,0,1,6,16.7,5,4,2,2,0,3,6,0,defense
ENG-Premier League,2020,Fulham,Neeskens Kebano,COD,"FW,MF",28,1992,1.3,0,0,0,0,0,0,1,0.0,1,3,0,3,0,0,0,0,defense
ENG-Premier League,2020,Fulham,Ola Aina,NGA,DF,23,1996,29.6,37,20,22,7,8,21,43,48.8,22,22,6,16,45,82,94,2,defense
ENG-Premier League,2020,Fulham,Ruben Loftus-Cheek,ENG,"MF,FW",24,1996,21.2,25,14,7,15,3,7,23,30.4,16,20,2,18,7,32,18,0,defense
ENG-Premier League,2020,Fulham,Terence Kongolo,NED,DF,26,1994,1.0,3,2,1,2,0,1,1,100.0,0,0,0,0,2,5,3,0,defense
ENG-Premier League,2020,Fulham,Tim Ream,USA,DF,32,1987,7.0,12,5,9,3,0,8,11,72.7,3,8,5,3,6,18,26,1,defense
ENG-Premier League,2020,Fulham,Tom Cairney,SCO,MF,29,1991,8.4,9,3,1,4,4,1,4,25.0,3,6,0,6,0,9,3,0,defense
ENG-Premier League,2020,Fulham,Tosin Adarabioyo,ENG,DF,22,1997,32.8,37,19,30,6,1,19,40,47.5,21,26,20,6,42,79,197,2,defense
ENG-Premier League,2020,Fulham,Tyrese Francois,AUS,DF,20,2000,0.2,0,0,0,0,0,0,0,,0,0,0,0,0,0,0,0,defense
ENG-Premier League,2020,Leeds United,Diego Llorente,ESP,DF,26,1993,13.4,34,21,21,13,0,19,32,59.4,13,18,13,5,20,54,40,2,defense
ENG-Premier League,2020,Leeds United,Ezgjan Alioski,MKD,"DF,MF",28,1992,27.3,74,31,38,28,8,32,74,43.2,42,17,2,15,23,97,50,2,defense
ENG-Premier League,2020,Leeds United,Gaetano Berardi,SUI,DF,31,1988,1.3,2,2,1,0,1,0,0,,0,2,1,1,1,3,2,0,defense
ENG-Premier League,2020,Leeds United,Hélder Costa,ANG,"MF,FW",26,1994,12.8,25,11,12,5,8,11,32,34.4,21,11,0,11,3,28,5,1,defense
ENG-Premier League,2020,Leeds United,Ian Poveda,ENG,MF,20,2000,3.9,5,4,3,0,2,1,7,14.3,6,5,1,4,1,6,2,0,defense
ENG-Premier League,2020,Leeds United,Illan Meslier,FRA,GK,20,2000,35.0,0,0,0,0,0,0,1,0.0,1,0,0,0,0,0,17,8,defense
ENG-Premier League,2020,Leeds United,Jack Harrison,ENG,"MF,FW",23,1996,31.6,63,38,20,30,13,26,59,44.1,33,30,2,28,15,78,21,0,defense
ENG-Premier League,2020,Leeds United,Jamie Shackleton,ENG,"MF,DF",20,1999,5.1,10,6,6,4,0,4,11,36.4,7,3,1,2,9,19,3,0,defense
ENG-Premier League,2020,Leeds United,Kalvin Phillips,ENG,MF,24,1995,27.0,74,38,38,29,7,26,62,41.9,36,49,14,35,45,119,53,3,defense
ENG-Premier League,2020,Leeds United,Kiko Casilla,ESP,GK,33,1986,3.0,0,0,0,0,0,0,0,,0,0,0,0,0,0,0,0,defense
ENG-Premier League,2020,Leeds United,Leif Davis,ENG,DF,20,2000,0.4,0,0,0,0,0,0,3,0.0,3,1,0,1,1,1,0,0,defense
ENG-Premier League,2020,Leeds United,Liam Cooper,SCO,DF,28,1991,24.3,68,45,39,27,2,37,59,62.7,22,39,32,7,61,129,70,1,defense
ENG-Premier League,2020,Leeds United,Luke Ayling,ENG,DF,28,1991,37.8,108,61,69,30,9,49,87,56.3,38,53,36,17,36,144,96,5,defense
ENG-Premier League,2020,Leeds United,Mateusz Klich,POL,MF,30,1990,26.6,38,20,14,20,4,14,61,23.0,47,13,4,9,11,49,16,0,defense
ENG-Premier League,2020,Leeds United,Niall Huggins,WAL,DF,19,2000,0.4,0,0,0,0,0,0,1,0.0,1,0,0,0,0,0,1,0,defense
ENG-Premier League,2020,Leeds United,Pablo Hernández,ESP,MF,35,1985,4.7,5,3,2,1,2,5,16,31.3,11,2,0,2,0,5,0,1,defense
ENG-Premier League,2020,Leeds United,Pascal Struijk,NED,"DF,MF",20,1999,23.1,49,30,28,19,2,17,28,60.7,11,35,21,14,47,96,92,0,defense
ENG-Premier League,2020,Leeds United,Patrick Bamford,ENG,FW,26,1993,33.9,21,9,2,11,8,8,27,29.6,19,14,4,10,10,31,37,0,defense
ENG-Premier League,2020,Leeds United,Raphinha,BRA,"MF,FW",23,1996,26.2,34,17,13,16,5,12,58,20.7,46,31,1,30,29,63,27,0,defense
ENG-Premier League,2020,Leeds United,Robin Koch,GER,"DF,MF",24,1996,12.6,27,16,17,10,0,10,19,52.6,9,18,12,6,27,54,34,2,defense
ENG-Premier League,2020,Leeds United,Rodrigo,ESP,"MF,FW",29,1991,14.3,14,7,8,3,3,4,22,18.2,18,7,0,7,5,19,16,0,defense
ENG-Premier League,2020,Leeds United,Stuart Dallas,NIR,"MF,DF",29,1991,37.9,74,45,46,22,6,30,88,34.1,58,41,3,38,44,118,52,1,defense
ENG-Premier League,2020,Leeds United,Tyler Roberts,WAL,"MF,FW",21,1999,14.9,15,13,1,11,3,5,22,22.7,17,17,2,15,9,24,12,0,defense
ENG-Premier League,2020,Leicester City,Ayoze Pérez,ESP,"MF,FW",27,1993,14.8,32,15,6,20,6,13,48,27.1,35,28,0,28,10,42,7,0,defense
ENG-Premier League,2020,Leicester City,Cengiz Ünder,TUR,"FW,MF",23,1997,3.1,4,1,0,3,1,3,5,60.0,2,3,0,3,2,6,0,0,defense
ENG-Premier League,2020,Leicester City,Christian Fuchs,AUT,DF,34,1986,7.8,18,7,15,2,1,8,15,53.3,7,6,4,2,16,34,34,1,defense
ENG-Premier League,2020,Leicester City,Daniel Amartey,GHA,DF,25,1994,8.0,11,7,6,4,1,8,12,66.7,4,8,4,4,12,23,26,0,defense
ENG-Premier League,2020,Leicester City,Demarai Gray,JAM,FW,24,1996,0.2,1,1,1,0,0,0,0,,0,0,0,0,0,1,0,0,defense
ENG-Premier League,2020,Leicester City,Dennis Praet,BEL,MF,26,1994,8.0,14,7,4,7,3,6,15,40.0,9,12,2,10,7,21,3,0,defense
ENG-Premier League,2020,Leicester City,Hamza Choudhury,BAN,MF,22,1997,3.5,8,7,3,5,0,4,10,40.0,6,4,1,3,4,12,9,1,defense
ENG-Premier League,2020,Leicester City,Harvey Barnes,ENG,"FW,MF",22,1997,21.6,19,9,11,3,5,5,22,22.7,17,16,3,13,8,27,11,0,defense
ENG-Premier League,2020,Leicester City,Islam Slimani,ALG,FW,32,1988,0.2,0,0,0,0,0,0,0,,0,0,0,0,0,0,0,0,defense
ENG-Premier League,2020,Leicester City,James Justin,ENG,DF,22,1998,23.0,61,37,38,18,5,20,41,48.8,21,36,10,26,30,91,58,1,defense
ENG-Premier League,2020,Leicester City,James Maddison,ENG,MF,23,1996,23.3,32,16,5,16,11,14,41,34.1,27,14,1,13,9,41,5,0,defense
ENG-Premier League,2020,Leicester City,Jamie Vardy,ENG,FW,33,1987,31.6,18,12,1,8,9,2,15,13.3,13,14,5,9,4,22,32,0,defense
ENG-Premier League,2020,Leicester City,Jonny Evans,NIR,DF,32,1988,27.5,25,12,22,2,1,14,20,70.0,6,8,3,5,46,71,98,1,defense
ENG-Premier League,2020,Leicester City,Kasper Schmeichel,DEN,GK,33,1986,38.0,0,0,0,0,0,0,0,,0,0,0,0,0,0,10,0,defense
ENG-Premier League,2020,Leicester City,Kelechi Iheanacho,NGA,FW,23,1996,16.2,12,5,2,4,6,4,17,23.5,13,14,0,14,2,14,1,1,defense
ENG-Premier League,2020,Leicester City,Khanya Leshabela,RSA,MF,20,1999,0.1,0,0,0,0,0,0,0,,0,0,0,0,0,0,0,0,defense
ENG-Premier League,2020,Leicester City,Luke Thomas,ENG,DF,19,2001,10.8,23,14,11,5,7,14,21,66.7,7,15,2,13,17,40,21,0,defense
ENG-Premier League,2020,Leicester City,Marc Albrighton,ENG,"DF,FW",30,1989,19.4,33,19,14,15,4,16,45,35.6,29,29,3,26,17,50,27,1,defense
ENG-Premier League,2020,Leicester City,Nampalys Mendy,SEN,MF,28,1992,16.2,26,17,18,6,2,7,20,35.0,13,12,1,11,14,40,8,0,defense
ENG-Premier League,2020,Leicester City,Ricardo Pereira,POR,"DF,FW",26,1993,10.7,31,22,16,8,7,14,35,40.0,21,24,1,23,15,46,23,0,defense
ENG-Premier League,2020,Leicester City,Sidnei Tavares,POR,MF,18,2001,0.9,1,1,0,1,0,0,0,,0,1,1,0,0,1,0,0,defense
ENG-Premier League,2020,Leicester City,Timothy Castagne,BEL,DF,24,1995,26.1,52,32,29,18,5,24,44,54.5,20,29,5,24,29,81,62,1,defense
ENG-Premier League,2020,Leicester City,Wes Morgan,JAM,DF,36,1984,0.2,0,0,0,0,0,0,0,,0,0,0,0,0,0,1,0,defense
ENG-Premier League,2020,Leicester City,Wesley Fofana,FRA,DF,19,2000,25.1,51,37,27,22,2,31,46,67.4,15,28,16,12,61,112,94,0,defense
ENG-Premier League,2020,Leicester City,Wilfred Ndidi,NGA,"MF,DF",23,1996,24.2,96,63,45,44,7,26,66,39.4,40,38,11,27,61,157,55,0,defense
ENG-Premier League,2020,Leicester City,Youri Tielemans,BEL,MF,23,1997,37.3,86,45,32,38,16,45,108,41.7,63,35,8,27,46,132,20,1,defense
ENG-Premier League,2020,Leicester City,Çağlar Söyüncü,TUR,DF,24,1996,20.2,27,17,13,14,0,17,30,56.7,13,12,9,3,28,55,80,1,defense
ENG-Premier League,2020,Liverpool,Adrián,ESP,GK,33,1987,3.0,0,0,0,0,0,0,0,,0,0,0,0,0,0,3,1,defense
ENG-Premier League,2020,Liverpool,Alex Oxlade-Chamberlain,ENG,"MF,FW",26,1993,2.8,4,0,0,3,1,0,2,0.0,2,1,0,1,2,6,0,0,defense
ENG-Premier League,2020,Liverpool,Alisson,BRA,GK,27,1992,33.0,3,2,3,0,0,3,4,75.0,1,0,0,0,2,5,26,7,defense
ENG-Premier League,2020,Liverpool,Andrew Robertson,SCO,DF,26,1994,37.6,46,34,23,18,5,28,57,49.1,29,39,9,30,21,67,79,1,defense
ENG-Premier League,2020,Liverpool,Caoimhín Kelleher,IRL,GK,21,1998,2.0,0,0,0,0,0,0,0,,0,0,0,0,0,0,2,0,defense
ENG-Premier League,2020,Liverpool,Curtis Jones,ENG,MF,19,2001,13.1,16,6,6,7,3,12,25,48.0,13,13,0,13,19,35,11,1,defense
ENG-Premier League,2020,Liverpool,Diogo Jota,POR,FW,23,1996,12.4,12,6,4,7,1,2,29,6.9,27,9,0,9,5,17,3,0,defense
ENG-Premier League,2020,Liverpool,Divock Origi,BEL,FW,25,1995,2.1,3,2,0,2,1,1,3,33.3,2,5,1,4,1,4,2,0,defense
ENG-Premier League,2020,Liverpool,Fabinho,BRA,"DF,MF",26,1993,28.5,58,31,21,29,8,27,54,50.0,27,28,10,18,44,102,66,1,defense
ENG-Premier League,2020,Liverpool,Georginio Wijnaldum,NED,MF,29,1990,32.7,23,7,6,14,3,7,31,22.6,24,18,3,15,26,49,18,1,defense
ENG-Premier League,2020,Liverpool,James Milner,ENG,"MF,DF",34,1986,11.9,26,19,9,14,3,11,33,33.3,22,30,3,27,14,40,16,1,defense
ENG-Premier League,2020,Liverpool,Joe Gomez,ENG,DF,23,1997,6.6,3,2,1,1,1,0,4,0.0,4,3,2,1,4,7,29,0,defense
ENG-Premier League,2020,Liverpool,Jordan Henderson,ENG,"MF,DF",30,1990,18.9,24,15,12,9,3,10,26,38.5,16,12,1,11,34,58,30,0,defense
ENG-Premier League,2020,Liverpool,Joël Matip,CMR,DF,28,1991,7.7,14,9,7,7,0,7,8,87.5,1,6,0,6,7,21,22,0,defense
ENG-Premier League,2020,Liverpool,Kostas Tsimikas,GRE,"DF,FW",24,1996,0.1,0,0,0,0,0,0,0,,0,0,0,0,0,0,0,0,defense
ENG-Premier League,2020,Liverpool,Mohamed Salah,EGY,FW,28,1992,34.2,18,9,4,4,10,7,16,43.8,9,10,0,10,1,19,10,1,defense
ENG-Premier League,2020,Liverpool,Naby Keïta,GUI,MF,25,1995,5.8,11,5,1,8,2,7,17,41.2,10,10,0,10,9,20,6,0,defense
ENG-Premier League,2020,Liverpool,Nathaniel Phillips,ENG,DF,23,1997,16.2,22,14,15,7,0,11,24,45.8,13,17,14,3,20,42,81,0,defense
ENG-Premier League,2020,Liverpool,Neco Williams,WAL,DF,19,2001,2.8,6,5,4,2,0,5,9,55.6,4,3,1,2,6,12,6,0,defense
ENG-Premier League,2020,Liverpool,Ozan Kabak,TUR,DF,20,2000,8.9,19,10,11,4,4,6,9,66.7,3,2,2,0,12,31,28,1,defense
ENG-Premier League,2020,Liverpool,Rhys Williams,ENG,DF,19,2001,7.3,6,4,3,3,0,3,3,100.0,0,4,3,1,6,12,27,1,defense
ENG-Premier League,2020,Liverpool,Roberto Firmino,BRA,FW,28,1991,31.5,33,15,3,17,13,6,32,18.8,26,42,5,37,11,44,12,0,defense
ENG-Premier League,2020,Liverpool,Sadio Mané,SEN,FW,28,1992,31.2,48,30,6,22,20,12,33,36.4,21,30,0,30,15,63,11,0,defense
ENG-Premier League,2020,Liverpool,Takumi Minamino,JPN,"MF,FW",25,1995,3.3,4,3,1,2,1,0,12,0.0,12,1,0,1,2,6,3,0,defense
ENG-Premier League,2020,Liverpool,Thiago Alcántara,ESP,MF,29,1991,20.6,61,36,20,30,11,17,49,34.7,32,26,0,26,30,91,14,0,defense
ENG-Premier League,2020,Liverpool,Trent Alexander-Arnold,ENG,DF,21,1998,33.7,56,33,31,18,7,36,56,64.3,20,24,3,21,49,105,50,3,defense
ENG-Premier League,2020,Liverpool,Virgil van Dijk,NED,DF,29,1991,4.1,3,2,1,2,0,0,0,,0,1,1,0,5,8,8,1,defense
ENG-Premier League,2020,Liverpool,Xherdan Shaqiri,SUI,"MF,FW",28,1991,6.2,7,4,3,1,3,2,7,28.6,5,4,0,4,2,9,0,0,defense
ENG-Premier League,2020,Manchester City,Aymeric Laporte,ESP,DF,26,1994,14.9,13,6,10,3,0,7,11,63.6,4,12,7,5,11,24,28,0,defense
ENG-Premier League,2020,Manchester City,Benjamin Mendy,FRA,DF,26,1994,10.6,13,9,1,8,4,5,21,23.8,16,12,5,7,5,18,14,1,defense
ENG-Premier League,2020,Manchester City,Bernardo Silva,POR,"MF,FW",25,1994,22.9,26,14,7,12,7,11,52,21.2,41,17,1,16,17,43,8,0,defense
ENG-Premier League,2020,Manchester City,Ederson,BRA,GK,26,1993,36.0,3,1,3,0,0,3,4,75.0,1,0,0,0,0,3,11,4,defense
ENG-Premier League,2020,Manchester City,Eric García,ESP,DF,19,2001,4.3,8,7,5,3,0,5,7,71.4,2,4,1,3,4,12,10,0,defense
ENG-Premier League,2020,Manchester City,Fernandinho,BRA,MF,35,1985,13.2,31,17,8,14,9,20,43,46.5,23,11,2,9,23,54,17,0,defense
ENG-Premier League,2020,Manchester City,Ferrán Torres,ESP,"FW,MF",20,2000,14.5,12,5,4,6,2,5,16,31.3,11,16,0,16,3,15,8,0,defense
ENG-Premier League,2020,Manchester City,Gabriel Jesus,BRA,FW,23,1997,22.9,17,6,5,5,7,11,28,39.3,17,16,0,16,15,32,5,0,defense
ENG-Premier League,2020,Manchester City,John Stones,ENG,DF,26,1994,21.5,21,10,13,5,3,9,14,64.3,5,23,15,8,18,39,56,1,defense
ENG-Premier League,2020,Manchester City,João Cancelo,POR,"DF,MF",26,1994,25.5,68,41,42,19,7,43,83,51.8,40,23,2,21,41,109,33,2,defense
ENG-Premier League,2020,Manchester City,Kevin De Bruyne,BEL,MF,29,1991,22.2,34,21,6,18,10,13,48,27.1,35,26,1,25,9,43,10,0,defense
ENG-Premier League,2020,Manchester City,Kyle Walker,ENG,DF,30,1990,21.6,29,19,15,12,2,16,24,66.7,8,19,7,12,14,43,28,0,defense
ENG-Premier League,2020,Manchester City,Liam Delap,ENG,FW,17,2003,0.4,0,0,0,0,0,0,0,,0,0,0,0,0,0,0,0,defense
ENG-Premier League,2020,Manchester City,Nathan Aké,NED,DF,25,1995,8.9,10,5,3,6,1,3,4,75.0,1,2,1,1,9,19,23,0,defense
ENG-Premier League,2020,Manchester City,Oleksandr Zinchenko,UKR,DF,23,1996,16.4,25,15,12,9,4,14,24,58.3,10,17,4,13,23,48,28,0,defense
ENG-Premier League,2020,Manchester City,Phil Foden,ENG,"FW,MF",20,2000,18.0,22,11,12,8,2,9,23,39.1,14,9,0,9,11,33,11,0,defense
ENG-Premier League,2020,Manchester City,Raheem Sterling,ENG,FW,25,1994,28.2,21,10,5,12,4,5,12,41.7,7,15,0,15,15,36,4,0,defense
ENG-Premier League,2020,Manchester City,Riyad Mahrez,ALG,FW,29,1991,21.7,20,5,2,10,8,6,30,20.0,24,19,0,19,8,28,4,0,defense
ENG-Premier League,2020,Manchester City,Rodri,ESP,MF,24,1996,30.5,72,40,24,40,8,33,66,50.0,33,23,9,14,36,108,54,3,defense
ENG-Premier League,2020,Manchester City,Rúben Dias,POR,DF,23,1997,31.6,24,13,13,8,3,4,16,25.0,12,31,23,8,35,59,92,0,defense
ENG-Premier League,2020,Manchester City,Scott Carson,ENG,GK,34,1985,1.0,0,0,0,0,0,0,0,,0,0,0,0,0,0,0,0,defense
ENG-Premier League,2020,Manchester City,Sergio Agüero,ARG,FW,32,1988,6.2,4,1,0,2,2,2,11,18.2,9,2,0,2,2,6,0,0,defense
ENG-Premier League,2020,Manchester City,Zack Steffen,USA,GK,25,1995,1.0,0,0,0,0,0,0,0,,0,0,0,0,0,0,0,0,defense
ENG-Premier League,2020,Manchester City,İlkay Gündoğan,GER,MF,29,1990,22.5,25,15,8,12,5,10,39,25.6,29,13,4,9,20,45,9,0,defense
ENG-Premier League,2020,Manchester Utd,Aaron Wan-Bissaka,ENG,DF,22,1997,34.0,88,54,53,29,6,32,45,71.1,13,65,17,48,62,150,84,2,defense
ENG-Premier League,2020,Manchester Utd,Alex Telles,BRA,DF,27,1992,7.7,14,7,10,3,1,8,17,47.1,9,7,2,5,16,30,20,0,defense
ENG-Premier League,2020,Manchester Utd,Amad Diallo,CIV,FW,18,2002,1.8,3,3,1,2,0,0,0,,0,2,1,1,0,3,1,0,defense
ENG-Premier League,2020,Manchester Utd,Anthony Elanga,SWE,FW,18,2002,1.7,4,2,3,1,0,4,5,80.0,1,1,1,0,1,5,1,0,defense
ENG-Premier League,2020,Manchester Utd,Anthony Martial,FRA,FW,24,1995,16.4,2,1,1,1,0,0,10,0.0,10,17,3,14,1,3,8,0,defense
ENG-Premier League,2020,Manchester Utd,Axel Tuanzebe,COD,DF,22,1997,4.5,13,7,5,7,1,8,9,88.9,1,7,5,2,3,16,18,0,defense
ENG-Premier League,2020,Manchester Utd,Brandon Williams,ENG,DF,19,2000,2.1,0,0,0,0,0,0,1,0.0,1,1,0,1,1,1,7,0,defense
ENG-Premier League,2020,Manchester Utd,Bruno Fernandes,POR,MF,25,1994,34.4,57,30,16,29,12,26,100,26.0,74,38,0,38,26,83,29,0,defense
ENG-Premier League,2020,Manchester Utd,Daniel James,WAL,FW,22,1997,10.1,15,9,4,7,4,3,18,16.7,15,10,1,9,0,15,6,0,defense
ENG-Premier League,2020,Manchester Utd,David de Gea,ESP,GK,29,1990,25.5,0,0,0,0,0,0,0,,0,0,0,0,0,0,8,3,defense
ENG-Premier League,2020,Manchester Utd,Dean Henderson,ENG,GK,23,1997,12.5,1,1,1,0,0,1,2,50.0,1,0,0,0,0,1,3,2,defense
ENG-Premier League,2020,Manchester Utd,Donny van de Beek,NED,"MF,FW",23,1997,5.8,15,10,2,11,2,7,15,46.7,8,10,1,9,6,21,7,0,defense
ENG-Premier League,2020,Manchester Utd,Edinson Cavani,URU,FW,33,1987,15.3,12,8,1,8,3,2,13,15.4,11,2,0,2,6,18,11,0,defense
ENG-Premier League,2020,Manchester Utd,Eric Bailly,CIV,DF,26,1994,10.2,5,5,3,1,1,0,1,0.0,1,13,11,2,13,18,36,2,defense
ENG-Premier League,2020,Manchester Utd,Fred,BRA,MF,27,1993,26.6,81,39,39,38,4,29,89,32.6,60,49,9,40,45,126,26,1,defense
ENG-Premier League,2020,Manchester Utd,Hannibal Mejbri,TUN,MF,17,2003,0.1,0,0,0,0,0,0,0,,0,0,0,0,0,0,0,0,defense
ENG-Premier League,2020,Manchester Utd,Harry Maguire,ENG,DF,27,1993,33.9,29,17,19,10,0,18,29,62.1,11,28,23,5,60,89,122,4,defense
ENG-Premier League,2020,Manchester Utd,Juan Mata,ESP,"FW,MF",32,1988,5.7,1,0,1,0,0,0,7,0.0,7,3,0,3,3,4,3,0,defense
ENG-Premier League,2020,Manchester Utd,Luke Shaw,ENG,DF,25,1995,29.5,44,28,21,16,7,21,36,58.3,15,34,9,25,20,64,44,2,defense
ENG-Premier League,2020,Manchester Utd,Marcus Rashford,ENG,FW,22,1997,32.4,18,9,2,8,8,7,27,25.9,20,22,2,20,8,26,10,0,defense
ENG-Premier League,2020,Manchester Utd,Mason Greenwood,ENG,FW,18,2001,20.2,13,10,6,4,3,5,22,22.7,17,9,0,9,5,18,1,0,defense
ENG-Premier League,2020,Manchester Utd,Nemanja Matić,SRB,MF,31,1988,12.3,25,11,13,12,0,13,31,41.9,18,19,5,14,22,47,10,3,defense
ENG-Premier League,2020,Manchester Utd,Odion Ighalo,NGA,FW,31,1989,0.1,0,0,0,0,0,0,1,0.0,1,0,0,0,0,0,0,0,defense
ENG-Premier League,2020,Manchester Utd,Paul Pogba,FRA,"MF,FW",27,1993,21.1,36,26,15,16,5,11,33,33.3,22,24,2,22,26,62,37,0,defense
ENG-Premier League,2020,Manchester Utd,Scott McTominay,SCO,MF,23,1996,23.7,51,24,23,25,3,23,36,63.9,13,35,10,25,29,80,46,0,defense
ENG-Premier League,2020,Manchester Utd,Shola Shoretire,ENG,FW,16,2004,0.1,0,0,0,0,0,0,0,,0,0,0,0,0,0,0,0,defense
ENG-Premier League,2020,Manchester Utd,Timothy Fosu-Mensah,NED,DF,22,1998,0.9,2,0,1,1,0,1,1,100.0,0,0,0,0,3,5,1,0,defense
ENG-Premier League,2020,Manchester Utd,Victor Lindelöf,SWE,DF,26,1994,28.7,22,10,12,10,0,12,24,50.0,12,22,14,8,30,52,95,1,defense
ENG-Premier League,2020,Manchester Utd,Will Fish,ENG,FW,17,2003,0.0,0,0,0,0,0,0,0,,0,0,0,0,0,0,0,0,defense
ENG-Premier League,2020,Newcastle Utd,Allan Saint-Maximin,FRA,"FW,MF",23,1997,17.3,16,9,6,9,1,4,9,44.4,5,10,0,10,4,20,2,0,defense
ENG-Premier League,2020,Newcastle Utd,Andy Carroll,ENG,FW,31,1989,4.4,3,1,1,1,1,1,8,12.5,7,1,0,1,0,3,14,0,defense
ENG-Premier League,2020,Newcastle Utd,Callum Wilson,ENG,FW,28,1992,23.2,12,5,1,6,5,2,12,16.7,10,10,3,7,7,19,14,0,defense
ENG-Premier League,2020,Newcastle Utd,Ciaran Clark,IRL,DF,30,1989,21.0,24,14,15,6,3,6,13,46.2,7,27,20,7,29,53,104,1,defense
ENG-Premier League,2020,Newcastle Utd,DeAndre Yedlin,USA,DF,27,1993,4.8,9,4,8,1,0,4,10,40.0,6,5,1,4,7,16,17,0,defense
ENG-Premier League,2020,Newcastle Utd,Dwight Gayle,ENG,"FW,MF",29,1990,5.7,2,0,1,1,0,0,7,0.0,7,3,1,2,1,3,2,0,defense
ENG-Premier League,2020,Newcastle Utd,Elliot Anderson,ENG,MF,17,2002,0.0,0,0,0,0,0,0,0,,0,0,0,0,0,0,0,0,defense
ENG-Premier League,2020,Newcastle Utd,Emil Krafth,SWE,DF,25,1994,14.3,19,8,9,9,1,12,25,48.0,13,15,9,6,15,34,52,2,defense
ENG-Premier League,2020,Newcastle Utd,Fabian Schär,SUI,DF,28,1991,13.8,13,4,8,5,0,7,19,36.8,12,19,12,7,27,40,52,1,defense
ENG-Premier League,2020,Newcastle Utd,Federico Fernández,ARG,DF,31,1989,23.1,29,22,23,5,1,17,21,81.0,4,41,31,10,17,46,147,0,defense
ENG-Premier League,2020,Newcastle Utd,Isaac Hayden,ENG,"MF,DF",25,1995,21.6,52,29,23,22,7,14,35,40.0,21,32,9,23,43,95,47,0,defense
ENG-Premier League,2020,Newcastle Utd,Jacob Murphy,ENG,"DF,MF",25,1995,18.1,39,24,25,12,2,24,49,49.0,25,27,3,24,14,53,29,0,defense
ENG-Premier League,2020,Newcastle Utd,Jamaal Lascelles,ENG,DF,26,1993,18.1,14,7,5,9,0,3,6,50.0,3,27,17,10,12,26,86,0,defense
ENG-Premier League,2020,Newcastle Utd,Jamal Lewis,NIR,DF,22,1998,20.4,37,20,23,13,1,16,38,42.1,22,21,7,14,11,48,44,1,defense
ENG-Premier League,2020,Newcastle Utd,Javier Manquillo,ESP,DF,26,1994,9.2,24,14,8,14,2,11,17,64.7,6,8,1,7,9,33,15,1,defense
ENG-Premier League,2020,Newcastle Utd,Jeff Hendrick,IRL,MF,28,1992,15.8,8,3,5,3,0,1,13,7.7,12,14,9,5,19,27,18,0,defense
ENG-Premier League,2020,Newcastle Utd,Joe Willock,ENG,MF,20,1999,10.9,26,13,16,7,3,9,42,21.4,33,21,3,18,17,43,15,1,defense
ENG-Premier League,2020,Newcastle Utd,Joelinton,BRA,"FW,MF",23,1996,22.0,33,21,7,21,5,14,37,37.8,23,30,2,28,9,42,24,0,defense
ENG-Premier League,2020,Newcastle Utd,Jonjo Shelvey,ENG,MF,28,1992,29.1,39,14,18,19,2,10,37,27.0,27,26,14,12,36,75,42,0,defense
ENG-Premier League,2020,Newcastle Utd,Karl Darlow,WAL,GK,29,1990,25.0,0,0,0,0,0,0,0,,0,0,0,0,0,0,17,0,defense
ENG-Premier League,2020,Newcastle Utd,Martin Dúbravka,SVK,GK,31,1989,13.0,0,0,0,0,0,0,0,,0,0,0,0,0,0,3,0,defense
ENG-Premier League,2020,Newcastle Utd,Matt Ritchie,SCO,"DF,MF",30,1989,15.0,10,3,5,3,2,3,17,17.6,14,17,2,15,12,22,47,0,defense
ENG-Premier League,2020,Newcastle Utd,Matthew Longstaff,ENG,MF,20,2000,4.2,3,2,2,1,0,2,8,25.0,6,7,0,7,7,10,2,0,defense
ENG-Premier League,2020,Newcastle Utd,Miguel Almirón,PAR,"MF,FW",26,1994,27.0,49,29,21,25,3,14,56,25.0,42,23,4,19,25,74,20,1,defense
ENG-Premier League,2020,Newcastle Utd,Paul Dummett,WAL,DF,28,1991,13.9,16,7,11,5,0,13,21,61.9,8,12,7,5,16,32,74,0,defense
ENG-Premier League,2020,Newcastle Utd,Ryan Fraser,SCO,"FW,MF",26,1994,10.3,4,1,3,1,0,2,5,40.0,3,1,0,1,6,10,7,0,defense
ENG-Premier League,2020,Newcastle Utd,Sean Longstaff,ENG,MF,22,1997,15.7,31,14,13,15,3,18,42,42.9,24,26,5,21,19,50,14,2,defense
ENG-Premier League,2020,Sheffield Utd,Aaron Ramsdale,ENG,GK,22,1998,38.0,1,1,1,0,0,1,1,100.0,0,0,0,0,2,3,22,6,defense
ENG-Premier League,2020,Sheffield Utd,Antwoine Hackford,ENG,DF,16,2004,0.1,0,0,0,0,0,0,0,,0,0,0,0,0,0,0,0,defense
ENG-Premier League,2020,Sheffield Utd,Ben Osborn,ENG,"MF,DF",25,1994,17.8,33,18,15,10,8,13,40,32.5,27,20,3,17,12,45,17,0,defense
ENG-Premier League,2020,Sheffield Utd,Billy Sharp,ENG,FW,34,1986,8.2,5,1,0,3,2,2,9,22.2,7,2,0,2,0,5,2,0,defense
ENG-Premier League,2020,Sheffield Utd,Chris Basham,ENG,"DF,MF",32,1988,28.6,69,42,41,23,5,41,67,61.2,26,36,15,21,49,118,105,1,defense
ENG-Premier League,2020,Sheffield Utd,Daniel Jebbison,ENG,FW,16,2003,3.2,6,2,1,3,2,3,7,42.9,4,6,1,5,1,7,0,0,defense
ENG-Premier League,2020,Sheffield Utd,David McGoldrick,IRL,"FW,MF",32,1987,26.6,33,21,8,15,10,13,31,41.9,18,19,3,16,2,35,25,0,defense
ENG-Premier League,2020,Sheffield Utd,Enda Stevens,IRL,DF,30,1990,30.0,59,26,32,19,8,33,58,56.9,25,41,12,29,22,81,81,1,defense
ENG-Premier League,2020,Sheffield Utd,Ethan Ampadu,WAL,"DF,MF",19,2000,23.2,57,36,31,24,2,20,46,43.5,26,40,19,21,49,106,87,3,defense
ENG-Premier League,2020,Sheffield Utd,Femi Seriki,ENG,MF,18,2002,0.0,0,0,0,0,0,0,0,,0,0,0,0,0,0,0,0,defense
ENG-Premier League,2020,Sheffield Utd,George Baldock,GRE,DF,27,1993,31.0,47,34,28,14,5,21,50,42.0,29,26,7,19,25,72,70,1,defense
ENG-Premier League,2020,Sheffield Utd,Iliman Ndiaye,SEN,MF,20,2000,0.1,1,1,0,1,0,1,1,100.0,0,0,0,0,0,1,0,0,defense
ENG-Premier League,2020,Sheffield Utd,Jack O'Connell,ENG,DF,26,1994,2.0,3,1,1,1,1,0,1,0.0,1,4,3,1,2,5,7,0,defense
ENG-Premier League,2020,Sheffield Utd,Jack Robinson,ENG,DF,26,1993,9.7,14,6,8,5,1,6,11,54.5,5,10,4,6,9,23,42,0,defense
ENG-Premier League,2020,Sheffield Utd,Jayden Bogle,ENG,"DF,MF",20,2000,12.3,33,23,21,10,2,20,39,51.3,19,14,4,10,14,47,22,0,defense
ENG-Premier League,2020,Sheffield Utd,John Egan,IRL,DF,27,1992,29.2,41,21,29,12,0,22,39,56.4,17,43,31,12,41,82,131,0,defense
ENG-Premier League,2020,Sheffield Utd,John Fleck,SCO,MF,28,1991,28.6,51,33,28,18,5,26,83,31.3,57,26,4,22,28,79,12,1,defense
ENG-Premier League,2020,Sheffield Utd,John Lundstram,ENG,MF,26,1994,22.6,25,16,12,11,2,13,47,27.7,34,26,8,18,14,39,29,1,defense
ENG-Premier League,2020,Sheffield Utd,Kean Bryan,ENG,DF,23,1996,11.2,20,10,9,11,0,9,19,47.4,10,16,10,6,13,33,39,1,defense
ENG-Premier League,2020,Sheffield Utd,Lys Mousset,FRA,"FW,MF",24,1996,3.3,1,0,0,0,1,0,2,0.0,2,1,0,1,0,1,1,1,defense
ENG-Premier League,2020,Sheffield Utd,Max Lowe,ENG,DF,23,1997,6.1,26,11,18,6,2,9,21,42.9,12,12,4,8,5,31,11,0,defense
ENG-Premier League,2020,Sheffield Utd,Oliver Burke,SCO,FW,23,1997,14.1,16,8,6,9,1,5,24,20.8,19,24,0,24,2,18,6,0,defense
ENG-Premier League,2020,Sheffield Utd,Oliver McBurnie,SCO,FW,24,1996,14.7,15,7,7,7,1,5,17,29.4,12,10,3,7,6,21,30,0,defense
ENG-Premier League,2020,Sheffield Utd,Oliver Norwood,NIR,MF,29,1991,24.7,49,22,16,28,5,21,72,29.2,51,29,12,17,36,85,51,1,defense
ENG-Premier League,2020,Sheffield Utd,Phil Jagielka,ENG,DF,37,1982,5.8,5,4,4,0,1,2,7,28.6,5,11,5,6,10,15,26,2,defense
ENG-Premier League,2020,Sheffield Utd,Rhian Brewster,ENG,"FW,MF",20,2000,12.5,8,5,1,4,3,1,13,7.7,12,15,2,13,5,13,5,0,defense
ENG-Premier League,2020,Sheffield Utd,Sander Berge,NOR,MF,22,1998,12.4,16,7,8,5,3,7,15,46.7,8,11,2,9,4,20,18,0,defense
ENG-Premier League,2020,Southampton,Alex McCarthy,ENG,GK,30,1989,30.0,1,0,1,0,0,1,4,25.0,3,0,0,0,0,1,11,1,defense
ENG-Premier League,2020,Southampton,Alexandre Jankewitz,SUI,MF,18,2001,0.0,2,1,2,0,0,1,1,100.0,0,0,0,0,0,2,0,0,defense
ENG-Premier League,2020,Southampton,Allan Tchaptchet,FRA,DF,18,2001,0.1,0,0,0,0,0,0,0,,0,0,0,0,0,0,0,0,defense
ENG-Premier League,2020,Southampton,Caleb Watts,AUS,MF,18,2002,0.4,2,1,2,0,0,1,2,50.0,1,0,0,0,0,2,0,0,defense
ENG-Premier League,2020,Southampton,Che Adams,SCO,FW,24,1996,29.6,25,16,4,15,6,6,17,35.3,11,20,2,18,4,29,19,1,defense
ENG-Premier League,2020,Southampton,Dan Nlundulu,ENG,"FW,MF",21,1999,1.2,0,0,0,0,0,0,1,0.0,1,2,0,2,0,0,2,0,defense
ENG-Premier League,2020,Southampton,Danny Ings,ENG,FW,28,1992,24.1,22,13,3,16,3,12,28,42.9,16,39,2,37,3,25,27,1,defense
ENG-Premier League,2020,Southampton,Fraser Forster,ENG,GK,32,1988,8.0,1,0,1,0,0,1,2,50.0,1,0,0,0,0,1,9,0,defense
ENG-Premier League,2020,Southampton,Ibrahima Diallo,FRA,MF,21,1999,11.3,29,16,11,17,1,9,16,56.3,7,10,1,9,10,39,12,2,defense
ENG-Premier League,2020,Southampton,Jack Stephens,ENG,DF,26,1994,17.1,34,19,19,15,0,17,38,44.7,21,25,14,11,28,62,64,2,defense
ENG-Premier League,2020,Southampton,Jake Vokins,ENG,DF,20,2000,0.7,0,0,0,0,0,0,1,0.0,1,0,0,0,0,0,0,0,defense
ENG-Premier League,2020,Southampton,James Ward-Prowse,ENG,MF,25,1994,38.0,75,49,30,41,4,29,70,41.4,41,36,4,32,42,117,60,0,defense
ENG-Premier League,2020,Southampton,Jan Bednarek,POL,DF,24,1996,34.4,37,19,25,11,1,25,49,51.0,24,44,27,17,84,121,132,0,defense
ENG-Premier League,2020,Southampton,Jannik Vestergaard,DEN,DF,27,1992,28.6,50,31,31,15,4,35,52,67.3,17,29,16,13,42,92,122,0,defense
ENG-Premier League,2020,Southampton,Kayne Ramsey,ENG,DF,19,2000,1.0,5,2,4,1,0,3,3,100.0,0,0,0,0,0,5,3,0,defense
ENG-Premier League,2020,Southampton,Kyle Walker-Peters,ENG,DF,23,1997,29.4,83,53,56,25,2,34,57,59.6,23,41,10,31,38,121,66,2,defense
ENG-Premier League,2020,Southampton,Michael Obafemi,IRL,FW,20,2000,0.7,1,0,0,1,0,0,1,0.0,1,1,0,1,0,1,0,0,defense
ENG-Premier League,2020,Southampton,Mohammed Salisu,GHA,DF,21,1999,9.4,38,21,20,16,2,25,34,73.5,9,22,5,17,17,55,30,0,defense
ENG-Premier League,2020,Southampton,Moussa Djenepo,MLI,MF,22,1998,13.8,52,27,27,17,8,28,63,44.4,35,24,2,22,10,62,14,0,defense
ENG-Premier League,2020,Southampton,Nathan Redmond,ENG,"MF,FW",26,1994,19.3,30,17,14,12,4,8,24,33.3,16,24,2,22,11,41,9,0,defense
ENG-Premier League,2020,Southampton,Nathan Tella,NGA,"FW,MF",21,1999,8.3,8,5,1,4,3,6,15,40.0,9,13,0,13,3,11,2,0,defense
ENG-Premier League,2020,Southampton,Oriol Romeu,ESP,MF,28,1991,19.6,69,35,25,39,5,26,68,38.2,42,28,7,21,30,99,18,0,defense
ENG-Premier League,2020,Southampton,Ryan Bertrand,ENG,DF,30,1989,28.9,60,32,26,27,7,30,48,62.5,18,19,1,18,30,90,41,1,defense
ENG-Premier League,2020,Southampton,Shane Long,IRL,FW,33,1987,2.3,2,1,0,0,2,2,3,66.7,1,0,0,0,3,5,1,0,defense
ENG-Premier League,2020,Southampton,Stuart Armstrong,SCO,MF,28,1992,30.7,60,41,19,32,9,27,75,36.0,48,26,1,25,24,84,19,0,defense
ENG-Premier League,2020,Southampton,Takumi Minamino,JPN,MF,25,1995,7.9,7,3,2,5,0,2,19,10.5,17,13,1,12,4,11,9,0,defense
ENG-Premier League,2020,Southampton,Theo Walcott,ENG,"MF,FW",31,1989,18.0,23,11,8,9,6,11,32,34.4,21,16,0,16,14,37,5,0,defense
ENG-Premier League,2020,Southampton,William Smallbone,IRL,MF,20,2000,1.9,6,3,2,4,0,1,3,33.3,2,5,0,5,2,8,1,0,defense
ENG-Premier League,2020,Southampton,Yan Valery,TUN,"DF,MF",21,1999,1.1,5,3,2,3,0,1,5,20.0,4,2,0,2,2,7,5,0,defense
ENG-Premier League,2020,Tottenham,Ben Davies,WAL,DF,27,1993,15.0,27,17,10,11,6,13,30,43.3,17,10,5,5,18,45,49,2,defense
ENG-Premier League,2020,Tottenham,Carlos Vinícius,BRA,FW,25,1995,3.4,3,1,2,1,0,1,1,100.0,0,0,0,0,2,5,5,0,defense
ENG-Premier League,2020,Tottenham,Dane Scarlett,ENG,FW,16,2004,0.0,0,0,0,0,0,0,0,,0,0,0,0,0,0,0,0,defense
ENG-Premier League,2020,Tottenham,Davinson Sánchez,COL,DF,24,1996,16.5,40,20,31,9,0,21,32,65.6,11,18,13,5,14,54,85,2,defense
ENG-Premier League,2020,Tottenham,Dele Alli,ENG,MF,24,1996,6.9,18,11,8,6,4,7,19,36.8,12,9,0,9,7,25,3,0,defense
ENG-Premier League,2020,Tottenham,Eric Dier,ENG,DF,26,1994,28.0,23,14,13,10,0,11,18,61.1,7,37,31,6,23,46,123,3,defense
ENG-Premier League,2020,Tottenham,Gareth Bale,WAL,FW,31,1989,10.2,17,10,4,9,4,7,14,50.0,7,13,2,11,8,25,16,0,defense
ENG-Premier League,2020,Tottenham,Giovani Lo Celso,ARG,MF,24,1996,10.5,28,22,12,11,5,10,29,34.5,19,12,1,11,7,35,5,0,defense
ENG-Premier League,2020,Tottenham,Harry Kane,ENG,FW,27,1993,34.2,22,12,1,17,4,8,26,30.8,18,28,11,17,11,33,40,0,defense
ENG-Premier League,2020,Tottenham,Harry Winks,ENG,MF,24,1996,9.6,16,9,11,5,0,5,20,25.0,15,16,4,12,11,27,12,1,defense
ENG-Premier League,2020,Tottenham,Hugo Lloris,FRA,GK,33,1986,38.0,0,0,0,0,0,0,1,0.0,1,0,0,0,0,0,10,1,defense
ENG-Premier League,2020,Tottenham,Japhet Tanganga,ENG,DF,21,1999,5.4,5,4,3,2,0,1,3,33.3,2,6,5,1,3,8,15,0,defense
ENG-Premier League,2020,Tottenham,Joe Rodon,WAL,DF,22,1997,8.1,14,9,11,2,1,3,4,75.0,1,10,8,2,21,35,36,2,defense
ENG-Premier League,2020,Tottenham,Lucas Moura,BRA,"FW,MF",27,1992,15.7,32,16,12,16,4,8,29,27.6,21,12,0,12,18,50,10,0,defense
ENG-Premier League,2020,Tottenham,Matt Doherty,IRL,DF,28,1992,13.8,29,15,15,10,4,13,33,39.4,20,20,5,15,23,52,46,0,defense
ENG-Premier League,2020,Tottenham,Moussa Sissoko,FRA,MF,30,1989,17.6,22,16,19,3,0,8,20,40.0,12,11,4,7,23,45,25,0,defense
ENG-Premier League,2020,Tottenham,Pierre Højbjerg,DEN,MF,24,1995,38.0,98,51,45,42,11,54,129,41.9,75,51,9,42,48,146,66,0,defense
ENG-Premier League,2020,Tottenham,Serge Aurier,CIV,DF,27,1992,17.8,55,33,33,17,5,15,40,37.5,25,28,5,23,19,74,44,3,defense
ENG-Premier League,2020,Tottenham,Sergio Reguilón,ESP,DF,23,1996,24.9,47,25,30,13,4,23,48,47.9,25,39,7,32,32,79,50,1,defense
ENG-Premier League,2020,Tottenham,Son Heung-min,KOR,FW,28,1992,34.6,32,18,11,14,7,18,72,25.0,54,28,3,25,14,46,8,0,defense
ENG-Premier League,2020,Tottenham,Steven Bergwijn,NED,"FW,MF",22,1997,13.4,15,7,8,3,4,7,20,35.0,13,7,1,6,5,20,9,0,defense
ENG-Premier League,2020,Tottenham,Tanguy Ndombele,FRA,MF,23,1996,23.2,41,20,11,21,9,18,44,40.9,26,28,4,24,19,60,15,0,defense
ENG-Premier League,2020,Tottenham,Toby Alderweireld,BEL,DF,31,1989,24.9,35,22,22,11,2,18,30,60.0,12,40,28,12,10,45,121,0,defense
ENG-Premier League,2020,Tottenham,Érik Lamela,ARG,"FW,MF",28,1992,8.0,17,9,1,11,5,8,21,38.1,13,11,1,10,6,23,2,0,defense
ENG-Premier League,2020,West Brom,Ahmed Hegazi,EGY,DF,29,1991,1.0,0,0,0,0,0,0,0,,0,2,0,2,1,1,7,0,defense
ENG-Premier League,2020,West Brom,Ainsley Maitland-Niles,ENG,MF,22,1997,13.7,22,10,7,8,7,9,28,32.1,19,12,1,11,17,39,24,0,defense
ENG-Premier League,2020,West Brom,Branislav Ivanović,SRB,DF,36,1984,8.5,14,5,11,3,0,7,13,53.8,6,11,5,6,8,22,25,0,defense
ENG-Premier League,2020,West Brom,Callum Robinson,IRL,"FW,MF",25,1995,17.3,7,5,5,1,1,3,19,15.8,16,9,0,9,7,14,8,0,defense
ENG-Premier League,2020,West Brom,Charlie Austin,ENG,"FW,MF",31,1989,1.5,4,2,1,2,1,1,3,33.3,2,0,0,0,3,7,4,0,defense
ENG-Premier League,2020,West Brom,Conor Gallagher,ENG,MF,20,2000,28.1,81,41,30,39,12,29,97,29.9,68,47,8,39,27,108,31,0,defense
ENG-Premier League,2020,West Brom,Conor Townsend,ENG,DF,27,1993,24.8,44,28,32,9,3,30,49,61.2,19,38,15,23,36,80,55,2,defense
ENG-Premier League,2020,West Brom,Dara O'Shea,IRL,DF,21,1999,23.4,45,25,30,13,2,21,45,46.7,24,32,17,15,45,90,108,0,defense
ENG-Premier League,2020,West Brom,Darnell Furlong,ENG,DF,24,1995,32.6,45,27,27,12,6,21,44,47.7,23,39,16,23,49,94,90,0,defense
ENG-Premier League,2020,West Brom,David Button,ENG,GK,31,1989,1.0,0,0,0,0,0,0,0,,0,0,0,0,0,0,0,0,defense
ENG-Premier League,2020,West Brom,Filip Krovinović,CRO,MF,24,1995,6.1,13,10,6,5,2,6,18,33.3,12,2,0,2,4,17,2,0,defense
ENG-Premier League,2020,West Brom,Grady Diangana,COD,"MF,FW",22,1998,13.7,35,19,19,9,7,19,43,44.2,24,16,2,14,16,51,9,0,defense
ENG-Premier League,2020,West Brom,Hal Robson-Kanu,WAL,FW,31,1989,6.2,2,1,1,0,1,0,1,0.0,1,2,0,2,2,4,7,0,defense
ENG-Premier League,2020,West Brom,Jake Livermore,ENG,MF,30,1989,13.8,33,18,14,16,3,14,31,45.2,17,21,6,15,16,49,26,0,defense
ENG-Premier League,2020,West Brom,Kamil Grosicki,POL,"MF,FW",32,1988,1.6,2,1,2,0,0,2,8,25.0,6,1,0,1,2,4,1,0,defense
ENG-Premier League,2020,West Brom,Karlan Grant,ENG,"FW,MF",22,1997,12.5,5,3,3,2,0,2,4,50.0,2,7,0,7,5,10,17,0,defense
ENG-Premier League,2020,West Brom,Kieran Gibbs,ENG,DF,30,1989,9.0,15,11,11,3,1,8,10,80.0,2,8,6,2,16,31,30,1,defense
ENG-Premier League,2020,West Brom,Kyle Bartley,ENG,DF,29,1991,28.7,27,16,14,10,3,11,23,47.8,12,50,35,15,38,65,159,1,defense
ENG-Premier League,2020,West Brom,Kyle Edwards,ENG,"MF,FW",22,1998,1.3,3,2,1,1,1,0,0,,0,2,0,2,1,4,0,0,defense
ENG-Premier League,2020,West Brom,Lee Peltier,ENG,DF,33,1986,2.5,9,4,8,1,0,4,4,100.0,0,1,1,0,1,10,11,0,defense
ENG-Premier League,2020,West Brom,Matheus Pereira,BRA,"MF,FW",24,1996,28.6,26,15,14,10,2,12,54,22.2,42,18,0,18,29,55,16,0,defense
ENG-Premier League,2020,West Brom,Matt Phillips,SCO,MF,29,1991,20.3,15,8,4,11,0,7,23,30.4,16,32,4,28,10,25,32,1,defense
ENG-Premier League,2020,West Brom,Mbaye Diagne,SEN,FW,28,1991,13.2,4,3,3,0,1,1,4,25.0,3,2,1,1,1,5,16,0,defense
ENG-Premier League,2020,West Brom,Okay Yokuşlu,TUR,MF,26,1994,14.6,38,25,21,13,4,17,35,48.6,18,15,3,12,35,73,33,1,defense
ENG-Premier League,2020,West Brom,Rekeem Harper,ENG,MF,20,2000,0.4,0,0,0,0,0,0,0,,0,2,0,2,1,1,0,0,defense
ENG-Premier League,2020,West Brom,Robert Snodgrass,SCO,"MF,FW",32,1987,5.8,17,12,12,4,1,10,16,62.5,6,11,2,9,1,18,12,0,defense
ENG-Premier League,2020,West Brom,Romaine Sawyers,SKN,MF,28,1991,16.5,30,18,16,12,2,14,43,32.6,29,20,4,16,18,48,12,3,defense
ENG-Premier League,2020,West Brom,Sam Field,ENG,MF,22,1998,0.7,5,5,3,2,0,0,0,,0,4,1,3,2,7,4,0,defense
ENG-Premier League,2020,West Brom,Sam Johnstone,ENG,GK,27,1993,37.0,0,0,0,0,0,0,0,,0,0,0,0,2,2,15,2,defense
ENG-Premier League,2020,West Brom,Semi Ajayi,NGA,DF,26,1993,30.9,40,14,34,6,0,23,41,56.1,18,51,32,19,42,82,122,2,defense
ENG-Premier League,2020,West Ham,Aaron Cresswell,ENG,DF,30,1989,35.2,32,13,15,15,2,18,32,56.3,14,29,14,15,32,64,79,2,defense
ENG-Premier League,2020,West Ham,Andriy Yarmolenko,UKR,"FW,MF",30,1989,4.2,5,4,2,2,1,2,8,25.0,6,1,0,1,1,6,2,0,defense
ENG-Premier League,2020,West Ham,Angelo Ogbonna,ITA,DF,32,1988,27.7,26,13,20,5,1,9,17,52.9,8,25,11,14,30,56,119,0,defense
ENG-Premier League,2020,West Ham,Arthur Masuaku,COD,"DF,MF",26,1993,11.2,20,12,14,6,0,11,34,32.4,23,12,0,12,8,28,28,2,defense
ENG-Premier League,2020,West Ham,Ben Johnson,ENG,"DF,FW",20,2000,5.8,11,5,5,3,3,7,9,77.8,2,5,1,4,11,22,9,0,defense
ENG-Premier League,2020,West Ham,Craig Dawson,ENG,DF,30,1990,21.4,11,8,7,4,0,5,12,41.7,7,26,22,4,32,43,88,3,defense
ENG-Premier League,2020,West Ham,Darren Randolph,IRL,GK,33,1987,3.0,0,0,0,0,0,0,0,,0,0,0,0,0,0,1,0,defense
ENG-Premier League,2020,West Ham,Declan Rice,ENG,MF,21,1999,32.0,59,35,33,25,1,21,51,41.2,30,39,11,28,59,118,41,0,defense
ENG-Premier League,2020,West Ham,Fabián Balbuena,PAR,DF,28,1991,13.3,24,12,23,1,0,14,23,60.9,9,23,6,17,25,49,63,0,defense
ENG-Premier League,2020,West Ham,Felipe Anderson,BRA,"FW,MF",27,1993,0.0,1,1,0,1,0,0,0,,0,0,0,0,0,1,0,0,defense
ENG-Premier League,2020,West Ham,Issa Diop,FRA,DF,23,1997,15.3,20,14,12,8,0,7,18,38.9,11,32,22,10,22,42,59,0,defense
ENG-Premier League,2020,West Ham,Jarrod Bowen,ENG,"FW,MF",23,1996,28.5,26,15,12,7,7,10,29,34.5,19,19,1,18,22,48,10,0,defense
ENG-Premier League,2020,West Ham,Jesse Lingard,ENG,"MF,FW",27,1992,15.8,12,6,4,8,0,5,14,35.7,9,7,1,6,4,16,0,0,defense
ENG-Premier League,2020,West Ham,Manuel Lanzini,ARG,"MF,FW",27,1993,6.3,9,2,3,4,2,3,10,30.0,7,9,0,9,7,16,5,0,defense
ENG-Premier League,2020,West Ham,Mark Noble,ENG,MF,33,1987,7.9,8,4,2,5,1,4,14,28.6,10,7,3,4,13,21,3,0,defense
ENG-Premier League,2020,West Ham,Michail Antonio,JAM,FW,30,1990,21.9,7,4,1,5,1,1,7,14.3,6,20,3,17,7,14,7,0,defense
ENG-Premier League,2020,West Ham,Pablo Fornals,ESP,"FW,MF",24,1996,28.6,44,26,14,24,6,11,73,15.1,62,43,1,42,36,80,9,0,defense
ENG-Premier League,2020,West Ham,Robert Snodgrass,SCO,"FW,MF",32,1987,0.1,0,0,0,0,0,0,0,,0,0,0,0,0,0,0,0,defense
ENG-Premier League,2020,West Ham,Ryan Fredericks,ENG,"DF,FW",27,1992,6.3,9,5,5,4,0,3,7,42.9,4,6,2,4,11,20,20,0,defense
ENG-Premier League,2020,West Ham,Saïd Benrahma,ALG,"FW,MF",24,1995,15.5,24,15,8,11,5,8,28,28.6,20,10,0,10,8,32,8,0,defense
ENG-Premier League,2020,West Ham,Sébastien Haller,CIV,FW,26,1994,10.4,14,9,1,6,7,4,20,20.0,16,7,1,6,5,19,7,0,defense
ENG-Premier League,2020,West Ham,Tomáš Souček,CZE,MF,25,1995,38.0,78,41,37,36,5,28,77,36.4,49,43,18,25,62,140,107,0,defense
ENG-Premier League,2020,West Ham,Vladimír Coufal,CZE,DF,27,1992,33.9,73,36,50,15,8,52,89,58.4,37,41,7,34,41,114,102,1,defense
ENG-Premier League,2020,West Ham,Łukasz Fabiański,POL,GK,35,1985,35.0,1,0,1,0,0,1,1,100.0,0,1,0,1,1,2,12,3,defense
ENG-Premier League,2020,Wolves,Adama Traoré,ESP,"FW,MF",24,1996,29.4,28,16,11,13,4,13,21,61.9,8,23,1,22,7,35,12,1,defense
ENG-Premier League,2020,Wolves,Conor Coady,ENG,DF,27,1993,36.7,35,23,25,10,0,19,35,54.3,16,40,32,8,27,62,134,2,defense
ENG-Premier League,2020,Wolves,Daniel Podence,POR,"MF,FW",24,1995,18.5,12,6,5,5,2,2,19,10.5,17,5,1,4,13,25,2,0,defense
ENG-Premier League,2020,Wolves,Fernando Marçal,BRA,"DF,MF",31,1989,6.9,13,5,6,7,0,6,11,54.5,5,11,2,9,12,25,25,0,defense
ENG-Premier League,2020,Wolves,Fábio Silva,POR,FW,18,2002,15.2,6,4,1,4,1,4,12,33.3,8,12,1,11,4,10,5,1,defense
ENG-Premier League,2020,Wolves,John Ruddy,ENG,GK,33,1986,1.0,0,0,0,0,0,0,0,,0,0,0,0,0,0,0,0,defense
ENG-Premier League,2020,Wolves,Jonny Castro,ESP,"MF,DF",26,1994,5.5,11,5,6,4,1,6,13,46.2,7,9,3,6,9,20,7,0,defense
ENG-Premier League,2020,Wolves,João Moutinho,POR,MF,33,1986,28.1,75,40,34,35,6,35,91,38.5,56,18,3,15,47,122,28,0,defense
ENG-Premier League,2020,Wolves,Ki-Jana Hoever,NED,"DF,MF",18,2002,6.4,14,6,11,2,1,10,22,45.5,12,2,0,2,9,23,23,0,defense
ENG-Premier League,2020,Wolves,Leander Dendoncker,BEL,"MF,DF",25,1995,27.8,54,29,29,22,3,31,60,51.7,29,38,15,23,27,81,52,2,defense
ENG-Premier League,2020,Wolves,Max Kilman,ENG,DF,23,1997,14.6,21,14,13,4,4,8,14,57.1,6,17,8,9,19,40,46,0,defense
ENG-Premier League,2020,Wolves,Morgan Gibbs-White,ENG,"MF,FW",20,2000,4.6,9,7,3,4,2,5,12,41.7,7,6,0,6,3,12,1,0,defense
ENG-Premier League,2020,Wolves,Nélson Semedo,POR,"DF,MF",26,1993,33.1,85,48,53,23,9,42,72,58.3,30,30,10,20,41,126,78,2,defense
ENG-Premier League,2020,Wolves,Oskar Buur,DEN,DF,22,1998,0.2,0,0,0,0,0,0,2,0.0,2,0,0,0,0,0,0,0,defense
ENG-Premier League,2020,Wolves,Owen Otasowie,USA,"MF,FW",19,2001,2.1,5,5,3,2,0,1,2,50.0,1,1,1,0,3,8,4,0,defense
ENG-Premier League,2020,Wolves,Patrick Cutrone,ITA,FW,22,1998,0.3,0,0,0,0,0,0,0,,0,0,0,0,0,0,0,0,defense
ENG-Premier League,2020,Wolves,Pedro Neto,POR,"FW,MF",20,2000,28.3,16,9,4,6,6,6,28,21.4,22,18,2,16,31,47,8,0,defense
ENG-Premier League,2020,Wolves,Rayan Aït-Nouri,ALG,DF,19,2001,15.6,29,16,18,10,1,13,27,48.1,14,14,1,13,15,44,25,0,defense
ENG-Premier League,2020,Wolves,Raúl Jiménez,MEX,FW,29,1991,9.1,3,2,1,2,0,0,7,0.0,7,2,0,2,8,11,12,0,defense
ENG-Premier League,2020,Wolves,Romain Saïss,MAR,DF,30,1990,26.7,35,24,23,12,0,19,33,57.6,14,28,13,15,52,87,115,1,defense
ENG-Premier League,2020,Wolves,Rui Patrício,POR,GK,32,1988,37.0,0,0,0,0,0,0,1,0.0,1,0,0,0,1,1,3,3,defense
ENG-Premier League,2020,Wolves,Rúben Neves,POR,MF,23,1997,29.7,86,46,42,38,6,36,88,40.9,52,55,11,44,65,151,46,2,defense
ENG-Premier League,2020,Wolves,Rúben Vinagre,POR,"MF,DF",21,1999,1.9,7,5,5,2,0,3,4,75.0,1,3,0,3,2,9,4,0,defense
ENG-Premier League,2020,Wolves,Theo Corbeanu,CAN,FW,18,2002,0.1,2,1,0,2,0,1,1,100.0,0,0,0,0,1,3,0,0,defense
ENG-Premier League,2020,Wolves,Vitinha,POR,MF,20,2000,5.8,7,3,2,5,0,3,8,37.5,5,3,0,3,3,10,1,0,defense
ENG-Premier League,2020,Wolves,Willian José,BRA,FW,28,1991,12.3,2,1,1,1,0,1,4,25.0,3,6,1,5,1,3,12,0,defense
ENG-Premier League,2020,Wolves,Willy Boly,CIV,DF,29,1991,20.9,33,20,26,7,0,13,24,54.2,11,18,12,6,32,65,84,1,defense
