league,season,team,player,nation,pos,age,born,90s,Tackles Tkl,Tackles TklW,Tackles Def 3rd,Tackles Mid 3rd,Tackles Att 3rd,Challenges Tkl,Challenges Att,Challenges Tkl%,Challenges Lost,Blocks Blocks,Blocks Sh,Blocks Pass,Int,Tkl+Int,Clr,Err,stat_type
GER-Bundesliga,2024,Augsburg,Arne Engels,BEL,"MF,FW",21-215,2003.0,0.9,0,0,0,0,0,0,0,,0,1,1,0,0,0,0,0,defense
GER-Bundesliga,2024,Augsburg,Arne Maier,GER,MF,26-093,1999.0,9.2,12,6,4,8,0,7,12,58.3,5,15,1,14,4,16,12,1,defense
GER-Bundesliga,2024,Augsburg,Cedric Zesiger,SUI,DF,26-291,1998.0,9.1,7,4,5,2,0,5,7,71.4,2,12,6,6,16,23,67,1,defense
GER-Bundesliga,2024,Augsburg,Chrislain Matsima,FRA,DF,22-331,2002.0,22.3,19,14,11,7,1,10,18,55.6,8,39,24,15,46,65,134,0,defense
GER-Bundesliga,2024,Augsburg,Dimitris Giannoulis,GRE,DF,29-176,1995.0,23.8,41,27,24,14,3,23,40,57.5,17,41,10,31,37,78,61,0,defense
GER-Bundesliga,2024,Augsburg,Elvis Rexhbeçaj,KVX,MF,27-161,1997.0,18.5,25,18,7,14,4,14,33,42.4,19,36,9,27,16,41,19,1,defense
GER-Bundesliga,2024,Augsburg,Finn Dahmen,GER,GK,27-015,1998.0,13.0,1,0,1,0,0,1,1,100.0,0,0,0,0,0,1,5,0,defense
GER-Bundesliga,2024,Augsburg,Frank Onyeka,NGA,MF,27-100,1998.0,23.1,50,40,19,25,6,18,35,51.4,17,32,9,23,32,82,31,1,defense
GER-Bundesliga,2024,Augsburg,Fredrik Jensen,FIN,MF,27-214,1997.0,7.2,5,5,1,2,2,3,4,75.0,1,8,1,7,4,9,15,0,defense
GER-Bundesliga,2024,Augsburg,Henri Koudossou,GER,DF,25-220,1999.0,6.9,17,10,6,10,1,11,18,61.1,7,8,2,6,12,29,33,0,defense
GER-Bundesliga,2024,Augsburg,Jeffrey Gouweleeuw,NED,DF,33-275,1991.0,26.7,42,23,22,16,4,22,32,68.8,10,29,12,17,29,71,151,0,defense
GER-Bundesliga,2024,Augsburg,Keven Schlotterbeck,GER,DF,27-348,1997.0,13.4,18,16,9,9,0,11,15,73.3,4,11,5,6,14,32,66,1,defense
GER-Bundesliga,2024,Augsburg,Kristijan Jakić,CRO,MF,27-332,1997.0,20.0,39,18,18,16,5,20,35,57.1,15,35,6,29,26,65,41,1,defense
GER-Bundesliga,2024,Augsburg,Mads Pedersen,DEN,DF,28-222,1996.0,2.6,8,7,5,2,1,4,5,80.0,1,4,0,4,2,10,6,0,defense
GER-Bundesliga,2024,Augsburg,Marius Wolf,GER,DF,29-319,1995.0,20.2,24,14,10,11,3,14,35,40.0,21,24,5,19,20,44,45,1,defense
GER-Bundesliga,2024,Augsburg,Maximilian Bauer,GER,DF,25-061,2000.0,7.3,14,8,5,7,2,9,14,64.3,5,10,4,6,6,20,35,1,defense
GER-Bundesliga,2024,Augsburg,Mergim Berisha,GER,FW,26-335,1998.0,0.1,1,0,0,1,0,1,1,100.0,0,0,0,0,0,1,0,0,defense
GER-Bundesliga,2024,Augsburg,Mert Kömür,GER,MF,19-268,2005.0,4.0,3,2,2,0,1,0,0,,0,5,2,3,3,6,4,1,defense
GER-Bundesliga,2024,Augsburg,Nediljko Labrović,CRO,GK,25-183,1999.0,15.0,0,0,0,0,0,0,0,,0,0,0,0,0,0,12,1,defense
GER-Bundesliga,2024,Augsburg,Niklas Dorsch,GER,MF,27-086,1998.0,0.4,0,0,0,0,0,0,0,,0,1,0,1,0,0,0,0,defense
GER-Bundesliga,2024,Augsburg,Noahkai Banks,USA,DF,18-131,2006.0,3.1,11,5,6,4,1,3,7,42.9,4,4,1,3,5,16,28,0,defense
GER-Bundesliga,2024,Augsburg,Phillip Tietz,GER,FW,27-276,1997.0,16.5,11,6,2,7,2,5,8,62.5,3,7,1,6,4,15,24,0,defense
GER-Bundesliga,2024,Augsburg,Robert Gumny,POL,DF,26-311,1998.0,1.6,2,2,1,1,0,1,3,33.3,2,1,0,1,0,2,5,0,defense
GER-Bundesliga,2024,Augsburg,Ruben Vargas,SUI,"MF,FW",26-249,1998.0,3.4,2,1,1,1,0,1,4,25.0,3,1,0,1,2,4,1,1,defense
GER-Bundesliga,2024,Augsburg,Samuel Essende,COD,FW,27-078,1998.0,15.3,6,5,1,3,2,3,4,75.0,1,12,2,10,0,6,8,0,defense
GER-Bundesliga,2024,Augsburg,Steve Mounié,BEN,"FW,MF",30-194,1994.0,3.3,3,3,0,1,2,0,1,0.0,1,1,1,0,1,4,4,1,defense
GER-Bundesliga,2024,Augsburg,Tim Breithaupt,GER,MF,23-063,2002.0,1.3,1,1,0,1,0,0,4,0.0,4,1,0,1,2,3,0,0,defense
GER-Bundesliga,2024,Augsburg,Yusuf Kabadayı,GER,"FW,MF",21-068,2004.0,0.8,1,0,0,1,0,0,0,,0,1,0,1,0,1,0,0,defense
GER-Bundesliga,2024,Bayern Munich,Adam Aznou,MAR,DF,18-313,2006.0,0.2,0,0,0,0,0,0,0,,0,0,0,0,0,0,1,0,defense
GER-Bundesliga,2024,Bayern Munich,Aleksandar Pavlovic,GER,MF,20-343,2004.0,11.6,30,16,9,13,8,18,27,66.7,9,17,3,14,3,33,9,0,defense
GER-Bundesliga,2024,Bayern Munich,Alphonso Davies,CAN,DF,24-160,2000.0,17.3,30,17,7,17,6,17,26,65.4,9,14,1,13,13,43,22,2,defense
GER-Bundesliga,2024,Bayern Munich,Arijon Ibrahimović,GER,FW,19-121,2005.0,0.0,0,0,0,0,0,0,0,,0,0,0,0,0,0,0,0,defense
GER-Bundesliga,2024,Bayern Munich,Daniel Peretz,ISR,GK,24-275,2000.0,3.0,0,0,0,0,0,0,1,0.0,1,0,0,0,0,0,2,0,defense
GER-Bundesliga,2024,Bayern Munich,Dayot Upamecano,FRA,DF,26-166,1998.0,19.5,36,22,18,16,2,16,29,55.2,13,17,7,10,34,70,45,1,defense
GER-Bundesliga,2024,Bayern Munich,Eric Dier,ENG,DF,31-086,1994.0,10.3,15,9,6,7,2,10,14,71.4,4,12,5,7,13,28,44,0,defense
GER-Bundesliga,2024,Bayern Munich,Gabriel Vidovic,CRO,MF,21-131,2003.0,0.0,0,0,0,0,0,0,0,,0,0,0,0,0,0,0,0,defense
GER-Bundesliga,2024,Bayern Munich,Harry Kane,ENG,FW,31-257,1993.0,22.5,10,9,3,5,2,2,5,40.0,3,12,2,10,2,12,11,0,defense
GER-Bundesliga,2024,Bayern Munich,Hiroki Ito,JPN,DF,25-334,1999.0,2.8,2,0,1,1,0,1,1,100.0,0,3,2,1,6,8,15,1,defense
GER-Bundesliga,2024,Bayern Munich,Jamal Musiala,GER,MF,22-044,2003.0,20.0,36,21,7,16,13,12,29,41.4,17,30,0,30,8,44,5,1,defense
GER-Bundesliga,2024,Bayern Munich,Jonas Urbig,GER,GK,21-246,2003.0,4.0,0,0,0,0,0,0,0,,0,0,0,0,0,0,4,1,defense
GER-Bundesliga,2024,Bayern Munich,Joshua Kimmich,GER,MF,30-062,1995.0,25.6,42,26,10,25,7,27,42,64.3,15,20,3,17,20,62,25,3,defense
GER-Bundesliga,2024,Bayern Munich,Josip Stanišić,CRO,DF,25-009,2000.0,4.1,8,7,3,3,2,4,6,66.7,2,4,1,3,4,12,13,1,defense
GER-Bundesliga,2024,Bayern Munich,João Palhinha,POR,MF,29-276,1995.0,7.3,19,14,5,11,3,10,14,71.4,4,12,1,11,4,23,9,1,defense
GER-Bundesliga,2024,Bayern Munich,Kim Min-jae,KOR,DF,28-147,1996.0,24.3,34,19,17,13,4,11,20,55.0,9,22,10,12,32,66,85,3,defense
GER-Bundesliga,2024,Bayern Munich,Kingsley Coman,FRA,FW,28-302,1996.0,11.5,15,10,5,5,5,6,10,60.0,4,7,0,7,7,22,14,0,defense
GER-Bundesliga,2024,Bayern Munich,Konrad Laimer,AUT,DF,27-319,1997.0,13.6,36,20,14,16,6,19,44,43.2,25,18,1,17,6,42,16,1,defense
GER-Bundesliga,2024,Bayern Munich,Leon Goretzka,GER,MF,30-064,1995.0,12.4,17,9,4,12,1,8,17,47.1,9,21,4,17,13,30,19,1,defense
GER-Bundesliga,2024,Bayern Munich,Leroy Sané,GER,FW,29-090,1996.0,14.6,18,12,3,7,8,8,14,57.1,6,7,0,7,6,24,1,0,defense
GER-Bundesliga,2024,Bayern Munich,Manuel Neuer,GER,GK,39-015,1986.0,20.0,1,0,1,0,0,1,1,100.0,0,0,0,0,0,1,8,1,defense
GER-Bundesliga,2024,Bayern Munich,Mathys Tel,FRA,"FW,MF",19-349,2005.0,2.8,2,2,0,2,0,0,0,,0,0,0,0,1,3,1,0,defense
GER-Bundesliga,2024,Bayern Munich,Michael Olise,FRA,"FW,MF",23-120,2001.0,20.1,31,18,8,20,3,14,28,50.0,14,20,1,19,6,37,12,2,defense
GER-Bundesliga,2024,Bayern Munich,Raphaël Guerreiro,POR,"DF,MF",31-110,1993.0,14.5,17,10,9,5,3,11,15,73.3,4,8,0,8,9,26,13,1,defense
GER-Bundesliga,2024,Bayern Munich,Sacha Boey,FRA,DF,24-210,2000.0,4.7,14,4,5,2,7,7,10,70.0,3,3,0,3,2,16,7,0,defense
GER-Bundesliga,2024,Bayern Munich,Serge Gnabry,GER,"FW,MF",29-271,1995.0,9.7,15,9,6,4,5,7,11,63.6,4,8,0,8,5,20,7,0,defense
GER-Bundesliga,2024,Bayern Munich,Sven Ulreich,GER,GK,36-251,1988.0,1.0,0,0,0,0,0,0,0,,0,0,0,0,0,0,0,0,defense
GER-Bundesliga,2024,Bayern Munich,Thomas Müller,GER,"MF,FW",35-210,1989.0,10.1,5,3,1,2,2,2,12,16.7,10,7,0,7,1,6,9,0,defense
GER-Bundesliga,2024,Bochum,Aliou Badara Baldé,GUI,"MF,FW",22-120,2002.0,1.0,1,1,1,0,0,0,0,,0,2,0,2,0,1,0,0,defense
GER-Bundesliga,2024,Bochum,Anthony Losilla,FRA,MF,39-032,1986.0,12.0,28,16,14,11,3,16,32,50.0,16,21,7,14,18,46,25,1,defense
GER-Bundesliga,2024,Bochum,Bernardo,BRA,DF,29-332,1995.0,13.8,39,22,29,9,1,23,30,76.7,7,27,12,15,17,56,67,1,defense
GER-Bundesliga,2024,Bochum,Cristian Gamboa,CRC,DF,35-169,1989.0,1.8,6,2,5,1,0,3,9,33.3,6,0,0,0,1,7,5,0,defense
GER-Bundesliga,2024,Bochum,Dani de Wit,NED,"MF,FW",27-073,1998.0,11.8,24,13,8,13,3,15,27,55.6,12,15,4,11,11,35,21,1,defense
GER-Bundesliga,2024,Bochum,Erhan Mašović,SRB,DF,26-140,1998.0,10.0,14,10,10,4,0,13,28,46.4,15,17,11,6,12,26,52,0,defense
GER-Bundesliga,2024,Bochum,Felix Passlack,GER,"DF,MF",26-317,1998.0,21.7,49,22,29,13,7,29,52,55.8,23,38,10,28,16,65,52,1,defense
GER-Bundesliga,2024,Bochum,Gerrit Holtmann,PHI,"DF,FW",30-017,1995.0,10.9,21,17,13,7,1,10,20,50.0,10,13,3,10,16,37,14,0,defense
GER-Bundesliga,2024,Bochum,Giorgos Masouras,GRE,"FW,MF",31-100,1994.0,6.8,12,7,2,5,5,6,13,46.2,7,8,1,7,3,15,0,0,defense
GER-Bundesliga,2024,Bochum,Ibrahima Sissoko,MLI,MF,27-166,1997.0,24.7,55,37,27,23,5,23,42,54.8,19,28,8,20,33,88,50,0,defense
GER-Bundesliga,2024,Bochum,Ivan Ordets,UKR,DF,32-277,1992.0,17.7,17,7,13,4,0,10,12,83.3,2,23,11,12,35,52,116,3,defense
GER-Bundesliga,2024,Bochum,Jakov Medić,CRO,DF,26-216,1998.0,14.9,12,10,9,2,1,7,16,43.8,9,29,19,10,17,29,88,4,defense
GER-Bundesliga,2024,Bochum,Koji Miyoshi,JPN,"FW,MF",28-016,1997.0,5.0,8,5,2,1,5,4,9,44.4,5,10,1,9,2,10,2,0,defense
GER-Bundesliga,2024,Bochum,Lukas Daschner,GER,"MF,FW",26-192,1998.0,4.6,4,2,1,2,1,2,9,22.2,7,5,0,5,0,4,5,0,defense
GER-Bundesliga,2024,Bochum,Mats Pannewig,GER,MF,20-165,2004.0,1.5,3,2,2,1,0,1,8,12.5,7,6,1,5,1,4,4,0,defense
GER-Bundesliga,2024,Bochum,Matúš Bero,SVK,MF,29-217,1995.0,24.0,51,26,24,18,9,24,52,46.2,28,33,8,25,15,66,31,1,defense
GER-Bundesliga,2024,Bochum,Maximilian Wittek,GER,DF,29-233,1995.0,24.1,53,36,33,16,4,33,46,71.7,13,50,8,42,25,78,75,2,defense
GER-Bundesliga,2024,Bochum,Moritz Broschinski,GER,"FW,MF",24-200,2000.0,14.2,18,14,6,6,6,5,14,35.7,9,16,0,16,1,19,17,0,defense
GER-Bundesliga,2024,Bochum,Moritz-Broni Kwarteng,GHA,"MF,FW",26-348,1998.0,1.9,4,3,1,1,2,1,2,50.0,1,0,0,0,0,4,1,0,defense
GER-Bundesliga,2024,Bochum,Myron Boadu,NED,FW,24-087,2001.0,7.5,2,1,0,0,2,1,4,25.0,3,1,0,1,0,2,3,0,defense
GER-Bundesliga,2024,Bochum,Patrick Drewes,GER,GK,32-066,1993.0,21.0,0,0,0,0,0,0,1,0.0,1,1,0,1,0,0,11,1,defense
GER-Bundesliga,2024,Bochum,Philipp Hofmann,GER,FW,32-012,1993.0,22.7,14,12,4,5,5,6,13,46.2,7,10,0,10,4,18,27,0,defense
GER-Bundesliga,2024,Bochum,Samuel Bamba,GER,"FW,DF",21-057,2004.0,0.2,0,0,0,0,0,0,0,,0,0,0,0,0,0,0,0,defense
GER-Bundesliga,2024,Bochum,Tim Oermann,GER,DF,21-187,2003.0,18.9,39,22,20,17,2,20,35,57.1,15,28,13,15,19,58,47,0,defense
GER-Bundesliga,2024,Bochum,Timo Horn,GER,GK,31-334,1993.0,7.0,0,0,0,0,0,0,0,,0,0,0,0,0,0,5,1,defense
GER-Bundesliga,2024,Bochum,Tom Krauß,GER,MF,23-293,2001.0,7.5,25,11,16,7,2,14,28,50.0,14,17,2,15,6,31,12,1,defense
GER-Bundesliga,2024,Dortmund,Alexander Meyer,GER,GK,33-363,1991.0,2.0,0,0,0,0,0,0,0,,0,0,0,0,0,0,0,0,defense
GER-Bundesliga,2024,Dortmund,Almugera Kabar,GER,DF,18-309,2006.0,1.5,5,3,2,2,1,3,3,100.0,0,1,0,1,1,6,4,0,defense
GER-Bundesliga,2024,Dortmund,Ayman Azhil,MAR,MF,24-001,2001.0,0.3,1,1,1,0,0,0,0,,0,0,0,0,0,1,0,0,defense
GER-Bundesliga,2024,Dortmund,Carney Chukwuemeka,ENG,MF,21-173,2003.0,1.5,2,2,1,1,0,0,0,,0,3,0,3,0,2,1,0,defense
GER-Bundesliga,2024,Dortmund,Cole Campbell,USA,"MF,FW",19-050,2006.0,0.2,0,0,0,0,0,0,0,,0,0,0,0,0,0,1,0,defense
GER-Bundesliga,2024,Dortmund,Daniel Svensson,SWE,"DF,FW",23-058,2002.0,2.7,7,5,3,2,2,3,3,100.0,0,5,2,3,1,8,11,0,defense
GER-Bundesliga,2024,Dortmund,Donyell Malen,NED,"FW,MF",26-092,1999.0,6.8,0,0,0,0,0,0,2,0.0,2,2,0,2,3,3,6,0,defense
GER-Bundesliga,2024,Dortmund,Emre Can,GER,"DF,MF",31-089,1994.0,20.7,45,26,29,13,3,17,31,54.8,14,23,16,7,18,63,79,3,defense
GER-Bundesliga,2024,Dortmund,Felix Nmecha,GER,MF,24-183,2000.0,12.8,27,18,3,16,8,9,16,56.3,7,18,5,13,18,45,26,0,defense
GER-Bundesliga,2024,Dortmund,Gio Reyna,USA,MF,22-149,2002.0,3.6,6,0,3,0,3,3,4,75.0,1,3,1,2,0,6,9,0,defense
GER-Bundesliga,2024,Dortmund,Gregor Kobel,SUI,GK,27-126,1997.0,26.0,0,0,0,0,0,0,0,,0,0,0,0,0,0,16,3,defense
GER-Bundesliga,2024,Dortmund,Jamie Gittens,ENG,"FW,MF",20-246,2004.0,18.1,27,17,9,11,7,13,17,76.5,4,15,0,15,8,35,4,0,defense
GER-Bundesliga,2024,Dortmund,Julian Brandt,GER,MF,28-344,1996.0,21.0,18,9,9,7,2,12,29,41.4,17,15,0,15,14,32,12,1,defense
GER-Bundesliga,2024,Dortmund,Julian Ryerson,NOR,DF,27-145,1997.0,20.0,38,24,22,10,6,20,34,58.8,14,26,2,24,18,56,21,1,defense
GER-Bundesliga,2024,Dortmund,Julien Duranville,BEL,"FW,MF",18-341,2006.0,2.9,3,0,0,3,0,1,1,100.0,0,1,0,1,0,3,3,0,defense
GER-Bundesliga,2024,Dortmund,Karim Adeyemi,GER,"FW,MF",23-083,2002.0,12.9,17,14,5,6,6,7,14,50.0,7,12,1,11,5,22,5,0,defense
GER-Bundesliga,2024,Dortmund,Kjell-Arik Wätjen,GER,MF,19-054,2006.0,0.2,0,0,0,0,0,0,0,,0,0,0,0,0,0,2,0,defense
GER-Bundesliga,2024,Dortmund,Marcel Sabitzer,AUT,"MF,FW",31-025,1994.0,16.4,27,17,7,14,6,15,25,60.0,10,18,6,12,10,37,29,1,defense
GER-Bundesliga,2024,Dortmund,Maximilian Beier,GER,"FW,MF",22-176,2002.0,16.4,25,16,8,11,6,12,31,38.7,19,15,1,14,7,32,14,1,defense
GER-Bundesliga,2024,Dortmund,Nico Schlotterbeck,GER,DF,25-131,1999.0,22.0,38,24,21,16,1,27,45,60.0,18,31,15,16,22,60,79,1,defense
GER-Bundesliga,2024,Dortmund,Niklas Süle,GER,DF,29-220,1995.0,6.3,7,6,5,2,0,6,8,75.0,2,5,3,2,2,9,29,1,defense
GER-Bundesliga,2024,Dortmund,Pascal Groß,GER,"MF,DF",33-300,1991.0,22.1,42,27,11,24,7,13,44,29.5,31,33,7,26,8,50,24,1,defense
GER-Bundesliga,2024,Dortmund,Ramy Bensebaini,ALG,DF,29-360,1995.0,17.4,38,16,20,13,5,25,40,62.5,15,35,6,29,20,58,60,1,defense
GER-Bundesliga,2024,Dortmund,Salih Özcan,TUR,"MF,DF",27-090,1998.0,3.0,9,7,5,3,1,6,9,66.7,3,7,0,7,7,16,7,0,defense
GER-Bundesliga,2024,Dortmund,Serhou Guirassy,GUI,FW,29-030,1996.0,23.0,3,2,1,0,2,0,1,0.0,1,8,3,5,4,7,30,0,defense
GER-Bundesliga,2024,Dortmund,Waldemar Anton,GER,DF,28-265,1996.0,15.7,27,18,12,9,6,15,20,75.0,5,25,13,12,16,43,66,1,defense
GER-Bundesliga,2024,Dortmund,Yan Couto,BRA,"DF,FW",22-312,2002.0,9.1,23,15,17,2,4,14,24,58.3,10,12,1,11,9,32,28,2,defense
GER-Bundesliga,2024,Dortmund,Yannik Lührs,GER,DF,21-214,2003.0,1.4,1,1,1,0,0,0,0,,0,0,0,0,2,3,4,0,defense
GER-Bundesliga,2024,Eint Frankfurt,Ansgar Knauff,GER,"MF,DF",23-091,2002.0,13.8,35,19,17,12,6,10,23,43.5,13,22,4,18,11,46,20,0,defense
GER-Bundesliga,2024,Eint Frankfurt,Arthur Theate,BEL,DF,24-321,2000.0,24.5,31,21,16,14,1,17,35,48.6,18,38,19,19,32,63,141,3,defense
GER-Bundesliga,2024,Eint Frankfurt,Aurele Amenda,SUI,DF,21-254,2003.0,0.9,0,0,0,0,0,0,0,,0,2,2,0,1,1,7,0,defense
GER-Bundesliga,2024,Eint Frankfurt,Can Uzun,TUR,"MF,FW",19-151,2005.0,6.3,8,3,1,3,4,5,9,55.6,4,8,0,8,1,9,3,0,defense
GER-Bundesliga,2024,Eint Frankfurt,Ellyes Skhiri,TUN,MF,29-336,1995.0,19.1,26,15,9,14,3,12,34,35.3,22,25,6,19,26,52,36,3,defense
GER-Bundesliga,2024,Eint Frankfurt,Elye Wahi,FRA,"FW,MF",22-099,2003.0,1.8,0,0,0,0,0,0,1,0.0,1,1,0,1,0,0,1,0,defense
GER-Bundesliga,2024,Eint Frankfurt,Fares Chaïbi,ALG,"MF,FW",22-134,2002.0,8.5,12,8,4,4,4,7,16,43.8,9,9,0,9,8,20,28,1,defense
GER-Bundesliga,2024,Eint Frankfurt,Hugo Ekitike,FRA,FW,22-295,2002.0,22.8,14,11,3,6,5,4,11,36.4,7,12,1,11,7,21,22,0,defense
GER-Bundesliga,2024,Eint Frankfurt,Hugo Larsson,SWE,MF,20-288,2004.0,21.4,36,23,16,16,4,17,35,48.6,18,33,8,25,23,59,26,1,defense
GER-Bundesliga,2024,Eint Frankfurt,Igor Matanovic,CRO,FW,22-011,2003.0,3.5,2,0,0,2,0,0,1,0.0,1,3,0,3,1,3,9,0,defense
GER-Bundesliga,2024,Eint Frankfurt,Jean Mattéo Bahoya,FRA,"MF,FW",19-339,2005.0,6.8,22,13,10,8,4,12,22,54.5,10,7,1,6,4,26,8,1,defense
GER-Bundesliga,2024,Eint Frankfurt,Junior Dina Ebimbe,FRA,"MF,FW",24-141,2000.0,3.3,3,2,1,2,0,1,3,33.3,2,4,0,4,7,10,6,0,defense
GER-Bundesliga,2024,Eint Frankfurt,Kauã Santos,BRA,GK,22-000,2003.0,7.5,0,0,0,0,0,0,0,,0,0,0,0,0,0,9,2,defense
GER-Bundesliga,2024,Eint Frankfurt,Kevin Trapp,GER,GK,34-277,1990.0,20.5,0,0,0,0,0,0,0,,0,0,0,0,0,0,9,3,defense
GER-Bundesliga,2024,Eint Frankfurt,Mahmoud Dahoud,GER,MF,29-100,1996.0,4.0,9,4,4,5,0,4,6,66.7,2,5,1,4,2,11,5,0,defense
GER-Bundesliga,2024,Eint Frankfurt,Mario Götze,GER,"MF,FW",32-312,1992.0,16.9,40,27,17,20,3,15,36,41.7,21,15,1,14,7,47,8,0,defense
GER-Bundesliga,2024,Eint Frankfurt,Michy Batshuayi,BEL,"FW,DF",31-191,1993.0,2.3,1,1,1,0,0,1,1,100.0,0,2,0,2,1,2,0,0,defense
GER-Bundesliga,2024,Eint Frankfurt,Nathaniel Brown,GER,"DF,MF",21-299,2003.0,16.4,53,35,28,13,12,36,44,81.8,8,24,0,24,13,66,51,1,defense
GER-Bundesliga,2024,Eint Frankfurt,Niels Nkounkou,FRA,"DF,MF",24-161,2000.0,4.2,13,10,7,3,3,4,7,57.1,3,5,2,3,7,20,14,0,defense
GER-Bundesliga,2024,Eint Frankfurt,Nnamdi Collins,GER,DF,21-091,2004.0,13.7,22,15,16,5,1,11,13,84.6,2,20,11,9,14,36,60,3,defense
GER-Bundesliga,2024,Eint Frankfurt,Omar Marmoush,EGY,FW,26-063,1999.0,16.1,12,8,0,3,9,3,7,42.9,4,7,1,6,2,14,2,0,defense
GER-Bundesliga,2024,Eint Frankfurt,Oscar Højlund,DEN,MF,20-097,2005.0,6.8,20,12,7,9,4,8,16,50.0,8,13,5,8,5,25,8,0,defense
GER-Bundesliga,2024,Eint Frankfurt,Rasmus Kristensen,DEN,DF,27-274,1997.0,23.3,49,27,33,11,5,33,56,58.9,23,41,13,28,18,67,77,0,defense
GER-Bundesliga,2024,Eint Frankfurt,Robin Koch,GER,DF,28-268,1996.0,22.7,17,8,10,5,2,8,19,42.1,11,34,22,12,20,37,135,3,defense
GER-Bundesliga,2024,Eint Frankfurt,Timothy Chandler,USA,DF,35-013,1990.0,0.2,0,0,0,0,0,0,0,,0,0,0,0,3,3,2,0,defense
GER-Bundesliga,2024,Eint Frankfurt,Tuta,BRA,"DF,MF",25-281,1999.0,20.6,33,21,18,13,2,22,34,64.7,12,37,19,18,38,71,113,1,defense
GER-Bundesliga,2024,Freiburg,Christian Günter,GER,DF,32-042,1993.0,24.5,22,20,12,7,3,16,29,55.2,13,23,9,14,8,30,46,1,defense
GER-Bundesliga,2024,Freiburg,Eren Dinkçi,GER,"MF,FW",23-119,2001.0,13.3,21,13,8,8,5,7,23,30.4,16,22,2,20,7,28,7,0,defense
GER-Bundesliga,2024,Freiburg,Florent Muslija,KVX,"FW,MF",26-279,1998.0,1.9,5,4,3,1,1,2,2,100.0,0,0,0,0,1,6,1,0,defense
GER-Bundesliga,2024,Freiburg,Florian Müller,GER,GK,27-149,1997.0,4.4,0,0,0,0,0,0,0,,0,0,0,0,0,0,1,0,defense
GER-Bundesliga,2024,Freiburg,Ifechukwu Ogbus,SUI,DF,19-115,2005.0,0.2,1,1,0,0,1,0,1,0.0,1,0,0,0,1,2,2,0,defense
GER-Bundesliga,2024,Freiburg,Jan-Niklas Beste,GER,"FW,MF",26-097,1999.0,1.4,0,0,0,0,0,0,4,0.0,4,0,0,0,1,1,2,0,defense
GER-Bundesliga,2024,Freiburg,Johan Manzambi,SUI,"MF,FW",19-179,2005.0,0.4,1,0,0,1,0,0,1,0.0,1,1,0,1,0,1,2,0,defense
GER-Bundesliga,2024,Freiburg,Jordy Makengo,FRA,DF,23-251,2001.0,3.3,12,7,8,3,1,8,10,80.0,2,5,3,2,3,15,12,0,defense
GER-Bundesliga,2024,Freiburg,Junior Adamu,AUT,FW,23-309,2001.0,13.0,4,1,1,2,1,1,7,14.3,6,11,0,11,9,13,13,0,defense
GER-Bundesliga,2024,Freiburg,Kiliann Sildillia,FRA,DF,22-330,2002.0,8.4,17,10,8,6,3,7,12,58.3,5,16,5,11,10,27,33,0,defense
GER-Bundesliga,2024,Freiburg,Lucas Höler,GER,"FW,MF",30-275,1994.0,16.6,30,17,15,13,2,6,19,31.6,13,27,7,20,7,37,22,0,defense
GER-Bundesliga,2024,Freiburg,Lukas Kübler,GER,DF,32-224,1992.0,18.0,36,17,16,17,3,24,44,54.5,20,27,11,16,45,81,49,3,defense
GER-Bundesliga,2024,Freiburg,Matthias Ginter,GER,DF,31-082,1994.0,23.5,24,15,13,9,2,14,25,56.0,11,32,20,12,13,37,115,4,defense
GER-Bundesliga,2024,Freiburg,Max Rosenfelder,GER,DF,22-060,2003.0,9.7,21,14,14,7,0,11,14,78.6,3,12,8,4,5,26,54,0,defense
GER-Bundesliga,2024,Freiburg,Maximilian Eggestein,GER,MF,28-124,1996.0,25.6,47,24,16,23,8,22,39,56.4,17,27,8,19,29,76,40,1,defense
GER-Bundesliga,2024,Freiburg,Maximilian Philipp,GER,"MF,FW",31-041,1994.0,0.2,0,0,0,0,0,0,0,,0,0,0,0,0,0,0,0,defense
GER-Bundesliga,2024,Freiburg,Merlin Röhl,GER,"MF,FW",22-280,2002.0,10.1,16,10,4,10,2,9,11,81.8,2,6,1,5,5,21,2,0,defense
GER-Bundesliga,2024,Freiburg,Michael Gregoritsch,AUT,FW,30-358,1994.0,6.3,3,2,1,0,2,0,3,0.0,3,2,1,1,0,3,7,0,defense
GER-Bundesliga,2024,Freiburg,Nicolas Höfler,GER,MF,35-033,1990.0,8.8,33,23,13,18,2,20,31,64.5,11,7,1,6,14,47,28,1,defense
GER-Bundesliga,2024,Freiburg,Noah Atubolu,GER,GK,22-321,2002.0,23.6,0,0,0,0,0,0,0,,0,0,0,0,0,0,13,4,defense
GER-Bundesliga,2024,Freiburg,Noah Weißhaupt,GER,FW,23-203,2001.0,0.9,0,0,0,0,0,0,1,0.0,1,0,0,0,0,0,1,0,defense
GER-Bundesliga,2024,Freiburg,Patrick Osterhage,GER,MF,25-069,2000.0,20.2,39,26,14,24,1,12,25,48.0,13,21,2,19,18,57,30,0,defense
GER-Bundesliga,2024,Freiburg,Philipp Lienhart,AUT,DF,28-274,1996.0,24.8,21,13,12,9,0,14,29,48.3,15,24,15,9,29,50,89,2,defense
GER-Bundesliga,2024,Freiburg,Ritsu Doan,JPN,"FW,MF",26-299,1998.0,26.0,59,37,28,25,6,24,41,58.5,17,44,1,43,13,72,34,1,defense
GER-Bundesliga,2024,Freiburg,Roland Sallai,HUN,"FW,MF",27-324,1997.0,0.5,2,1,1,1,0,0,0,,0,0,0,0,1,3,0,0,defense
GER-Bundesliga,2024,Freiburg,Vincenzo Grifo,ITA,"FW,MF",32-004,1993.0,22.0,17,14,7,9,1,8,26,30.8,18,18,1,17,5,22,15,1,defense
GER-Bundesliga,2024,Gladbach,Alassane Pléa,FRA,"MF,FW",32-032,1993.0,17.3,7,3,0,2,5,4,9,44.4,5,8,0,8,2,9,6,1,defense
GER-Bundesliga,2024,Gladbach,Fabio Chiarodia,ITA,DF,19-310,2005.0,1.3,2,1,1,1,0,1,1,100.0,0,4,1,3,5,7,24,0,defense
GER-Bundesliga,2024,Gladbach,Florian Neuhaus,GER,MF,28-026,1997.0,2.7,4,0,2,2,0,3,10,30.0,7,5,0,5,4,8,3,1,defense
GER-Bundesliga,2024,Gladbach,Franck Honorat,FRA,FW,28-243,1996.0,12.3,12,4,6,3,3,1,4,25.0,3,9,1,8,4,16,24,1,defense
GER-Bundesliga,2024,Gladbach,Grant Ranos,ARM,FW,21-265,2003.0,0.2,1,0,0,1,0,0,1,0.0,1,2,0,2,0,1,0,0,defense
GER-Bundesliga,2024,Gladbach,Joe Scally,USA,DF,22-101,2002.0,24.1,40,29,23,15,2,25,43,58.1,18,29,11,18,13,53,70,1,defense
GER-Bundesliga,2024,Gladbach,Jonas Omlin,SUI,GK,31-091,1994.0,5.9,0,0,0,0,0,0,0,,0,0,0,0,0,0,1,0,defense
GER-Bundesliga,2024,Gladbach,Julian Weigl,GER,MF,29-215,1995.0,26.3,45,20,20,20,5,23,37,62.2,14,44,20,24,41,86,69,1,defense
GER-Bundesliga,2024,Gladbach,Kevin Stöger,AUT,"MF,FW",31-227,1993.0,14.5,33,17,20,9,4,14,32,43.8,18,19,1,18,11,44,21,2,defense
GER-Bundesliga,2024,Gladbach,Ko Itakura,JPN,DF,28-074,1997.0,26.0,34,25,19,14,1,18,31,58.1,13,35,18,17,22,56,138,0,defense
GER-Bundesliga,2024,Gladbach,Luca Netz,GER,DF,21-331,2003.0,9.6,22,12,13,7,2,11,17,64.7,6,16,4,12,10,32,28,0,defense
GER-Bundesliga,2024,Gladbach,Lukas Ullrich,GER,DF,21-026,2004.0,16.3,17,8,11,5,1,9,23,39.1,14,22,8,14,17,34,54,1,defense
GER-Bundesliga,2024,Gladbach,Marvin Friedrich,GER,DF,29-119,1995.0,10.6,14,8,11,3,0,8,15,53.3,7,16,12,4,5,19,55,0,defense
GER-Bundesliga,2024,Gladbach,Moritz Nicolas,GER,GK,27-172,1997.0,18.2,0,0,0,0,0,0,0,,0,1,0,1,1,1,8,1,defense
GER-Bundesliga,2024,Gladbach,Nathan N'Goumou,CMR,FW,25-028,2000.0,9.2,17,11,11,4,2,6,11,54.5,5,8,2,6,4,21,16,0,defense
GER-Bundesliga,2024,Gladbach,Nico Elvedi,SUI,DF,28-193,1996.0,20.5,34,22,24,6,4,16,22,72.7,6,32,25,7,25,59,142,0,defense
GER-Bundesliga,2024,Gladbach,Noah Pesch,CRO,FW,19-328,2005.0,0.1,1,0,0,0,1,0,0,,0,0,0,0,0,1,0,0,defense
GER-Bundesliga,2024,Gladbach,Philipp Sander,GER,MF,27-049,1998.0,13.9,32,16,16,14,2,10,21,47.6,11,15,6,9,20,52,42,3,defense
GER-Bundesliga,2024,Gladbach,Robin Hack,GER,FW,26-227,1998.0,19.7,18,14,8,7,3,11,24,45.8,13,24,2,22,8,26,26,0,defense
GER-Bundesliga,2024,Gladbach,Rocco Reitz,GER,MF,22-317,2002.0,15.9,40,16,17,20,3,18,33,54.5,15,25,10,15,41,81,45,1,defense
GER-Bundesliga,2024,Gladbach,Shiō Fukuda,JPN,"FW,MF",21-003,2004.0,0.5,0,0,0,0,0,0,0,,0,1,0,1,0,0,0,0,defense
GER-Bundesliga,2024,Gladbach,Stefan Lainer,AUT,DF,32-227,1992.0,6.3,18,10,12,5,1,10,12,83.3,2,8,4,4,9,27,21,0,defense
GER-Bundesliga,2024,Gladbach,Tiago Cardoso,LUX,GK,19-004,2006.0,3.2,0,0,0,0,0,0,0,,0,0,0,0,0,0,2,1,defense
GER-Bundesliga,2024,Gladbach,Tim Kleindienst,GER,FW,29-223,1995.0,25.4,22,13,5,10,7,8,31,25.8,23,39,6,33,10,32,51,0,defense
GER-Bundesliga,2024,Gladbach,Tobias Sippel,GER,GK,37-020,1988.0,0.7,0,0,0,0,0,0,0,,0,0,0,0,0,0,0,0,defense
GER-Bundesliga,2024,Gladbach,Tomáš Čvančara,CZE,FW,24-241,2000.0,6.7,2,1,1,1,0,2,4,50.0,2,6,3,3,3,5,14,0,defense
GER-Bundesliga,2024,Heidenheim,Adrian Beck,GER,"MF,FW",27-306,1997.0,12.4,29,12,14,11,4,10,27,37.0,17,26,2,24,6,35,14,0,defense
GER-Bundesliga,2024,Heidenheim,Benedikt Gimber,GER,DF,28-051,1997.0,24.7,65,41,45,20,0,34,55,61.8,21,46,18,28,27,92,113,1,defense
GER-Bundesliga,2024,Heidenheim,Budu Zivzivadze,GEO,FW,31-032,1994.0,9.9,16,10,1,9,6,4,8,50.0,4,9,0,9,3,19,5,0,defense
GER-Bundesliga,2024,Heidenheim,Denis Thomalla,GER,MF,32-238,1992.0,0.0,0,0,0,0,0,0,0,,0,0,0,0,0,0,0,0,defense
GER-Bundesliga,2024,Heidenheim,Frans Krätzig,GER,"DF,MF",22-087,2003.0,8.8,22,12,7,9,6,7,12,58.3,5,7,1,6,7,29,12,0,defense
GER-Bundesliga,2024,Heidenheim,Jan Schöppner,GER,MF,25-303,1999.0,24.9,47,26,17,22,8,17,53,32.1,36,33,5,28,37,84,76,1,defense
GER-Bundesliga,2024,Heidenheim,Jonas Föhrenbach,GER,DF,29-075,1996.0,19.9,43,23,23,15,5,22,35,62.9,13,28,3,25,16,59,57,0,defense
GER-Bundesliga,2024,Heidenheim,Julian Niehues,GER,MF,23-359,2001.0,0.6,1,0,1,0,0,1,2,50.0,1,1,0,1,0,1,1,0,defense
GER-Bundesliga,2024,Heidenheim,Kevin Müller,GER,GK,34-027,1991.0,28.0,3,2,3,0,0,3,3,100.0,0,0,0,0,0,3,10,4,defense
GER-Bundesliga,2024,Heidenheim,Lennard Maloney,USA,MF,25-185,1999.0,8.4,20,11,12,7,1,14,23,60.9,9,9,2,7,14,34,38,0,defense
GER-Bundesliga,2024,Heidenheim,Luca Kerber,GER,"MF,DF",23-032,2002.0,7.6,26,16,17,8,1,16,28,57.1,12,11,3,8,4,30,23,0,defense
GER-Bundesliga,2024,Heidenheim,Léo Scienza,BRA,"FW,MF",26-210,1998.0,11.5,13,9,8,4,1,5,15,33.3,10,12,1,11,5,18,8,1,defense
GER-Bundesliga,2024,Heidenheim,Marnon Busch,GER,"DF,MF",30-124,1994.0,11.9,18,12,12,6,0,16,23,69.6,7,18,7,11,12,30,55,5,defense
GER-Bundesliga,2024,Heidenheim,Marvin Pieringer,GER,"FW,MF",25-189,1999.0,19.3,20,11,5,10,5,4,7,57.1,3,20,2,18,6,26,28,0,defense
GER-Bundesliga,2024,Heidenheim,Mathias Honsak,AUT,"FW,DF",28-112,1996.0,11.9,15,8,10,5,0,10,21,47.6,11,17,4,13,7,22,28,0,defense
GER-Bundesliga,2024,Heidenheim,Maximilian Breunig,GER,"FW,MF",24-240,2000.0,3.9,4,3,1,2,1,3,6,50.0,3,9,2,7,1,5,3,0,defense
GER-Bundesliga,2024,Heidenheim,Mikkel Kaufmann,DEN,FW,24-098,2001.0,4.1,6,4,1,3,2,2,5,40.0,3,5,2,3,2,8,7,0,defense
GER-Bundesliga,2024,Heidenheim,Niklas Dorsch,GER,MF,27-086,1998.0,11.7,21,12,8,13,0,10,17,58.8,7,11,1,10,14,35,16,1,defense
GER-Bundesliga,2024,Heidenheim,Norman Theuerkauf,GER,MF,38-077,1987.0,0.2,0,0,0,0,0,0,0,,0,0,0,0,0,0,0,0,defense
GER-Bundesliga,2024,Heidenheim,Omar Traoré,GER,DF,27-066,1998.0,23.2,39,23,24,14,1,21,37,56.8,16,28,4,24,16,55,51,0,defense
GER-Bundesliga,2024,Heidenheim,Patrick Mainka,GER,DF,30-156,1994.0,28.0,54,26,32,20,2,32,49,65.3,17,46,26,20,61,115,164,0,defense
GER-Bundesliga,2024,Heidenheim,Paul Wanner,GER,"MF,FW",19-109,2005.0,16.9,32,21,15,17,0,14,30,46.7,16,13,0,13,4,36,17,0,defense
GER-Bundesliga,2024,Heidenheim,Sirlord Conteh,GER,"FW,MF",28-276,1996.0,7.8,9,5,3,6,0,2,6,33.3,4,1,1,0,1,10,6,0,defense
GER-Bundesliga,2024,Heidenheim,Stefan Schimmer,GER,"FW,MF",30-348,1994.0,2.5,2,0,1,1,0,1,1,100.0,0,1,0,1,0,2,4,0,defense
GER-Bundesliga,2024,Heidenheim,Thomas Keller,GER,"DF,MF",25-249,1999.0,1.5,6,5,5,1,0,4,6,66.7,2,3,1,2,4,10,11,0,defense
GER-Bundesliga,2024,Heidenheim,Tim Siersleben,GER,DF,25-033,2000.0,8.1,16,11,9,6,1,7,14,50.0,7,14,5,9,15,31,45,0,defense
GER-Bundesliga,2024,Hoffenheim,Adam Hložek,CZE,"FW,MF",22-260,2002.0,16.6,19,8,7,6,6,11,20,55.0,9,12,1,11,4,23,18,0,defense
GER-Bundesliga,2024,Hoffenheim,Alexander Prass,AUT,DF,23-320,2001.0,16.9,41,23,23,15,3,24,57,42.1,33,32,6,26,9,50,48,4,defense
GER-Bundesliga,2024,Hoffenheim,Andrej Kramarić,CRO,"MF,FW",33-296,1991.0,24.9,9,4,3,5,1,4,8,50.0,4,12,2,10,4,13,9,1,defense
GER-Bundesliga,2024,Hoffenheim,Anton Stach,GER,"MF,DF",26-147,1998.0,22.8,54,39,21,29,4,26,37,70.3,11,37,12,25,33,87,81,1,defense
GER-Bundesliga,2024,Hoffenheim,Arthur Chaves,BRA,DF,24-072,2001.0,18.3,34,24,18,13,3,18,38,47.4,20,38,15,23,26,60,101,2,defense
GER-Bundesliga,2024,Hoffenheim,Bazoumana Touré,CIV,"FW,DF",19-040,2006.0,2.4,6,4,0,6,0,2,4,50.0,2,1,0,1,3,9,1,0,defense
GER-Bundesliga,2024,Hoffenheim,David Jurásek,CZE,DF,24-247,2000.0,6.5,6,3,3,2,1,2,5,40.0,3,5,0,5,4,10,17,0,defense
GER-Bundesliga,2024,Hoffenheim,David Mokwa,FRA,"DF,FW",20-343,2004.0,0.2,1,0,1,0,0,0,0,,0,0,0,0,0,1,0,0,defense
GER-Bundesliga,2024,Hoffenheim,Dennis Geiger,GER,"MF,FW",26-305,1998.0,5.9,14,9,6,7,1,6,10,60.0,4,11,2,9,2,16,6,0,defense
GER-Bundesliga,2024,Hoffenheim,Diadie Samassékou,MLI,MF,29-090,1996.0,3.2,5,5,1,2,2,2,4,50.0,2,4,2,2,5,10,5,0,defense
GER-Bundesliga,2024,Hoffenheim,Erencan Yardimci,TUR,"FW,MF",23-066,2002.0,3.4,4,3,1,3,0,1,2,50.0,1,2,0,2,1,5,2,0,defense
GER-Bundesliga,2024,Hoffenheim,Finn Ole Becker,GER,MF,24-307,2000.0,7.2,11,5,4,6,1,1,4,25.0,3,7,3,4,10,21,17,0,defense
GER-Bundesliga,2024,Hoffenheim,Florian Grillitsch,AUT,MF,29-247,1995.0,6.7,15,9,5,9,1,8,14,57.1,6,6,2,4,8,23,18,0,defense
GER-Bundesliga,2024,Hoffenheim,Florian Micheler,AUT,MF,19-329,2005.0,0.4,0,0,0,0,0,0,2,0.0,2,0,0,0,0,0,0,0,defense
GER-Bundesliga,2024,Hoffenheim,Gift Orban,NGA,FW,22-268,2002.0,7.3,3,1,2,1,0,1,6,16.7,5,7,0,7,0,3,3,0,defense
GER-Bundesliga,2024,Hoffenheim,Grischa Prömel,GER,MF,30-092,1995.0,1.9,0,0,0,0,0,0,1,0.0,1,1,1,0,2,2,4,0,defense
GER-Bundesliga,2024,Hoffenheim,Hannes Behrens,GER,DF,,,0.3,1,1,0,1,0,0,0,,0,1,0,1,2,3,0,0,defense
GER-Bundesliga,2024,Hoffenheim,Haris Tabakovic,BIH,FW,30-295,1994.0,6.8,3,1,1,0,2,0,3,0.0,3,4,2,2,1,4,13,0,defense
GER-Bundesliga,2024,Hoffenheim,Jacob Bruun Larsen,DEN,"FW,MF",26-204,1998.0,4.4,4,3,1,2,1,3,8,37.5,5,5,1,4,1,5,2,0,defense
GER-Bundesliga,2024,Hoffenheim,Kevin Akpoguma,NGA,DF,29-357,1995.0,20.3,42,21,28,10,4,21,33,63.6,12,58,34,24,23,65,90,1,defense
GER-Bundesliga,2024,Hoffenheim,Leo Skiri Østigård,NOR,DF,25-134,1999.0,6.3,6,6,3,3,0,3,5,60.0,2,13,7,6,4,10,74,0,defense
GER-Bundesliga,2024,Hoffenheim,Luca Philipp,GER,GK,24-134,2000.0,5.0,1,0,1,0,0,1,1,100.0,0,0,0,0,0,1,1,0,defense
GER-Bundesliga,2024,Hoffenheim,Marius Bülter,GER,FW,32-013,1993.0,14.1,7,7,1,4,2,6,11,54.5,5,4,1,3,1,8,7,0,defense
GER-Bundesliga,2024,Hoffenheim,Max Moerstedt,GER,FW,,,5.0,5,5,1,3,1,1,2,50.0,1,4,0,4,0,5,5,0,defense
GER-Bundesliga,2024,Hoffenheim,Mergim Berisha,GER,"FW,MF",26-335,1998.0,3.7,3,3,1,2,0,0,3,0.0,3,2,1,1,0,3,3,0,defense
GER-Bundesliga,2024,Hoffenheim,Oliver Baumann,GER,GK,34-313,1990.0,23.0,1,1,1,0,0,1,3,33.3,2,0,0,0,0,1,13,2,defense
GER-Bundesliga,2024,Hoffenheim,Paul Hennrich,GER,MF,20-036,2005.0,0.1,0,0,0,0,0,0,0,,0,1,1,0,0,0,0,0,defense
GER-Bundesliga,2024,Hoffenheim,Pavel Kadeřábek,CZE,DF,32-351,1992.0,13.2,19,10,9,3,7,12,27,44.4,15,10,3,7,17,36,44,1,defense
GER-Bundesliga,2024,Hoffenheim,Robin Hranáč,CZE,DF,25-072,2000.0,2.4,0,0,0,0,0,0,1,0.0,1,3,2,1,5,5,9,1,defense
GER-Bundesliga,2024,Hoffenheim,Stanley N'Soki,FRA,DF,26-002,1999.0,11.4,18,13,10,6,2,9,17,52.9,8,17,4,13,21,39,44,3,defense
GER-Bundesliga,2024,Hoffenheim,Tim Drexler,GER,DF,20-036,2005.0,4.0,17,7,11,6,0,9,12,75.0,3,6,4,2,1,18,9,1,defense
GER-Bundesliga,2024,Hoffenheim,Tom Bischof,GER,"MF,FW",19-287,2005.0,23.8,86,47,31,42,13,34,69,49.3,35,55,10,45,27,113,41,1,defense
GER-Bundesliga,2024,Hoffenheim,Umut Tohumcu,GER,"MF,FW",20-243,2004.0,3.8,9,5,3,5,1,5,7,71.4,2,3,0,3,3,12,6,0,defense
GER-Bundesliga,2024,Hoffenheim,Valentin Gendrey,FRA,DF,24-294,2000.0,14.0,28,11,17,9,2,10,15,66.7,5,18,4,14,15,43,44,0,defense
GER-Bundesliga,2024,Holstein Kiel,Alexander Bernhardsson,SWE,"MF,DF",26-215,1998.0,8.6,16,10,6,4,6,11,15,73.3,4,12,0,12,3,19,14,0,defense
GER-Bundesliga,2024,Holstein Kiel,Andu Kelati,GER,"MF,DF",22-241,2002.0,3.2,7,4,2,4,1,2,5,40.0,3,4,1,3,3,10,3,0,defense
GER-Bundesliga,2024,Holstein Kiel,Armin Gigovic,BIH,MF,23-005,2002.0,16.5,19,9,11,5,3,3,17,17.6,14,17,1,16,16,35,28,0,defense
GER-Bundesliga,2024,Holstein Kiel,Benedikt Pichler,AUT,FW,27-265,1997.0,8.6,5,2,1,0,4,2,4,50.0,2,4,2,2,2,7,11,0,defense
GER-Bundesliga,2024,Holstein Kiel,Carl Johansson,SWE,DF,30-323,1994.0,4.1,4,2,4,0,0,3,6,50.0,3,7,6,1,6,10,25,1,defense
GER-Bundesliga,2024,Holstein Kiel,David Zec,SVN,DF,25-096,2000.0,12.4,16,7,12,4,0,11,14,78.6,3,24,13,11,13,29,72,3,defense
GER-Bundesliga,2024,Holstein Kiel,Dominik Javorček,SVK,"DF,MF",22-160,2002.0,4.3,3,0,3,0,0,1,5,20.0,4,7,3,4,5,8,24,1,defense
GER-Bundesliga,2024,Holstein Kiel,Finn Porath,GER,"DF,MF",28-047,1997.0,20.2,43,24,23,13,7,24,50,48.0,26,24,7,17,18,61,61,0,defense
GER-Bundesliga,2024,Holstein Kiel,Ivan Nekić,CRO,DF,24-108,2000.0,0.8,1,1,1,0,0,1,2,50.0,1,1,0,1,3,4,2,0,defense
GER-Bundesliga,2024,Holstein Kiel,Jann-Fiete Arp,GER,"FW,MF",25-095,2000.0,7.7,12,9,5,2,5,4,13,30.8,9,5,0,5,3,15,7,1,defense
GER-Bundesliga,2024,Holstein Kiel,John Tolkin,USA,"DF,FW",22-254,2002.0,3.0,7,4,4,3,0,4,5,80.0,1,4,1,3,1,8,18,0,defense
GER-Bundesliga,2024,Holstein Kiel,Lasse Rosenboom,GER,DF,23-082,2002.0,13.9,35,24,18,13,4,26,35,74.3,9,22,8,14,15,50,53,2,defense
GER-Bundesliga,2024,Holstein Kiel,Lewis Holtby,GER,MF,34-205,1990.0,13.1,32,20,17,10,5,10,26,38.5,16,14,2,12,21,53,26,3,defense
GER-Bundesliga,2024,Holstein Kiel,Magnus Knudsen,NOR,MF,23-300,2001.0,17.5,42,25,20,17,5,21,37,56.8,16,15,4,11,12,54,37,0,defense
GER-Bundesliga,2024,Holstein Kiel,Marco Komenda,CRO,DF,28-136,1996.0,13.8,25,17,12,12,1,10,14,71.4,4,21,10,11,6,31,64,0,defense
GER-Bundesliga,2024,Holstein Kiel,Marko Ivezić,SRB,DF,23-130,2001.0,15.4,25,16,18,4,3,12,35,34.3,23,23,12,11,24,49,78,2,defense
GER-Bundesliga,2024,Holstein Kiel,Marvin Schulz,GER,"DF,MF",30-086,1995.0,3.0,5,4,2,2,1,2,8,25.0,6,10,6,4,0,5,13,0,defense
GER-Bundesliga,2024,Holstein Kiel,Max Geschwill,GER,DF,23-278,2001.0,13.5,26,21,13,12,1,14,19,73.7,5,14,9,5,27,53,47,0,defense
GER-Bundesliga,2024,Holstein Kiel,Nicolai Remberg,GER,MF,24-296,2000.0,21.9,37,20,20,14,3,15,32,46.9,17,39,16,23,25,62,80,0,defense
GER-Bundesliga,2024,Holstein Kiel,Patrick Erras,GER,DF,30-080,1995.0,9.2,8,5,6,2,0,2,9,22.2,7,13,11,2,9,17,64,0,defense
GER-Bundesliga,2024,Holstein Kiel,Phil Harres,GER,FW,23-017,2002.0,15.5,10,10,3,4,3,4,7,57.1,3,14,3,11,5,15,15,0,defense
GER-Bundesliga,2024,Holstein Kiel,Shuto Machino,JPN,"FW,MF",25-193,1999.0,16.9,7,4,4,2,1,5,11,45.5,6,10,1,9,6,13,17,0,defense
GER-Bundesliga,2024,Holstein Kiel,Steven Skrzybski,GER,"FW,MF",32-144,1992.0,10.6,11,1,2,5,4,5,15,33.3,10,15,0,15,9,20,8,0,defense
GER-Bundesliga,2024,Holstein Kiel,Thomas Dähne,GER,GK,31-097,1994.0,3.0,0,0,0,0,0,0,0,,0,0,0,0,0,0,3,0,defense
GER-Bundesliga,2024,Holstein Kiel,Timo Becker,GER,DF,28-017,1997.0,21.7,39,25,26,9,4,27,35,77.1,8,25,15,10,14,53,83,0,defense
GER-Bundesliga,2024,Holstein Kiel,Timon Weiner,GER,GK,26-083,1999.0,25.0,0,0,0,0,0,0,1,0.0,1,0,0,0,0,0,17,3,defense
GER-Bundesliga,2024,Holstein Kiel,Tymoteusz Puchacz,POL,DF,26-078,1999.0,4.4,9,4,6,3,0,5,7,71.4,2,4,1,3,3,12,11,0,defense
GER-Bundesliga,2024,Leverkusen,Aleix García,ESP,MF,27-287,1997.0,13.7,9,5,2,5,2,5,12,41.7,7,10,1,9,8,17,21,1,defense
GER-Bundesliga,2024,Leverkusen,Amine Adli,MAR,"MF,FW",24-336,2000.0,5.9,11,6,3,1,7,4,10,40.0,6,9,0,9,0,11,3,0,defense
GER-Bundesliga,2024,Leverkusen,Arthur,BRA,"DF,FW",22-025,2003.0,6.0,13,10,3,8,2,5,10,50.0,5,7,0,7,8,21,20,0,defense
GER-Bundesliga,2024,Leverkusen,Edmond Tapsoba,BFA,DF,26-068,1999.0,22.4,34,20,15,15,4,18,33,54.5,15,14,9,5,23,57,66,0,defense
GER-Bundesliga,2024,Leverkusen,Emi Buendía,ARG,"MF,FW",28-107,1996.0,1.5,3,2,1,1,1,3,5,60.0,2,4,0,4,0,3,0,0,defense
GER-Bundesliga,2024,Leverkusen,Exequiel Palacios,ARG,MF,26-188,1998.0,9.2,17,12,7,6,4,6,13,46.2,7,12,1,11,10,27,8,0,defense
GER-Bundesliga,2024,Leverkusen,Florian Wirtz,GER,"MF,FW",21-343,2003.0,20.8,29,18,10,11,8,8,19,42.1,11,23,1,22,8,37,4,0,defense
GER-Bundesliga,2024,Leverkusen,Granit Xhaka,SUI,MF,32-196,1992.0,27.2,39,23,12,21,6,21,37,56.8,16,25,5,20,11,50,38,4,defense
GER-Bundesliga,2024,Leverkusen,Jeanuël Belocian,FRA,"DF,MF",20-053,2005.0,0.8,1,1,1,0,0,1,1,100.0,0,0,0,0,0,1,2,0,defense
GER-Bundesliga,2024,Leverkusen,Jeremie Frimpong,NED,"DF,MF",24-122,2000.0,21.8,30,22,12,11,7,14,27,51.9,13,21,0,21,8,38,18,0,defense
GER-Bundesliga,2024,Leverkusen,Jonas Hofmann,GER,"MF,DF",32-271,1992.0,2.7,1,0,0,1,0,1,3,33.3,2,2,0,2,0,1,2,0,defense
GER-Bundesliga,2024,Leverkusen,Jonathan Tah,GER,DF,29-059,1996.0,27.0,11,7,8,2,1,7,11,63.6,4,20,14,6,31,42,122,2,defense
GER-Bundesliga,2024,Leverkusen,Lukáš Hrádecký,FIN,GK,35-138,1989.0,25.0,0,0,0,0,0,0,1,0.0,1,0,0,0,0,0,6,1,defense
GER-Bundesliga,2024,Leverkusen,Mario Hermoso,ESP,DF,29-297,1995.0,3.3,0,0,0,0,0,0,0,,0,3,1,2,9,9,15,1,defense
GER-Bundesliga,2024,Leverkusen,Martin Terrier,FRA,"MF,FW",28-038,1997.0,6.5,4,2,1,0,3,1,4,25.0,3,3,0,3,1,5,1,0,defense
GER-Bundesliga,2024,Leverkusen,Matej Kovar,CZE,GK,24-329,2000.0,3.0,0,0,0,0,0,0,0,,0,0,0,0,0,0,0,0,defense
GER-Bundesliga,2024,Leverkusen,Nathan Tella,NGA,"MF,FW",25-280,1999.0,11.6,11,6,1,5,5,3,9,33.3,6,11,0,11,4,15,4,0,defense
GER-Bundesliga,2024,Leverkusen,Nordi Mukiele,FRA,DF,27-161,1997.0,10.0,20,16,8,8,4,12,18,66.7,6,10,0,10,16,36,37,2,defense
GER-Bundesliga,2024,Leverkusen,Patrik Schick,CZE,FW,29-077,1996.0,13.9,5,4,1,2,2,1,4,25.0,3,5,0,5,2,7,13,1,defense
GER-Bundesliga,2024,Leverkusen,Piero Hincapié,ECU,DF,23-092,2002.0,24.5,41,33,21,13,7,20,33,60.6,13,32,15,17,29,70,87,1,defense
GER-Bundesliga,2024,Leverkusen,Robert Andrich,GER,"MF,DF",30-201,1994.0,15.5,22,11,8,13,1,6,13,46.2,7,14,7,7,23,45,20,0,defense
GER-Bundesliga,2024,Leverkusen,Victor Boniface,NGA,FW,24-109,2000.0,11.0,5,4,0,3,2,3,4,75.0,1,1,0,1,0,5,5,0,defense
GER-Bundesliga,2024,Leverkusen,Álex Grimaldo,ESP,"DF,MF",29-203,1995.0,24.2,21,12,12,5,4,15,36,41.7,21,16,2,14,15,36,36,2,defense
GER-Bundesliga,2024,Mainz 05,Andreas Hanche-Olsen,NOR,DF,28-084,1997.0,10.1,15,7,7,7,1,5,7,71.4,2,20,15,5,7,22,60,1,defense
GER-Bundesliga,2024,Mainz 05,Anthony Caci,FRA,DF,27-284,1997.0,24.9,55,37,21,22,12,27,40,67.5,13,29,8,21,20,75,44,2,defense
GER-Bundesliga,2024,Mainz 05,Armindo Sieb,GER,"FW,MF",22-053,2003.0,8.2,9,3,3,5,1,3,10,30.0,7,4,0,4,1,10,7,0,defense
GER-Bundesliga,2024,Mainz 05,Arnaud Nordin,FRA,DF,26-298,1998.0,0.3,1,0,0,1,0,1,1,100.0,0,0,0,0,0,1,0,0,defense
GER-Bundesliga,2024,Mainz 05,Aymen Barkok,MAR,MF,26-325,1998.0,0.8,2,1,1,1,0,1,1,100.0,0,1,1,0,2,4,0,0,defense
GER-Bundesliga,2024,Mainz 05,Danny da Costa,GER,DF,31-272,1993.0,17.0,33,19,18,12,3,13,20,65.0,7,17,9,8,19,52,80,3,defense
GER-Bundesliga,2024,Mainz 05,Dominik Kohr,GER,"DF,MF",31-070,1994.0,22.7,52,39,29,18,5,27,44,61.4,17,38,21,17,40,92,110,0,defense
GER-Bundesliga,2024,Mainz 05,Gabriel Vidovic,CRO,MF,21-131,2003.0,0.0,0,0,0,0,0,0,0,,0,0,0,0,0,0,0,0,defense
GER-Bundesliga,2024,Mainz 05,Hong Hyunseok,KOR,MF,25-299,1999.0,5.2,6,2,3,2,1,1,4,25.0,3,6,1,5,7,13,7,0,defense
GER-Bundesliga,2024,Mainz 05,Jonathan Burkardt,GER,FW,24-274,2000.0,18.5,10,6,1,4,5,3,7,42.9,4,9,1,8,1,11,13,0,defense
GER-Bundesliga,2024,Mainz 05,Kaishu Sano,JPN,MF,24-102,2000.0,27.8,53,32,18,27,8,20,41,48.8,21,56,11,45,45,98,47,0,defense
GER-Bundesliga,2024,Mainz 05,Karim Onisiwo,AUT,"MF,FW",33-025,1992.0,1.2,1,1,0,0,1,0,0,,0,0,0,0,0,1,0,0,defense
GER-Bundesliga,2024,Mainz 05,Lee Jae-sung,KOR,MF,32-244,1992.0,24.0,35,19,13,17,5,11,33,33.3,22,30,3,27,32,67,32,0,defense
GER-Bundesliga,2024,Mainz 05,Lennard Maloney,USA,MF,25-185,1999.0,0.3,1,0,0,0,1,1,1,100.0,0,1,0,1,0,1,3,0,defense
GER-Bundesliga,2024,Mainz 05,Maxim Leitsch,GER,DF,26-328,1998.0,7.5,12,4,6,4,2,7,9,77.8,2,12,4,8,10,22,42,1,defense
GER-Bundesliga,2024,Mainz 05,Moritz Jenz,GER,DF,25-346,1999.0,15.8,36,20,18,18,0,16,21,76.2,5,21,13,8,24,60,116,1,defense
GER-Bundesliga,2024,Mainz 05,Nadiem Amiri,GER,MF,28-166,1996.0,22.5,38,19,11,20,7,13,39,33.3,26,18,4,14,16,54,29,2,defense
GER-Bundesliga,2024,Mainz 05,Nelson Weiper,GER,"FW,MF",20-025,2005.0,5.7,4,4,2,2,0,2,4,50.0,2,4,0,4,1,5,3,1,defense
GER-Bundesliga,2024,Mainz 05,Nikolas Veratschnig,AUT,"DF,FW",22-077,2003.0,1.3,4,3,1,3,0,1,1,100.0,0,1,0,1,2,6,2,0,defense
GER-Bundesliga,2024,Mainz 05,Paul Nebel,GER,MF,22-183,2002.0,21.1,31,19,9,14,8,10,31,32.3,21,44,4,40,10,41,30,2,defense
GER-Bundesliga,2024,Mainz 05,Phillipp Mwene,AUT,DF,31-072,1994.0,25.2,41,23,16,20,5,13,37,35.1,24,26,6,20,22,63,49,0,defense
GER-Bundesliga,2024,Mainz 05,Robin Zentner,GER,GK,30-165,1994.0,28.0,2,1,2,0,0,1,2,50.0,1,0,0,0,0,2,30,4,defense
GER-Bundesliga,2024,Mainz 05,Silvan Widmer,SUI,DF,32-037,1993.0,4.4,10,5,2,6,2,7,11,63.6,4,6,1,5,5,15,20,0,defense
GER-Bundesliga,2024,Mainz 05,Stefan Bell,GER,DF,33-230,1991.0,13.1,18,10,14,4,0,8,13,61.5,5,14,12,2,24,42,89,0,defense
GER-Bundesliga,2024,RB Leipzig,Amadou Haidara,MLI,MF,27-070,1998.0,13.3,26,14,10,14,2,10,24,41.7,14,37,10,27,18,44,51,0,defense
GER-Bundesliga,2024,RB Leipzig,André Silva,POR,"FW,MF",29-156,1995.0,1.5,1,1,1,0,0,0,1,0.0,1,1,0,1,1,2,2,0,defense
GER-Bundesliga,2024,RB Leipzig,Antonio Nusa,NOR,"MF,DF",19-359,2005.0,16.0,30,17,16,9,5,18,36,50.0,18,20,2,18,8,38,11,0,defense
GER-Bundesliga,2024,RB Leipzig,Arthur Vermeeren,BEL,MF,20-063,2005.0,13.7,26,17,13,11,2,10,39,25.6,29,30,9,21,22,48,17,1,defense
GER-Bundesliga,2024,RB Leipzig,Assan Ouedraogo,GER,MF,18-337,2006.0,0.6,0,0,0,0,0,0,0,,0,1,0,1,0,0,0,0,defense
GER-Bundesliga,2024,RB Leipzig,Benjamin Henrichs,GER,DF,28-047,1997.0,10.4,32,16,18,10,4,14,27,51.9,13,22,3,19,15,47,33,0,defense
GER-Bundesliga,2024,RB Leipzig,Benjamin Šeško,SVN,"FW,MF",21-315,2003.0,22.1,7,3,0,4,3,3,10,30.0,7,12,3,9,5,12,19,0,defense
GER-Bundesliga,2024,RB Leipzig,Castello Lukeba,FRA,DF,22-115,2002.0,12.5,25,12,11,11,3,11,15,73.3,4,19,9,10,13,38,56,0,defense
GER-Bundesliga,2024,RB Leipzig,Christoph Baumgartner,AUT,"MF,FW",25-253,1999.0,15.1,36,22,9,18,9,11,33,33.3,22,39,8,31,12,48,18,1,defense
GER-Bundesliga,2024,RB Leipzig,David Raum,GER,DF,26-354,1998.0,17.8,31,22,14,12,5,15,27,55.6,12,22,6,16,9,40,41,3,defense
GER-Bundesliga,2024,RB Leipzig,El Chadaille Bitshiabu,FRA,DF,19-330,2005.0,8.0,20,14,11,8,1,7,13,53.8,6,14,7,7,9,29,59,1,defense
GER-Bundesliga,2024,RB Leipzig,Elif Elmas,MKD,MF,25-199,1999.0,0.5,3,1,3,0,0,1,3,33.3,2,2,0,2,0,3,2,0,defense
GER-Bundesliga,2024,RB Leipzig,Faik Sakar,GER,MF,17-087,2008.0,0.0,0,0,0,0,0,0,0,,0,0,0,0,0,0,0,0,defense
GER-Bundesliga,2024,RB Leipzig,Kevin Kampl,SVN,MF,34-184,1990.0,15.6,26,18,11,9,6,15,22,68.2,7,24,6,18,23,49,23,0,defense
GER-Bundesliga,2024,RB Leipzig,Kosta Nedeljković,SRB,DF,19-116,2005.0,1.5,3,2,1,2,0,2,5,40.0,3,2,1,1,0,3,4,0,defense
GER-Bundesliga,2024,RB Leipzig,Loïs Openda,BEL,"FW,MF",25-054,2000.0,23.1,8,4,2,4,2,2,7,28.6,5,17,1,16,5,13,12,0,defense
GER-Bundesliga,2024,RB Leipzig,Lukas Klostermann,GER,DF,28-312,1996.0,15.4,24,13,15,7,2,12,19,63.2,7,25,13,12,22,46,104,2,defense
GER-Bundesliga,2024,RB Leipzig,Lutsharel Geertruida,NED,DF,24-267,2000.0,14.6,30,19,21,9,0,15,30,50.0,15,12,4,8,15,45,49,4,defense
GER-Bundesliga,2024,RB Leipzig,Maarten Vandevoordt,BEL,GK,23-044,2002.0,2.5,0,0,0,0,0,0,0,,0,0,0,0,0,0,4,0,defense
GER-Bundesliga,2024,RB Leipzig,Mohamed Simakan,FRA,DF,24-343,2000.0,0.6,0,0,0,0,0,0,0,,0,0,0,0,2,2,0,0,defense
GER-Bundesliga,2024,RB Leipzig,Nicolas Seiwald,AUT,"MF,DF",23-342,2001.0,17.2,40,23,14,22,4,20,39,51.3,19,32,8,24,29,69,58,2,defense
GER-Bundesliga,2024,RB Leipzig,Péter Gulácsi,HUN,GK,34-340,1990.0,25.5,0,0,0,0,0,0,1,0.0,1,0,0,0,0,0,10,4,defense
GER-Bundesliga,2024,RB Leipzig,Ridle Baku,GER,"DF,MF",27-003,1998.0,10.1,15,12,7,8,0,5,12,41.7,7,14,2,12,5,20,41,0,defense
GER-Bundesliga,2024,RB Leipzig,Tidiam Gomis,FRA,"MF,DF",18-246,2006.0,0.7,0,0,0,0,0,0,0,,0,2,0,2,1,1,0,0,defense
GER-Bundesliga,2024,RB Leipzig,Viggo Gebel,GER,MF,17-140,2007.0,0.2,0,0,0,0,0,0,0,,0,0,0,0,0,0,0,0,defense
GER-Bundesliga,2024,RB Leipzig,Willi Orban,HUN,DF,32-159,1992.0,24.7,38,21,23,14,1,23,32,71.9,9,45,31,14,21,59,169,4,defense
GER-Bundesliga,2024,RB Leipzig,Xaver Schlager,AUT,MF,27-195,1997.0,2.0,4,2,2,1,1,3,7,42.9,4,7,0,7,0,4,3,0,defense
GER-Bundesliga,2024,RB Leipzig,Xavi Simons,NED,MF,21-355,2003.0,19.1,21,15,5,14,2,11,23,47.8,12,11,2,9,10,31,15,0,defense
GER-Bundesliga,2024,RB Leipzig,Yussuf Poulsen,DEN,"FW,MF",30-300,1994.0,3.3,9,5,2,5,2,3,6,50.0,3,5,2,3,0,9,10,0,defense
GER-Bundesliga,2024,St. Pauli,Abdoulie Ceesay,GAM,FW,21-096,2004.0,0.7,3,3,1,1,1,2,3,66.7,1,2,0,2,0,3,1,0,defense
GER-Bundesliga,2024,St. Pauli,Adam Dźwigała,POL,"DF,MF",29-198,1995.0,2.8,14,7,11,2,1,6,11,54.5,5,5,1,4,3,17,21,0,defense
GER-Bundesliga,2024,St. Pauli,Andreas Albers,DEN,FW,35-019,1990.0,0.7,1,1,0,0,1,0,1,0.0,1,0,0,0,0,1,1,0,defense
GER-Bundesliga,2024,St. Pauli,Carlo Boukhalfa,MAR,MF,25-343,1999.0,13.7,19,6,5,13,1,5,15,33.3,10,17,3,14,11,30,19,1,defense
GER-Bundesliga,2024,St. Pauli,Connor Metcalfe,AUS,MF,25-157,1999.0,3.0,1,0,0,1,0,0,4,0.0,4,3,0,3,3,4,4,0,defense
GER-Bundesliga,2024,St. Pauli,Danel Sinani,LUX,"MF,FW",28-006,1997.0,8.4,11,9,2,5,4,5,11,45.5,6,11,1,10,1,12,9,0,defense
GER-Bundesliga,2024,St. Pauli,David Nemeth,AUT,DF,24-024,2001.0,17.7,36,25,22,12,2,21,37,56.8,16,23,10,13,13,49,72,2,defense
GER-Bundesliga,2024,St. Pauli,Elias Saad,TUN,"FW,MF",25-105,1999.0,9.2,20,13,7,8,5,10,20,50.0,10,12,0,12,2,22,1,0,defense
GER-Bundesliga,2024,St. Pauli,Eric Smith,SWE,"DF,MF",28-093,1997.0,25.4,37,27,23,11,3,17,31,54.8,14,31,9,22,31,68,87,4,defense
GER-Bundesliga,2024,St. Pauli,Erik Ahlstrand,SWE,"FW,MF",23-179,2001.0,0.5,0,0,0,0,0,0,0,,0,1,0,1,1,1,1,0,defense
GER-Bundesliga,2024,St. Pauli,Finley Stevens,WAL,DF,22-001,2003.0,0.0,0,0,0,0,0,0,0,,0,0,0,0,0,0,0,0,defense
GER-Bundesliga,2024,St. Pauli,Hauke Wahl,GER,DF,30-361,1994.0,27.0,29,22,15,12,2,17,29,58.6,12,34,21,13,30,59,129,3,defense
GER-Bundesliga,2024,St. Pauli,Jackson Irvine,AUS,MF,32-035,1993.0,28.0,55,28,23,26,6,25,45,55.6,20,27,5,22,36,91,61,2,defense
GER-Bundesliga,2024,St. Pauli,James Sands,USA,"MF,DF",24-279,2000.0,5.0,15,6,5,8,2,4,4,100.0,0,5,1,4,5,20,8,0,defense
GER-Bundesliga,2024,St. Pauli,Johannes Eggestein,GER,FW,26-338,1998.0,20.3,5,3,0,2,3,1,5,20.0,4,5,0,5,0,5,8,0,defense
GER-Bundesliga,2024,St. Pauli,Karol Mets,EST,DF,31-330,1993.0,10.0,13,8,6,7,0,4,7,57.1,3,9,3,6,12,25,60,0,defense
GER-Bundesliga,2024,St. Pauli,Lars Ritzka,GER,"DF,MF",26-339,1998.0,8.6,46,29,26,15,5,22,37,59.5,15,14,2,12,9,55,34,0,defense
GER-Bundesliga,2024,St. Pauli,Manolis Saliakas,GRE,"MF,DF",28-211,1996.0,20.0,36,16,18,15,3,20,36,55.6,16,31,6,25,17,53,47,0,defense
GER-Bundesliga,2024,St. Pauli,Maurides,BRA,FW,31-032,1994.0,0.0,0,0,0,0,0,0,0,,0,0,0,0,0,0,0,0,defense
GER-Bundesliga,2024,St. Pauli,Morgan Guilavogui,GUI,"FW,MF",27-032,1998.0,14.9,31,16,10,16,5,14,27,51.9,13,25,0,25,11,42,27,0,defense
GER-Bundesliga,2024,St. Pauli,Nikola Vasilj,BIH,GK,29-130,1995.0,28.0,0,0,0,0,0,0,2,0.0,2,0,0,0,0,0,20,2,defense
GER-Bundesliga,2024,St. Pauli,Noah Weißhaupt,GER,"FW,MF",23-203,2001.0,10.2,6,4,3,0,3,3,8,37.5,5,6,0,6,2,8,6,0,defense
GER-Bundesliga,2024,St. Pauli,Oladapo Afolayan,ENG,"FW,MF",27-058,1998.0,15.9,16,8,4,8,4,6,18,33.3,12,14,1,13,7,23,18,0,defense
GER-Bundesliga,2024,St. Pauli,Philipp Treu,GER,"MF,DF",24-129,2000.0,26.4,53,39,30,14,9,33,60,55.0,27,45,9,36,17,70,69,2,defense
GER-Bundesliga,2024,St. Pauli,Robert Wagner,GER,MF,21-271,2003.0,4.0,7,2,1,6,0,3,10,30.0,7,6,0,6,1,8,9,0,defense
GER-Bundesliga,2024,St. Pauli,Scott Banks,SCO,"FW,MF",23-197,2001.0,1.1,1,1,1,0,0,0,2,0.0,2,0,0,0,2,3,2,0,defense
GER-Bundesliga,2024,St. Pauli,Siebe Van Der Heyden,BEL,"DF,MF",26-316,1998.0,6.4,14,8,9,5,0,7,15,46.7,8,5,2,3,10,24,25,1,defense
GER-Bundesliga,2024,Stuttgart,Alexander Nübel,GER,GK,28-193,1996.0,28.0,0,0,0,0,0,0,1,0.0,1,0,0,0,0,0,16,3,defense
GER-Bundesliga,2024,Stuttgart,Ameen Al-Dakhil,BEL,DF,23-036,2002.0,4.8,6,6,4,2,0,4,4,100.0,0,12,8,4,9,15,30,1,defense
GER-Bundesliga,2024,Stuttgart,Angelo Stiller,GER,MF,24-007,2001.0,26.3,46,24,17,23,6,13,26,50.0,13,25,8,17,22,68,48,4,defense
GER-Bundesliga,2024,Stuttgart,Anrie Chase,JPN,DF,21-018,2004.0,8.2,10,4,6,4,0,5,7,71.4,2,10,6,4,9,19,35,0,defense
GER-Bundesliga,2024,Stuttgart,Anthony Rouault,FRA,DF,23-317,2001.0,13.5,15,11,10,3,2,10,15,66.7,5,18,9,9,19,34,63,1,defense
GER-Bundesliga,2024,Stuttgart,Atakan Karazor,,MF,28-180,1996.0,23.2,49,24,15,25,9,23,48,47.9,25,33,5,28,25,74,39,1,defense
GER-Bundesliga,2024,Stuttgart,Chris Führich,GER,"MF,FW",27-092,1998.0,17.2,12,7,3,4,5,10,23,43.5,13,21,2,19,6,18,16,0,defense
GER-Bundesliga,2024,Stuttgart,Dan-Axel Zagadou,FRA,"DF,MF",25-312,1999.0,0.3,0,0,0,0,0,0,0,,0,0,0,0,1,1,1,0,defense
GER-Bundesliga,2024,Stuttgart,Deniz Undav,GER,"FW,MF",28-266,1996.0,14.1,8,7,2,1,5,0,11,0.0,11,6,0,6,3,11,7,0,defense
GER-Bundesliga,2024,Stuttgart,El Bilal Touré,MLI,"FW,MF",23-190,2001.0,4.0,4,1,1,1,2,3,3,100.0,0,1,0,1,0,4,1,0,defense
GER-Bundesliga,2024,Stuttgart,Enzo Millot,FRA,"MF,FW",22-268,2002.0,18.1,24,11,10,11,3,9,29,31.0,20,25,0,25,11,35,6,1,defense
GER-Bundesliga,2024,Stuttgart,Ermedin Demirović,BIH,FW,27-017,1998.0,17.1,10,6,2,3,5,1,6,16.7,5,13,2,11,3,13,10,0,defense
GER-Bundesliga,2024,Stuttgart,Fabian Rieder,SUI,"MF,FW",23-054,2002.0,8.4,15,12,3,8,4,7,22,31.8,15,9,1,8,7,22,4,1,defense
GER-Bundesliga,2024,Stuttgart,Finn Jeltsch,GER,DF,18-268,2006.0,4.2,12,11,4,7,1,8,11,72.7,3,8,4,4,5,17,13,1,defense
GER-Bundesliga,2024,Stuttgart,Frans Krätzig,GER,DF,22-087,2003.0,0.6,2,1,1,0,1,1,3,33.3,2,2,1,1,0,2,1,0,defense
GER-Bundesliga,2024,Stuttgart,Jacob Bruun Larsen,DEN,MF,26-204,1998.0,4.0,1,1,1,0,0,0,2,0.0,2,5,0,5,1,2,3,1,defense
GER-Bundesliga,2024,Stuttgart,Jamie Leweling,GER,"MF,FW",24-044,2001.0,15.5,15,6,6,3,6,10,22,45.5,12,21,1,20,10,25,16,1,defense
GER-Bundesliga,2024,Stuttgart,Jarzinho Malanga,GER,DF,18-275,2006.0,0.0,0,0,0,0,0,0,0,,0,0,0,0,0,0,0,0,defense
GER-Bundesliga,2024,Stuttgart,Josha Vagnoman,GER,"DF,MF",24-121,2000.0,18.9,23,11,10,11,2,16,30,53.3,14,15,2,13,12,35,54,1,defense
GER-Bundesliga,2024,Stuttgart,Julian Chabot,GER,DF,27-058,1998.0,20.3,29,18,15,12,2,12,27,44.4,15,21,14,7,32,61,118,0,defense
GER-Bundesliga,2024,Stuttgart,Justin Diehl,GER,"FW,DF",20-135,2004.0,1.2,1,0,0,1,0,1,1,100.0,0,2,0,2,0,1,0,0,defense
GER-Bundesliga,2024,Stuttgart,Leonidas Stergiou,SUI,DF,23-039,2002.0,6.9,21,12,7,11,3,14,16,87.5,2,11,4,7,9,30,26,0,defense
GER-Bundesliga,2024,Stuttgart,Luca Jaquez,SUI,DF,21-313,2003.0,1.0,3,0,3,0,0,1,2,50.0,1,1,0,1,0,3,1,0,defense
GER-Bundesliga,2024,Stuttgart,Maximilian Mittelstädt,GER,DF,28-024,1997.0,21.7,69,50,39,26,4,46,64,71.9,18,40,11,29,36,105,82,2,defense
GER-Bundesliga,2024,Stuttgart,Nick Woltemade,GER,"FW,MF",23-056,2002.0,14.0,6,3,2,3,1,3,7,42.9,4,19,1,18,1,7,10,1,defense
GER-Bundesliga,2024,Stuttgart,Pascal Stenzel,GER,DF,29-022,1996.0,1.5,1,0,1,0,0,0,1,0.0,1,4,1,3,0,1,4,0,defense
GER-Bundesliga,2024,Stuttgart,Ramon Hendriks,NED,DF,23-267,2001.0,11.1,18,7,10,7,1,9,13,69.2,4,13,5,8,16,34,53,0,defense
GER-Bundesliga,2024,Stuttgart,Yannik Keitel,GER,MF,25-055,2000.0,2.7,7,5,2,4,1,7,8,87.5,1,4,2,2,4,11,5,0,defense
GER-Bundesliga,2024,Union Berlin,Alexander Schwolow,GER,GK,32-313,1992.0,5.0,0,0,0,0,0,0,0,,0,0,0,0,0,0,1,0,defense
GER-Bundesliga,2024,Union Berlin,Aljoscha Kemlein,GER,MF,20-252,2004.0,10.2,10,4,4,5,1,5,14,35.7,9,14,3,11,6,16,15,0,defense
GER-Bundesliga,2024,Union Berlin,Andrej Ilic,SRB,FW,25-008,2000.0,6.2,2,2,0,2,0,0,4,0.0,4,6,2,4,3,5,3,0,defense
GER-Bundesliga,2024,Union Berlin,András Schäfer,HUN,MF,25-363,1999.0,12.3,34,16,15,15,4,18,29,62.1,11,28,4,24,19,53,27,0,defense
GER-Bundesliga,2024,Union Berlin,Benedict Hollerbach,GER,"FW,MF",23-329,2001.0,23.1,39,19,8,20,11,20,43,46.5,23,27,0,27,2,41,12,1,defense
GER-Bundesliga,2024,Union Berlin,Christopher Trimmel,AUT,"DF,MF",38-046,1987.0,14.7,27,18,17,9,1,22,32,68.8,10,12,5,7,13,40,66,0,defense
GER-Bundesliga,2024,Union Berlin,Danilho Doekhi,NED,DF,26-285,1998.0,28.0,31,19,15,14,2,13,21,61.9,8,30,14,16,37,68,136,1,defense
GER-Bundesliga,2024,Union Berlin,Diogo Leite,POR,DF,26-078,1999.0,25.6,56,27,35,17,4,27,41,65.9,14,59,23,36,52,108,141,1,defense
GER-Bundesliga,2024,Union Berlin,Frederik Rønnow,DEN,GK,32-250,1992.0,23.0,0,0,0,0,0,0,1,0.0,1,0,0,0,0,0,14,2,defense
GER-Bundesliga,2024,Union Berlin,Ivan Prtajin,CRO,FW,28-332,1996.0,1.8,3,2,0,1,2,0,0,,0,2,0,2,0,3,3,0,defense
GER-Bundesliga,2024,Union Berlin,Janik Haberer,GER,"MF,DF",31-009,1994.0,13.5,21,15,8,11,2,15,31,48.4,16,12,0,12,12,33,28,0,defense
GER-Bundesliga,2024,Union Berlin,Jeong Woo-yeong,KOR,"MF,FW",25-203,1999.0,14.0,10,7,5,5,0,3,11,27.3,8,10,1,9,11,21,11,0,defense
GER-Bundesliga,2024,Union Berlin,Jordan Pefok,USA,FW,28-350,1996.0,10.1,11,6,6,0,5,3,7,42.9,4,9,2,7,4,15,18,0,defense
GER-Bundesliga,2024,Union Berlin,Josip Juranović,CRO,"DF,MF",29-238,1995.0,11.0,18,10,10,5,3,9,22,40.9,13,12,6,6,7,25,33,1,defense
GER-Bundesliga,2024,Union Berlin,Jérôme Roussillon,FRA,"DF,MF",32-095,1993.0,1.4,0,0,0,0,0,0,1,0.0,1,0,0,0,2,2,6,0,defense
GER-Bundesliga,2024,Union Berlin,Kevin Vogt,GER,DF,33-200,1991.0,13.3,9,6,6,3,0,7,11,63.6,4,15,8,7,9,18,64,0,defense
GER-Bundesliga,2024,Union Berlin,Kevin Volland,GER,"FW,MF",32-255,1992.0,0.6,0,0,0,0,0,0,0,,0,0,0,0,0,0,1,0,defense
GER-Bundesliga,2024,Union Berlin,Leopold Querfeld,AUT,DF,21-112,2003.0,13.4,15,5,11,4,0,7,12,58.3,5,19,8,11,11,26,96,2,defense
GER-Bundesliga,2024,Union Berlin,Lucas Tousart,FRA,MF,27-347,1997.0,5.5,16,9,6,8,2,5,12,41.7,7,9,3,6,5,21,18,0,defense
GER-Bundesliga,2024,Union Berlin,László Bénes,SVK,"MF,FW",27-214,1997.0,5.4,1,1,0,1,0,0,1,0.0,1,5,1,4,2,3,8,0,defense
GER-Bundesliga,2024,Union Berlin,Marin Ljubicic,CRO,"FW,MF",23-042,2002.0,2.2,0,0,0,0,0,0,2,0.0,2,2,0,2,0,0,6,0,defense
GER-Bundesliga,2024,Union Berlin,Rani Khedira,GER,MF,31-074,1994.0,24.3,60,36,26,31,3,21,32,65.6,11,29,10,19,36,96,49,0,defense
GER-Bundesliga,2024,Union Berlin,Robert Skov,DEN,"DF,MF",28-326,1996.0,9.5,15,11,8,7,0,10,20,50.0,10,8,1,7,8,23,9,0,defense
GER-Bundesliga,2024,Union Berlin,Robin Gosens,GER,DF,30-280,1994.0,1.0,0,0,0,0,0,0,3,0.0,3,1,0,1,1,1,2,0,defense
GER-Bundesliga,2024,Union Berlin,Tim Skarke,GER,"FW,MF",28-216,1996.0,10.7,13,11,5,7,1,9,17,52.9,8,6,0,6,5,18,14,0,defense
GER-Bundesliga,2024,Union Berlin,Tom Rothe,GER,"DF,MF",20-164,2004.0,13.8,38,21,24,11,3,26,42,61.9,16,27,3,24,11,49,37,1,defense
GER-Bundesliga,2024,Union Berlin,Yorbe Vertessen,BEL,"MF,FW",24-093,2001.0,8.0,6,3,3,2,1,2,8,25.0,6,6,0,6,3,9,6,0,defense
GER-Bundesliga,2024,Werder Bremen,Amos Pieper,GER,DF,27-084,1998.0,10.7,21,10,11,6,4,14,23,60.9,9,19,12,7,18,39,52,0,defense
GER-Bundesliga,2024,Werder Bremen,André Silva,POR,FW,29-156,1995.0,4.1,2,2,1,1,0,0,1,0.0,1,3,1,2,0,2,3,0,defense
GER-Bundesliga,2024,Werder Bremen,Anthony Jung,GER,DF,33-159,1991.0,21.0,34,22,22,11,1,22,34,64.7,12,23,14,9,25,59,76,1,defense
GER-Bundesliga,2024,Werder Bremen,Derrick Köhn,GER,"DF,FW",26-066,1999.0,14.4,19,10,7,9,3,10,13,76.9,3,20,4,16,9,28,24,0,defense
GER-Bundesliga,2024,Werder Bremen,Felix Agu,GER,DF,25-196,1999.0,14.0,24,11,11,9,4,11,18,61.1,7,16,7,9,14,38,37,0,defense
GER-Bundesliga,2024,Werder Bremen,Issa Kaboré,BFA,"DF,FW",23-334,2001.0,3.4,8,4,2,5,1,4,6,66.7,2,8,2,6,2,10,7,0,defense
GER-Bundesliga,2024,Werder Bremen,Jens Stage,DEN,MF,28-154,1996.0,19.1,37,23,16,19,2,20,37,54.1,17,33,7,26,17,54,34,1,defense
GER-Bundesliga,2024,Werder Bremen,Julián Malatini,ARG,DF,23-315,2001.0,5.0,11,9,5,5,1,5,11,45.5,6,8,3,5,7,18,17,0,defense
GER-Bundesliga,2024,Werder Bremen,Justin Njinmah,GER,"FW,MF",24-147,2000.0,9.3,3,2,1,2,0,2,4,50.0,2,5,0,5,3,6,1,0,defense
GER-Bundesliga,2024,Werder Bremen,Keke Maximilian Topp,GER,"FW,MF",21-017,2004.0,2.7,2,1,0,1,1,1,2,50.0,1,0,0,0,1,3,3,0,defense
GER-Bundesliga,2024,Werder Bremen,Leonardo Bittencourt,GER,MF,31-113,1993.0,9.9,23,9,13,7,3,6,15,40.0,9,8,0,8,12,35,10,0,defense
GER-Bundesliga,2024,Werder Bremen,Marco Friedl,AUT,DF,27-026,1998.0,18.0,47,32,25,21,1,29,53,54.7,24,31,17,14,30,77,99,0,defense
GER-Bundesliga,2024,Werder Bremen,Marco Grüll,AUT,"FW,MF",26-279,1998.0,11.7,10,7,1,3,6,3,15,20.0,12,13,1,12,3,13,6,0,defense
GER-Bundesliga,2024,Werder Bremen,Marvin Ducksch,GER,FW,31-035,1994.0,21.5,8,6,3,4,1,2,12,16.7,10,6,1,5,6,14,21,1,defense
GER-Bundesliga,2024,Werder Bremen,Michael Zetterer,GER,GK,29-273,1995.0,28.0,0,0,0,0,0,0,0,,0,1,0,1,1,1,7,5,defense
GER-Bundesliga,2024,Werder Bremen,Miloš Veljković,SRB,DF,29-197,1995.0,11.4,10,5,6,3,1,7,15,46.7,8,14,9,5,2,12,47,1,defense
GER-Bundesliga,2024,Werder Bremen,Mitchell Weiser,GER,"DF,MF",30-355,1994.0,25.9,51,35,15,28,8,23,44,52.3,21,21,0,21,18,69,48,3,defense
GER-Bundesliga,2024,Werder Bremen,Niklas Stark,GER,DF,29-362,1995.0,17.4,31,20,19,10,2,14,20,70.0,6,32,21,11,24,55,84,1,defense
GER-Bundesliga,2024,Werder Bremen,Oliver Burke,SCO,FW,28-004,1997.0,6.2,9,4,5,0,4,3,4,75.0,1,14,0,14,2,11,5,0,defense
GER-Bundesliga,2024,Werder Bremen,Olivier Deman,BEL,DF,25-005,2000.0,0.7,6,3,2,4,0,2,7,28.6,5,3,1,2,3,9,4,0,defense
GER-Bundesliga,2024,Werder Bremen,Romano Schmid,AUT,MF,25-074,2000.0,25.7,40,23,10,20,10,21,44,47.7,23,37,2,35,11,51,7,2,defense
GER-Bundesliga,2024,Werder Bremen,Senne Lynen,BEL,MF,26-051,1999.0,24.6,65,33,33,26,6,35,61,57.4,26,52,12,40,54,119,59,5,defense
GER-Bundesliga,2024,Werder Bremen,Skelly Alvero,FRA,MF,22-342,2002.0,2.6,11,6,5,5,1,4,5,80.0,1,4,0,4,2,13,10,0,defense
GER-Bundesliga,2024,Wolfsburg,Andreas Skov Olsen,DEN,"FW,MF",25-103,1999.0,3.9,8,6,5,3,0,4,4,100.0,0,3,0,3,2,10,6,0,defense
GER-Bundesliga,2024,Wolfsburg,Aster Vranckx,BEL,MF,22-189,2002.0,4.7,8,4,2,6,0,2,7,28.6,5,9,2,7,6,14,12,0,defense
GER-Bundesliga,2024,Wolfsburg,Bence Dárdai,HUN,MF,19-077,2006.0,10.5,14,8,3,11,0,8,17,47.1,9,14,4,10,10,24,18,1,defense
GER-Bundesliga,2024,Wolfsburg,Cedric Zesiger,SUI,DF,26-291,1998.0,5.8,13,8,6,5,2,6,12,50.0,6,6,5,1,3,16,28,0,defense
GER-Bundesliga,2024,Wolfsburg,David Odogu,GER,DF,18-312,2006.0,1.0,2,1,1,1,0,0,0,,0,0,0,0,1,3,11,0,defense
GER-Bundesliga,2024,Wolfsburg,Denis Vavro,SVK,DF,29-001,1996.0,21.7,13,9,10,3,0,5,15,33.3,10,34,21,13,27,40,185,3,defense
GER-Bundesliga,2024,Wolfsburg,Jakub Kamiński,POL,"DF,MF",22-310,2002.0,9.8,16,7,7,3,6,8,21,38.1,13,16,7,9,11,27,19,1,defense
GER-Bundesliga,2024,Wolfsburg,Joakim Mæhle,DEN,DF,27-326,1997.0,19.1,27,11,21,6,0,12,35,34.3,23,21,3,18,22,49,39,1,defense
GER-Bundesliga,2024,Wolfsburg,Jonas Wind,DEN,"FW,MF",26-063,1999.0,17.9,5,4,1,4,0,2,5,40.0,3,13,3,10,5,10,12,0,defense
GER-Bundesliga,2024,Wolfsburg,Kamil Grabara,POL,GK,26-093,1999.0,22.7,0,0,0,0,0,0,2,0.0,2,1,0,1,0,0,8,2,defense
GER-Bundesliga,2024,Wolfsburg,Kevin Behrens,GER,FW,34-067,1991.0,1.7,1,1,0,1,0,0,1,0.0,1,0,0,0,1,2,2,0,defense
GER-Bundesliga,2024,Wolfsburg,Kilian Fischer,GER,DF,24-181,2000.0,21.0,54,36,42,8,4,41,79,51.9,38,35,6,29,14,68,80,2,defense
GER-Bundesliga,2024,Wolfsburg,Konstantinos Koulierakis,GRE,DF,21-134,2003.0,22.4,34,17,22,10,2,20,31,64.5,11,29,11,18,24,58,120,2,defense
GER-Bundesliga,2024,Wolfsburg,Lovro Majer,CRO,MF,27-084,1998.0,1.6,0,0,0,0,0,0,2,0.0,2,2,0,2,0,0,1,0,defense
GER-Bundesliga,2024,Wolfsburg,Lukas Nmecha,GER,"FW,MF",26-118,1998.0,2.9,1,0,0,1,0,0,1,0.0,1,1,0,1,2,3,3,0,defense
GER-Bundesliga,2024,Wolfsburg,Mads Roerslev,DEN,DF,25-291,1999.0,2.8,10,9,8,1,1,6,9,66.7,3,2,2,0,4,14,14,0,defense
GER-Bundesliga,2024,Wolfsburg,Marius Müller,GER,GK,31-273,1993.0,5.3,0,0,0,0,0,0,0,,0,0,0,0,0,0,0,0,defense
GER-Bundesliga,2024,Wolfsburg,Mattias Svanberg,SWE,MF,26-096,1999.0,13.3,20,10,6,11,3,9,19,47.4,10,11,4,7,15,35,26,0,defense
GER-Bundesliga,2024,Wolfsburg,Maximilian Arnold,GER,MF,30-319,1994.0,22.9,29,18,12,15,2,14,28,50.0,14,20,11,9,19,48,63,1,defense
GER-Bundesliga,2024,Wolfsburg,Mohamed Amoura,ALG,FW,24-337,2000.0,22.9,23,17,10,5,8,10,30,33.3,20,36,2,34,9,32,20,0,defense
GER-Bundesliga,2024,Wolfsburg,Patrick Wimmer,AUT,"MF,FW",23-316,2001.0,14.9,33,24,17,11,5,14,35,40.0,21,26,3,23,25,58,10,0,defense
GER-Bundesliga,2024,Wolfsburg,Ridle Baku,GER,"FW,MF",27-003,1998.0,13.0,23,15,9,9,5,8,19,42.1,11,22,1,21,15,38,15,0,defense
GER-Bundesliga,2024,Wolfsburg,Salih Özcan,TUR,MF,27-090,1998.0,3.9,2,2,1,0,1,1,5,20.0,4,5,1,4,7,9,5,0,defense
GER-Bundesliga,2024,Wolfsburg,Sebastiaan Bornauw,BEL,DF,26-020,1999.0,8.7,9,6,4,4,1,4,8,50.0,4,14,12,2,12,21,35,0,defense
GER-Bundesliga,2024,Wolfsburg,Tiago Tomás,POR,"FW,MF",22-299,2002.0,19.6,27,16,12,8,7,12,31,38.7,19,17,4,13,7,34,18,0,defense
GER-Bundesliga,2024,Wolfsburg,Yannick Gerhardt,GER,"MF,DF",31-029,1994.0,13.5,23,12,12,10,1,8,26,30.8,18,27,8,19,15,38,39,0,defense
