league,season,team,player,nation,pos,age,born,90s,Tackles Tkl,Tackles TklW,Tackles Def 3rd,Tackles Mid 3rd,Tackles Att 3rd,Challenges Tkl,Challenges Att,Challenges Tkl%,Challenges Lost,Blocks Blocks,Blocks Sh,Blocks Pass,Int,Tkl+Int,Clr,Err,stat_type
GER-Bundesliga,2022,Augsburg,André Hahn,GER,"FW,MF",31,1990,4.3,9,5,4,4,1,8,12,66.7,4,9,2,7,4,13,14,0,defense
GER-Bundesliga,2022,Augsburg,Arne Engels,BEL,MF,18,2003,16.0,20,9,9,10,1,8,19,42.1,11,17,5,12,15,35,12,1,defense
GER-Bundesliga,2022,Augsburg,Arne Maier,GER,MF,23,1999,21.8,31,22,17,11,3,10,18,55.6,8,21,0,21,15,46,22,0,defense
GER-Bundesliga,2022,Augsburg,Carlos Gruezo,ECU,MF,27,1995,10.7,21,12,12,9,0,9,16,56.3,7,13,4,9,10,31,15,0,defense
GER-Bundesliga,2022,Augsburg,Daniel Caligiuri,ITA,"DF,MF",34,1988,3.2,8,5,5,3,0,4,5,80.0,1,3,2,1,3,11,2,0,defense
GER-Bundesliga,2022,Augsburg,David Čolina,CRO,"DF,FW",22,2000,1.8,4,1,1,1,2,2,2,100.0,0,8,0,8,4,8,3,0,defense
GER-Bundesliga,2022,Augsburg,Dion Drena Beljo,CRO,FW,20,2002,12.5,7,6,3,2,2,2,13,15.4,11,15,2,13,1,8,14,0,defense
GER-Bundesliga,2022,Augsburg,Elvis Rexhbeçaj,KVX,MF,24,1997,28.0,51,30,18,24,9,29,59,49.2,30,39,12,27,17,68,40,0,defense
GER-Bundesliga,2022,Augsburg,Ermedin Demirović,BIH,"FW,MF",24,1998,26.3,31,14,9,12,10,9,22,40.9,13,31,4,27,14,45,37,0,defense
GER-Bundesliga,2022,Augsburg,Florian Niederlechner,GER,"FW,MF",31,1990,10.1,10,5,5,4,1,4,7,57.1,3,16,2,14,1,11,9,0,defense
GER-Bundesliga,2022,Augsburg,Frederik Winther,DEN,DF,21,2001,1.0,2,2,1,1,0,0,2,0.0,2,1,1,0,0,2,7,0,defense
GER-Bundesliga,2022,Augsburg,Fredrik Jensen,FIN,"FW,MF",24,1997,10.3,15,10,8,3,4,5,10,50.0,5,12,5,7,4,19,12,0,defense
GER-Bundesliga,2022,Augsburg,Iago,BRA,"DF,MF",25,1997,17.8,34,16,20,10,4,11,29,37.9,18,18,5,13,17,51,53,0,defense
GER-Bundesliga,2022,Augsburg,Irvin Cardona,FRA,"MF,FW",24,1997,3.5,1,1,1,0,0,1,5,20.0,4,3,0,3,4,5,8,0,defense
GER-Bundesliga,2022,Augsburg,Jeffrey Gouweleeuw,NED,DF,31,1991,31.1,42,27,19,17,6,24,49,49.0,25,41,23,18,50,92,141,2,defense
GER-Bundesliga,2022,Augsburg,Julian Baumgartlinger,AUT,MF,34,1988,6.2,15,4,5,6,4,6,19,31.6,13,4,2,2,4,19,15,0,defense
GER-Bundesliga,2022,Augsburg,Kelvin Yeboah,ITA,"FW,MF",22,2000,3.9,6,4,2,4,0,2,5,40.0,3,7,0,7,1,7,2,0,defense
GER-Bundesliga,2022,Augsburg,Lukas Petkov,BUL,"MF,FW",21,2000,1.6,5,1,4,1,0,2,3,66.7,1,4,1,3,1,6,0,0,defense
GER-Bundesliga,2022,Augsburg,Mads Pedersen,DEN,"DF,MF",25,1996,20.4,44,23,31,11,2,22,33,66.7,11,32,9,23,20,64,41,1,defense
GER-Bundesliga,2022,Augsburg,Maximilian Bauer,GER,DF,22,2000,20.5,31,17,18,12,1,17,34,50.0,17,25,9,16,23,54,79,1,defense
GER-Bundesliga,2022,Augsburg,Mergim Berisha,GER,FW,24,1998,18.7,11,6,4,3,4,4,14,28.6,10,16,1,15,0,11,19,0,defense
GER-Bundesliga,2022,Augsburg,Nathanael Mbuku,COD,"MF,FW",20,2002,0.4,1,0,0,1,0,0,0,,0,0,0,0,0,1,0,0,defense
GER-Bundesliga,2022,Augsburg,Niklas Dorsch,GER,MF,24,1998,5.4,21,12,8,11,2,9,16,56.3,7,9,3,6,6,27,9,0,defense
GER-Bundesliga,2022,Augsburg,Noah Joel Sarenren Bazee,NGA,"MF,FW",25,1996,0.2,0,0,0,0,0,0,1,0.0,1,1,0,1,0,0,0,0,defense
GER-Bundesliga,2022,Augsburg,Ohis Felix Uduokhai,GER,DF,24,1997,16.1,30,20,14,13,3,15,29,51.7,14,27,14,13,29,59,61,1,defense
GER-Bundesliga,2022,Augsburg,Rafał Gikiewicz,POL,GK,34,1987,23.0,2,2,2,0,0,2,3,66.7,1,0,0,0,0,2,15,5,defense
GER-Bundesliga,2022,Augsburg,Raphael Framberger,GER,"DF,FW",26,1995,2.0,10,6,6,4,0,3,5,60.0,2,2,1,1,2,12,5,0,defense
GER-Bundesliga,2022,Augsburg,Reece Oxford,ENG,DF,23,1998,1.0,1,1,1,0,0,0,0,,0,4,3,1,1,2,5,0,defense
GER-Bundesliga,2022,Augsburg,Renato Veiga,POR,DF,19,2003,7.1,9,6,4,3,2,7,9,77.8,2,20,6,14,7,16,29,1,defense
GER-Bundesliga,2022,Augsburg,Ricardo Pepi,USA,FW,19,2003,1.1,1,1,1,0,0,1,1,100.0,0,1,0,1,0,1,1,0,defense
GER-Bundesliga,2022,Augsburg,Robert Gumny,POL,DF,24,1998,22.4,34,24,13,15,6,11,27,40.7,16,21,7,14,26,60,62,1,defense
GER-Bundesliga,2022,Augsburg,Ruben Vargas,SUI,"MF,FW",23,1998,12.6,15,7,6,7,2,5,11,45.5,6,8,2,6,6,21,16,1,defense
GER-Bundesliga,2022,Augsburg,Tomáš Koubek,CZE,GK,29,1992,11.0,0,0,0,0,0,0,0,,0,0,0,0,0,0,7,0,defense
GER-Bundesliga,2022,Bayern Munich,Alphonso Davies,CAN,DF,21,2000,22.7,45,28,25,13,7,18,39,46.2,21,28,4,24,24,69,24,4,defense
GER-Bundesliga,2022,Bayern Munich,Arijon Ibrahimović,GER,MF,16,2005,0.2,1,1,1,0,0,0,0,,0,0,0,0,0,1,0,0,defense
GER-Bundesliga,2022,Bayern Munich,Benjamin Pavard,FRA,DF,26,1996,27.0,70,41,36,26,8,36,48,75.0,12,35,16,19,44,114,83,0,defense
GER-Bundesliga,2022,Bayern Munich,Bouna Sarr,SEN,FW,30,1992,0.0,0,0,0,0,0,0,0,,0,0,0,0,0,0,0,0,defense
GER-Bundesliga,2022,Bayern Munich,Daley Blind,NED,"DF,MF",32,1990,1.5,2,0,2,0,0,0,1,0.0,1,4,2,2,2,4,6,0,defense
GER-Bundesliga,2022,Bayern Munich,Dayot Upamecano,FRA,DF,23,1998,26.1,65,37,43,22,0,28,45,62.2,17,26,6,20,27,92,71,4,defense
GER-Bundesliga,2022,Bayern Munich,Eric Maxim Choupo-Moting,CMR,FW,33,1989,12.4,10,7,2,6,2,1,2,50.0,1,8,0,8,0,10,5,0,defense
GER-Bundesliga,2022,Bayern Munich,Gabriel Vidovic,CRO,FW,18,2003,0.2,0,0,0,0,0,0,0,,0,0,0,0,0,0,0,0,defense
GER-Bundesliga,2022,Bayern Munich,Jamal Musiala,GER,"MF,FW",19,2003,24.4,34,23,9,16,9,13,35,37.1,22,30,3,27,19,53,3,0,defense
GER-Bundesliga,2022,Bayern Munich,Joshua Kimmich,GER,MF,27,1995,31.2,78,49,24,46,8,38,72,52.8,34,36,7,29,41,119,39,2,defense
GER-Bundesliga,2022,Bayern Munich,Josip Stanišić,CRO,DF,22,2000,6.4,19,11,14,2,3,12,17,70.6,5,9,1,8,7,26,11,3,defense
GER-Bundesliga,2022,Bayern Munich,João Cancelo,POR,"DF,FW",28,1994,11.2,23,14,9,10,4,10,23,43.5,13,14,2,12,15,38,22,0,defense
GER-Bundesliga,2022,Bayern Munich,Kingsley Coman,FRA,"FW,MF",26,1996,15.7,11,8,3,5,3,7,17,41.2,10,19,1,18,2,13,7,0,defense
GER-Bundesliga,2022,Bayern Munich,Leon Goretzka,GER,MF,27,1995,19.2,43,24,21,16,6,27,48,56.3,21,40,3,37,30,73,32,0,defense
GER-Bundesliga,2022,Bayern Munich,Leroy Sané,GER,"MF,FW",26,1996,22.3,38,30,11,19,8,18,36,50.0,18,11,1,10,3,41,1,2,defense
GER-Bundesliga,2022,Bayern Munich,Lucas Hernández,FRA,DF,26,1996,5.3,6,4,3,3,0,5,6,83.3,1,2,1,1,5,11,7,0,defense
GER-Bundesliga,2022,Bayern Munich,Manuel Neuer,GER,GK,36,1986,12.0,0,0,0,0,0,0,0,,0,0,0,0,0,0,4,1,defense
GER-Bundesliga,2022,Bayern Munich,Marcel Sabitzer,AUT,MF,28,1994,7.0,27,14,11,10,6,10,17,58.8,7,3,0,3,10,37,9,0,defense
GER-Bundesliga,2022,Bayern Munich,Mathys Tel,FRA,FW,17,2005,4.6,2,2,0,1,1,1,1,100.0,0,5,1,4,0,2,2,0,defense
GER-Bundesliga,2022,Bayern Munich,Matthijs de Ligt,NED,DF,22,1999,26.7,32,23,15,16,1,15,24,62.5,9,31,20,11,23,55,85,0,defense
GER-Bundesliga,2022,Bayern Munich,Noussair Mazraoui,MAR,DF,24,1997,11.9,29,21,9,9,11,15,24,62.5,9,13,2,11,10,39,25,0,defense
GER-Bundesliga,2022,Bayern Munich,Paul Wanner,GER,MF,16,2005,0.3,3,1,1,2,0,1,1,100.0,0,0,0,0,0,3,1,0,defense
GER-Bundesliga,2022,Bayern Munich,Ryan Gravenberch,NED,MF,20,2002,6.4,17,8,4,10,3,7,13,53.8,6,9,1,8,9,26,10,0,defense
GER-Bundesliga,2022,Bayern Munich,Sadio Mané,SEN,"FW,MF",30,1992,15.8,11,5,3,3,5,1,9,11.1,8,15,2,13,0,11,4,0,defense
GER-Bundesliga,2022,Bayern Munich,Serge Gnabry,GER,"FW,MF",27,1995,21.6,35,23,11,14,10,17,43,39.5,26,24,1,23,11,46,5,1,defense
GER-Bundesliga,2022,Bayern Munich,Sven Ulreich,GER,GK,33,1988,3.0,1,1,1,0,0,1,1,100.0,0,0,0,0,0,1,0,1,defense
GER-Bundesliga,2022,Bayern Munich,Thomas Müller,GER,"FW,MF",32,1989,18.5,21,12,5,9,7,6,16,37.5,10,19,3,16,4,25,16,0,defense
GER-Bundesliga,2022,Bayern Munich,Yann Sommer,SUI,GK,33,1988,19.0,0,0,0,0,0,0,0,,0,0,0,0,1,1,5,1,defense
GER-Bundesliga,2022,Bochum,Anthony Losilla,FRA,MF,36,1986,30.2,76,49,32,34,10,38,77,49.4,39,39,12,27,37,113,67,0,defense
GER-Bundesliga,2022,Bochum,Christopher Antwi-Adjei,GHA,"FW,MF",28,1994,22.0,23,15,7,8,8,10,29,34.5,19,17,0,17,5,28,16,0,defense
GER-Bundesliga,2022,Bochum,Cristian Gamboa,CRC,DF,32,1989,16.4,42,24,27,14,1,21,31,67.7,10,20,7,13,16,58,34,1,defense
GER-Bundesliga,2022,Bochum,Danilo Soares,BRA,DF,30,1991,19.6,72,46,42,23,7,43,72,59.7,29,29,6,23,30,102,56,1,defense
GER-Bundesliga,2022,Bochum,Dominique Heintz,GER,DF,28,1993,8.8,13,9,5,7,1,6,17,35.3,11,11,7,4,12,25,34,0,defense
GER-Bundesliga,2022,Bochum,Erhan Mašović,SRB,"DF,MF",23,1998,24.2,50,31,28,21,1,30,51,58.8,21,30,14,16,27,77,79,0,defense
GER-Bundesliga,2022,Bochum,Gerrit Holtmann,PHI,"FW,MF",27,1995,10.5,14,7,6,7,1,12,21,57.1,9,15,1,14,2,16,4,0,defense
GER-Bundesliga,2022,Bochum,Ivan Ordets,UKR,DF,30,1992,27.2,31,19,21,9,1,16,28,57.1,12,34,17,17,57,88,139,0,defense
GER-Bundesliga,2022,Bochum,Jacek Góralski,POL,MF,29,1992,1.6,6,3,3,3,0,4,6,66.7,2,4,0,4,3,9,5,0,defense
GER-Bundesliga,2022,Bochum,Jannes Horn,GER,"DF,FW",25,1997,0.7,2,1,1,1,0,1,1,100.0,0,1,0,1,3,5,2,0,defense
GER-Bundesliga,2022,Bochum,Jordi Osei-Tutu,ENG,"DF,FW",23,1998,8.3,23,18,13,5,5,12,23,52.2,11,12,5,7,10,33,8,0,defense
GER-Bundesliga,2022,Bochum,Keven Schlotterbeck,GER,DF,25,1997,8.2,17,9,12,5,0,9,11,81.8,2,11,5,6,14,31,49,0,defense
GER-Bundesliga,2022,Bochum,Kevin Stöger,AUT,MF,28,1993,28.9,84,45,38,32,14,31,94,33.0,63,27,4,23,26,110,21,1,defense
GER-Bundesliga,2022,Bochum,Kostas Stafylidis,GRE,"DF,MF",28,1993,11.6,27,16,13,8,6,10,24,41.7,14,21,8,13,20,47,31,1,defense
GER-Bundesliga,2022,Bochum,Manuel Riemann,GER,GK,33,1988,34.0,3,2,3,0,0,3,5,60.0,2,1,0,1,5,8,23,7,defense
GER-Bundesliga,2022,Bochum,Moritz Broschinski,GER,"FW,MF",21,2000,2.4,0,0,0,0,0,0,5,0.0,5,1,0,1,0,0,6,0,defense
GER-Bundesliga,2022,Bochum,Patrick Osterhage,GER,MF,22,2000,11.4,20,17,8,10,2,11,16,68.8,5,17,6,11,12,32,25,0,defense
GER-Bundesliga,2022,Bochum,Philipp Förster,GER,MF,27,1995,14.5,31,19,11,15,5,12,40,30.0,28,22,0,22,6,37,6,0,defense
GER-Bundesliga,2022,Bochum,Philipp Hofmann,GER,FW,29,1993,29.2,18,11,0,13,5,5,12,41.7,7,20,8,12,6,24,48,0,defense
GER-Bundesliga,2022,Bochum,Pierre Kunde,CMR,"MF,FW",27,1995,4.2,12,6,3,8,1,6,14,42.9,8,7,1,6,7,19,9,0,defense
GER-Bundesliga,2022,Bochum,Saidy Janko,GAM,DF,26,1995,12.6,23,15,13,8,2,12,20,60.0,8,24,10,14,11,34,33,1,defense
GER-Bundesliga,2022,Bochum,Silvère Ganvoula M'Boussy,CGO,"FW,MF",26,1996,2.7,2,2,0,1,1,0,0,,0,0,0,0,0,2,3,0,defense
GER-Bundesliga,2022,Bochum,Simon Zoller,GER,FW,31,1991,16.2,11,4,2,8,1,4,12,33.3,8,14,1,13,6,17,21,0,defense
GER-Bundesliga,2022,Bochum,Takuma Asano,JPN,"FW,MF",27,1994,19.0,14,9,4,4,6,7,16,43.8,9,17,1,16,8,22,8,0,defense
GER-Bundesliga,2022,Bochum,Tim Oermann,GER,DF,18,2003,2.2,2,1,2,0,0,1,1,100.0,0,3,2,1,1,3,8,1,defense
GER-Bundesliga,2022,Bochum,Vassilis Lambropoulos,GRE,DF,32,1990,7.0,10,8,7,3,0,6,9,66.7,3,5,3,2,13,23,41,0,defense
GER-Bundesliga,2022,Dortmund,Alexander Meyer,GER,GK,31,1991,7.0,0,0,0,0,0,0,1,0.0,1,0,0,0,0,0,1,0,defense
GER-Bundesliga,2022,Dortmund,Anthony Modeste,FRA,FW,34,1988,9.0,4,4,2,0,2,2,5,40.0,3,7,0,7,2,6,22,0,defense
GER-Bundesliga,2022,Dortmund,Antonios Papadopoulos,GER,DF,22,1999,0.1,0,0,0,0,0,0,0,,0,0,0,0,1,1,0,0,defense
GER-Bundesliga,2022,Dortmund,Donyell Malen,NED,FW,23,1999,19.0,13,5,3,4,6,5,12,41.7,7,14,1,13,4,17,11,0,defense
GER-Bundesliga,2022,Dortmund,Emre Can,GER,MF,28,1994,21.1,57,28,25,27,5,22,43,51.2,21,16,6,10,25,82,39,1,defense
GER-Bundesliga,2022,Dortmund,Felix Passlack,GER,DF,24,1998,0.7,4,3,0,4,0,1,1,100.0,0,1,1,0,0,4,1,0,defense
GER-Bundesliga,2022,Dortmund,Gio Reyna,USA,"FW,MF",19,2002,6.9,14,7,2,5,7,5,10,50.0,5,8,2,6,3,17,5,0,defense
GER-Bundesliga,2022,Dortmund,Gregor Kobel,SUI,GK,24,1997,27.0,0,0,0,0,0,0,1,0.0,1,1,0,1,0,0,7,2,defense
GER-Bundesliga,2022,Dortmund,Jamie Gittens,ENG,"FW,MF",17,2004,5.9,8,4,2,5,1,2,7,28.6,5,1,0,1,1,9,2,0,defense
GER-Bundesliga,2022,Dortmund,Jude Bellingham,ENG,MF,19,2003,29.9,76,42,28,34,14,34,51,66.7,17,51,4,47,35,111,30,0,defense
GER-Bundesliga,2022,Dortmund,Julian Brandt,GER,"MF,FW",26,1996,26.6,29,20,6,14,9,12,43,27.9,31,23,0,23,15,44,9,1,defense
GER-Bundesliga,2022,Dortmund,Julian Ryerson,NOR,DF,24,1997,15.7,27,15,17,7,3,19,37,51.4,18,13,2,11,8,35,28,0,defense
GER-Bundesliga,2022,Dortmund,Julien Duranville,BEL,MF,16,2006,0.3,1,1,0,1,0,1,1,100.0,0,0,0,0,0,1,0,0,defense
GER-Bundesliga,2022,Dortmund,Justin Njinmah,GER,FW,21,2000,0.2,0,0,0,0,0,0,0,,0,0,0,0,0,0,0,0,defense
GER-Bundesliga,2022,Dortmund,Karim Adeyemi,GER,"FW,MF",20,2002,15.4,16,11,6,6,4,8,30,26.7,22,18,1,17,7,23,3,0,defense
GER-Bundesliga,2022,Dortmund,Mahmoud Dahoud,GER,MF,26,1996,3.7,11,9,3,4,4,7,7,100.0,0,6,2,4,7,18,3,0,defense
GER-Bundesliga,2022,Dortmund,Marco Pašalić,CRO,MF,21,2000,0.1,0,0,0,0,0,0,0,,0,0,0,0,0,0,0,0,defense
GER-Bundesliga,2022,Dortmund,Marco Reus,GER,"MF,FW",33,1989,15.0,30,17,12,14,4,7,24,29.2,17,12,4,8,8,38,8,0,defense
GER-Bundesliga,2022,Dortmund,Marius Wolf,GER,DF,27,1995,17.4,25,18,9,12,4,16,29,55.2,13,40,10,30,18,43,22,1,defense
GER-Bundesliga,2022,Dortmund,Mats Hummels,GER,DF,33,1988,22.4,62,34,38,22,2,32,55,58.2,23,30,16,14,33,95,100,1,defense
GER-Bundesliga,2022,Dortmund,Nico Schlotterbeck,GER,DF,22,1999,25.0,59,34,34,24,1,37,53,69.8,16,38,21,17,32,91,71,1,defense
GER-Bundesliga,2022,Dortmund,Niklas Süle,GER,DF,26,1995,23.5,25,19,18,3,4,14,23,60.9,9,28,19,9,17,42,53,0,defense
GER-Bundesliga,2022,Dortmund,Raphaël Guerreiro,POR,"DF,MF",28,1993,25.4,36,20,13,15,8,21,34,61.8,13,21,2,19,36,72,23,0,defense
GER-Bundesliga,2022,Dortmund,Salih Özcan,TUR,MF,24,1998,17.5,31,18,10,16,5,16,39,41.0,23,24,2,22,28,59,19,1,defense
GER-Bundesliga,2022,Dortmund,Soumaïla Coulibaly,FRA,DF,18,2003,0.5,0,0,0,0,0,0,0,,0,0,0,0,0,0,0,1,defense
GER-Bundesliga,2022,Dortmund,Sébastien Haller,CIV,FW,28,1994,13.6,5,4,2,1,2,0,4,0.0,4,8,0,8,1,6,10,0,defense
GER-Bundesliga,2022,Dortmund,Thomas Meunier,BEL,DF,30,1991,6.5,16,7,8,5,3,10,17,58.8,7,7,2,5,9,25,16,0,defense
GER-Bundesliga,2022,Dortmund,Thorgan Hazard,BEL,"FW,DF",29,1993,5.2,17,6,5,11,1,12,17,70.6,5,6,0,6,5,22,5,0,defense
GER-Bundesliga,2022,Dortmund,Tom Rothe,GER,DF,17,2004,0.3,1,1,0,1,0,1,1,100.0,0,0,0,0,1,2,2,0,defense
GER-Bundesliga,2022,Dortmund,Youssoufa Moukoko,GER,FW,17,2004,12.7,13,7,3,6,4,3,6,50.0,3,9,0,9,2,15,1,0,defense
GER-Bundesliga,2022,Eint Frankfurt,Almamy Touré,MLI,DF,26,1996,4.4,13,7,7,5,1,5,9,55.6,4,9,2,7,10,23,8,0,defense
GER-Bundesliga,2022,Eint Frankfurt,Ansgar Knauff,GER,DF,20,2002,14.3,36,25,22,11,3,15,34,44.1,19,19,1,18,15,51,26,0,defense
GER-Bundesliga,2022,Eint Frankfurt,Aurélio Buta,POR,DF,25,1997,14.6,33,19,15,13,5,15,27,55.6,12,18,1,17,9,42,34,0,defense
GER-Bundesliga,2022,Eint Frankfurt,Christopher Lenz,GER,DF,27,1994,14.3,29,21,17,7,5,16,37,43.2,21,16,3,13,21,50,34,0,defense
GER-Bundesliga,2022,Eint Frankfurt,Daichi Kamada,JPN,MF,25,1996,25.2,51,31,10,37,4,31,57,54.4,26,31,2,29,16,67,17,1,defense
GER-Bundesliga,2022,Eint Frankfurt,Dario Gebuhr,GER,DF,19,2003,0.2,0,0,0,0,0,0,1,0.0,1,0,0,0,0,0,0,0,defense
GER-Bundesliga,2022,Eint Frankfurt,Diant Ramaj,GER,GK,20,2001,1.0,0,0,0,0,0,0,0,,0,0,0,0,0,0,1,0,defense
GER-Bundesliga,2022,Eint Frankfurt,Djibril Sow,SUI,MF,25,1997,29.4,41,25,13,25,3,22,44,50.0,22,22,4,18,28,69,23,0,defense
GER-Bundesliga,2022,Eint Frankfurt,Faride Alidou,GER,"DF,MF",21,2001,2.0,8,5,3,4,1,3,9,33.3,6,3,0,3,1,9,3,0,defense
GER-Bundesliga,2022,Eint Frankfurt,Filip Kostić,SRB,"DF,MF",29,1992,0.8,2,0,1,1,0,0,0,,0,0,0,0,1,3,0,0,defense
GER-Bundesliga,2022,Eint Frankfurt,Hrvoje Smolčić,CRO,DF,21,2000,5.2,8,7,6,2,0,5,10,50.0,5,11,4,7,6,14,38,0,defense
GER-Bundesliga,2022,Eint Frankfurt,Jesper Lindstrøm,DEN,"MF,FW",22,2000,18.7,26,11,15,7,4,7,22,31.8,15,25,3,22,9,35,9,0,defense
GER-Bundesliga,2022,Eint Frankfurt,Junior Dina Ebimbe,FRA,"DF,MF",21,2000,11.8,30,19,16,14,0,16,33,48.5,17,18,5,13,11,41,20,0,defense
GER-Bundesliga,2022,Eint Frankfurt,Kevin Trapp,GER,GK,32,1990,33.0,1,1,1,0,0,0,2,0.0,2,2,0,2,0,1,10,0,defense
GER-Bundesliga,2022,Eint Frankfurt,Kristijan Jakić,CRO,"DF,MF",25,1997,16.2,33,21,19,12,2,22,41,53.7,19,32,10,22,14,47,49,1,defense
GER-Bundesliga,2022,Eint Frankfurt,Luca Pellegrini,ITA,DF,23,1999,6.2,13,8,10,3,0,8,8,100.0,0,8,2,6,7,20,11,1,defense
GER-Bundesliga,2022,Eint Frankfurt,Lucas Alario,ARG,"FW,MF",29,1992,3.7,3,2,1,0,2,0,1,0.0,1,0,0,0,2,5,13,0,defense
GER-Bundesliga,2022,Eint Frankfurt,Makoto Hasebe,JPN,DF,38,1984,14.5,18,12,16,2,0,7,22,31.8,15,22,9,13,17,35,45,0,defense
GER-Bundesliga,2022,Eint Frankfurt,Marcel Wenig,GER,MF,18,2004,0.0,0,0,0,0,0,0,0,,0,0,0,0,0,0,0,0,defense
GER-Bundesliga,2022,Eint Frankfurt,Mario Götze,GER,MF,30,1992,30.4,42,25,13,22,7,14,47,29.8,33,25,0,25,13,55,12,0,defense
GER-Bundesliga,2022,Eint Frankfurt,Obite N'Dicka,CIV,DF,22,1999,29.9,25,18,10,11,4,18,32,56.3,14,47,19,28,31,56,150,0,defense
GER-Bundesliga,2022,Eint Frankfurt,Paxten Aaronson,USA,"MF,DF",18,2003,1.9,6,5,2,2,2,2,3,66.7,1,2,1,1,0,6,2,0,defense
GER-Bundesliga,2022,Eint Frankfurt,Philipp Max,GER,DF,28,1993,7.7,12,9,4,7,1,5,16,31.3,11,10,2,8,3,15,11,0,defense
GER-Bundesliga,2022,Eint Frankfurt,Rafael Borré,COL,"MF,FW",26,1995,12.0,25,15,4,13,8,4,17,23.5,13,10,2,8,2,27,9,0,defense
GER-Bundesliga,2022,Eint Frankfurt,Randal Kolo Muani,FRA,FW,23,1998,29.2,14,10,3,3,8,1,9,11.1,8,19,2,17,3,17,13,0,defense
GER-Bundesliga,2022,Eint Frankfurt,Sebastian Rode,GER,MF,31,1990,15.7,38,24,7,28,3,14,45,31.1,31,18,2,16,16,54,12,0,defense
GER-Bundesliga,2022,Eint Frankfurt,Timothy Chandler,USA,DF,32,1990,1.0,2,2,2,0,0,2,2,100.0,0,1,0,1,0,2,3,0,defense
GER-Bundesliga,2022,Eint Frankfurt,Tuta,BRA,DF,23,1999,30.2,53,35,27,19,7,33,57,57.9,24,47,14,33,49,102,134,2,defense
GER-Bundesliga,2022,Freiburg,Christian Günter,GER,"DF,MF",29,1993,30.5,29,21,18,9,2,13,43,30.2,30,22,4,18,16,45,41,0,defense
GER-Bundesliga,2022,Freiburg,Daniel Kyereh,GHA,"MF,FW",26,1996,6.2,6,4,2,4,0,3,6,50.0,3,4,0,4,2,8,6,0,defense
GER-Bundesliga,2022,Freiburg,Hugo Siquet,BEL,DF,20,2002,0.2,2,2,2,0,0,2,2,100.0,0,1,0,1,0,2,0,0,defense
GER-Bundesliga,2022,Freiburg,Jeong Woo-yeong,KOR,"MF,FW",22,1999,7.3,7,3,4,2,1,2,5,40.0,3,7,1,6,1,8,7,0,defense
GER-Bundesliga,2022,Freiburg,Jonathan Schmid,FRA,DF,32,1990,0.5,1,1,1,0,0,0,0,,0,1,0,1,1,2,1,1,defense
GER-Bundesliga,2022,Freiburg,Kenneth Schmidt,GER,DF,20,2002,2.8,6,3,4,2,0,5,6,83.3,1,4,2,2,0,6,2,0,defense
GER-Bundesliga,2022,Freiburg,Keven Schlotterbeck,GER,DF,25,1997,0.2,0,0,0,0,0,0,0,,0,1,1,0,2,2,2,0,defense
GER-Bundesliga,2022,Freiburg,Kevin Schade,GER,"FW,MF",20,2001,2.0,6,4,3,2,1,3,5,60.0,2,0,0,0,0,6,2,0,defense
GER-Bundesliga,2022,Freiburg,Kiliann Sildillia,FRA,"DF,MF",20,2002,22.0,33,20,10,19,4,18,30,60.0,12,24,9,15,21,54,47,1,defense
GER-Bundesliga,2022,Freiburg,Kimberly Ezekwem,GER,DF,21,2001,0.1,0,0,0,0,0,0,0,,0,1,0,1,0,0,0,0,defense
GER-Bundesliga,2022,Freiburg,Lucas Höler,GER,"FW,MF",28,1994,16.7,19,14,5,7,7,6,22,27.3,16,22,5,17,10,29,17,0,defense
GER-Bundesliga,2022,Freiburg,Lukas Kübler,GER,DF,29,1992,18.2,37,25,24,9,4,18,30,60.0,12,25,11,14,29,66,50,0,defense
GER-Bundesliga,2022,Freiburg,Manuel Gulde,GER,DF,31,1991,7.1,14,8,10,4,0,2,4,50.0,2,5,1,4,19,33,25,0,defense
GER-Bundesliga,2022,Freiburg,Mark Flekken,NED,GK,29,1993,34.0,0,0,0,0,0,0,1,0.0,1,1,0,1,0,0,9,5,defense
GER-Bundesliga,2022,Freiburg,Matthias Ginter,GER,DF,28,1994,34.0,43,20,29,12,2,26,40,65.0,14,40,24,16,35,78,153,3,defense
GER-Bundesliga,2022,Freiburg,Maximilian Eggestein,GER,MF,25,1996,27.2,51,29,21,24,6,17,35,48.6,18,37,8,29,36,87,27,0,defense
GER-Bundesliga,2022,Freiburg,Merlin Röhl,GER,"MF,FW",20,2002,0.6,1,0,1,0,0,0,0,,0,0,0,0,0,1,1,0,defense
GER-Bundesliga,2022,Freiburg,Michael Gregoritsch,AUT,FW,28,1994,23.9,19,12,6,9,4,3,21,14.3,18,23,4,19,5,24,10,0,defense
GER-Bundesliga,2022,Freiburg,Nicolas Höfler,GER,MF,32,1990,31.3,66,35,28,35,3,27,61,44.3,34,40,13,27,58,124,49,0,defense
GER-Bundesliga,2022,Freiburg,Nils Petersen,GER,FW,33,1988,3.1,6,4,0,3,3,2,5,40.0,3,11,2,9,1,7,6,0,defense
GER-Bundesliga,2022,Freiburg,Noah Weißhaupt,GER,"MF,DF",20,2001,4.7,11,6,3,7,1,2,7,28.6,5,4,0,4,6,17,8,0,defense
GER-Bundesliga,2022,Freiburg,Philipp Lienhart,AUT,DF,26,1996,27.8,29,18,19,10,0,13,27,48.1,14,29,15,14,35,64,97,0,defense
GER-Bundesliga,2022,Freiburg,Ritsu Doan,JPN,"MF,FW",24,1998,26.9,61,29,19,29,13,25,55,45.5,30,40,1,39,14,75,12,0,defense
GER-Bundesliga,2022,Freiburg,Robert Wagner,GER,MF,19,2003,0.4,0,0,0,0,0,0,0,,0,2,0,2,0,0,2,0,defense
GER-Bundesliga,2022,Freiburg,Roland Sallai,HUN,"MF,FW",25,1997,11.1,11,8,4,3,4,4,10,40.0,6,7,1,6,2,13,11,0,defense
GER-Bundesliga,2022,Freiburg,Vincenzo Grifo,ITA,"MF,FW",29,1993,26.8,29,16,6,15,8,13,31,41.9,18,18,1,17,19,48,19,0,defense
GER-Bundesliga,2022,Freiburg,Yannik Keitel,GER,MF,22,2000,7.6,11,7,4,6,1,3,5,60.0,2,6,3,3,13,24,8,0,defense
GER-Bundesliga,2022,Gladbach,Alassane Pléa,FRA,FW,29,1993,19.7,16,8,5,7,4,8,26,30.8,18,23,3,20,12,28,14,0,defense
GER-Bundesliga,2022,Gladbach,Christoph Kramer,GER,MF,31,1991,24.7,44,33,24,15,5,22,55,40.0,33,34,2,32,17,61,40,0,defense
GER-Bundesliga,2022,Gladbach,Florian Neuhaus,GER,MF,25,1997,15.6,19,9,9,5,5,8,27,29.6,19,20,3,17,12,31,5,0,defense
GER-Bundesliga,2022,Gladbach,Hannes Wolf,AUT,FW,23,1999,5.0,11,8,4,5,2,5,13,38.5,8,3,0,3,3,14,9,0,defense
GER-Bundesliga,2022,Gladbach,Jan Olschowsky,GER,GK,20,2001,4.0,0,0,0,0,0,0,1,0.0,1,1,0,1,0,0,1,0,defense
GER-Bundesliga,2022,Gladbach,Joe Scally,USA,DF,19,2002,24.5,31,20,25,5,1,24,31,77.4,7,17,6,11,8,39,61,0,defense
GER-Bundesliga,2022,Gladbach,Jonas Hofmann,GER,"FW,MF",30,1992,29.8,31,16,17,8,6,15,52,28.8,37,36,2,34,16,47,21,0,defense
GER-Bundesliga,2022,Gladbach,Jonas Omlin,SUI,GK,28,1994,14.3,1,1,1,0,0,1,3,33.3,2,1,0,1,0,1,9,1,defense
GER-Bundesliga,2022,Gladbach,Julian Weigl,GER,MF,26,1995,21.0,43,16,21,21,1,23,41,56.1,18,23,2,21,18,61,32,0,defense
GER-Bundesliga,2022,Gladbach,Ko Itakura,JPN,DF,25,1997,22.0,29,17,18,7,4,16,30,53.3,14,41,25,16,27,56,95,0,defense
GER-Bundesliga,2022,Gladbach,Lars Stindl,GER,"FW,MF",33,1988,19.3,24,14,4,17,3,10,28,35.7,18,24,5,19,11,35,19,0,defense
GER-Bundesliga,2022,Gladbach,Luca Netz,GER,DF,19,2003,7.8,25,13,19,3,3,19,32,59.4,13,5,1,4,6,31,27,0,defense
GER-Bundesliga,2022,Gladbach,Manu Koné,FRA,MF,21,2001,29.0,74,39,37,33,4,24,47,51.1,23,44,12,32,32,106,21,0,defense
GER-Bundesliga,2022,Gladbach,Marcus Thuram,FRA,FW,24,1997,27.9,14,7,3,6,5,6,13,46.2,7,20,3,17,6,20,22,0,defense
GER-Bundesliga,2022,Gladbach,Marvin Friedrich,GER,DF,26,1995,13.9,17,11,13,3,1,10,13,76.9,3,14,6,8,11,28,52,0,defense
GER-Bundesliga,2022,Gladbach,Nathan N'Goumou,CMR,FW,22,2000,7.7,11,5,5,5,1,7,13,53.8,6,9,0,9,1,12,4,0,defense
GER-Bundesliga,2022,Gladbach,Nico Elvedi,SUI,DF,25,1996,31.4,46,24,32,12,2,27,41,65.9,14,31,16,15,35,81,149,3,defense
GER-Bundesliga,2022,Gladbach,Oscar Fraulo,DEN,"FW,MF",18,2003,0.1,0,0,0,0,0,0,0,,0,0,0,0,0,0,0,0,defense
GER-Bundesliga,2022,Gladbach,Patrick Herrmann,GER,"FW,MF",31,1991,1.8,6,2,4,1,1,2,4,50.0,2,2,0,2,2,8,1,0,defense
GER-Bundesliga,2022,Gladbach,Ramy Bensebaini,ALG,DF,27,1995,27.6,34,21,21,10,3,26,39,66.7,13,44,14,30,36,70,98,1,defense
GER-Bundesliga,2022,Gladbach,Rocco Reitz,GER,MF,20,2002,0.0,0,0,0,0,0,0,0,,0,0,0,0,0,0,0,0,defense
GER-Bundesliga,2022,Gladbach,Semir Telalovic,GER,"MF,FW",22,1999,0.1,0,0,0,0,0,0,0,,0,0,0,0,0,0,0,0,defense
GER-Bundesliga,2022,Gladbach,Stefan Lainer,AUT,DF,29,1992,9.1,16,8,10,5,1,10,23,43.5,13,8,1,7,14,30,34,1,defense
GER-Bundesliga,2022,Gladbach,Tobias Sippel,GER,GK,34,1988,5.7,0,0,0,0,0,0,0,,0,0,0,0,0,0,1,1,defense
GER-Bundesliga,2022,Gladbach,Tony Jantschke,GER,"DF,MF",32,1990,1.1,2,1,1,1,0,1,1,100.0,0,5,3,2,0,2,5,0,defense
GER-Bundesliga,2022,Gladbach,Yann Sommer,SUI,GK,33,1988,10.0,1,0,1,0,0,1,1,100.0,0,0,0,0,0,1,8,0,defense
GER-Bundesliga,2022,Gladbach,Yvandro Borges Sanches,LUX,"FW,MF",18,2004,0.3,2,2,0,2,0,2,2,100.0,0,0,0,0,0,2,0,0,defense
GER-Bundesliga,2022,Hertha BSC,Agustín Rogel,URU,DF,24,1997,15.8,18,9,13,5,0,11,17,64.7,6,15,8,7,11,29,74,1,defense
GER-Bundesliga,2022,Hertha BSC,Chidera Ejuke,NGA,"FW,MF",24,1998,9.9,5,4,1,4,0,1,5,20.0,4,4,0,4,4,9,1,0,defense
GER-Bundesliga,2022,Hertha BSC,Davie Selke,GER,FW,27,1995,3.1,2,1,1,1,0,0,1,0.0,1,3,1,2,1,3,5,0,defense
GER-Bundesliga,2022,Hertha BSC,Derry Scherhant,GER,"FW,MF",19,2002,3.2,7,6,3,3,1,4,8,50.0,4,3,0,3,0,7,5,0,defense
GER-Bundesliga,2022,Hertha BSC,Dodi Lukebakio,BEL,"FW,MF",24,1997,26.6,18,11,7,8,3,6,27,22.2,21,23,5,18,13,31,17,0,defense
GER-Bundesliga,2022,Hertha BSC,Filip Uremović,CRO,DF,25,1997,19.2,38,23,29,8,1,14,22,63.6,8,18,13,5,36,74,88,2,defense
GER-Bundesliga,2022,Hertha BSC,Florian Niederlechner,GER,FW,31,1990,8.7,9,7,2,4,3,2,8,25.0,6,7,0,7,3,12,10,0,defense
GER-Bundesliga,2022,Hertha BSC,Ibrahim Maza,ALG,"MF,FW",16,2005,0.8,1,1,1,0,0,0,1,0.0,1,2,0,2,0,1,1,0,defense
GER-Bundesliga,2022,Hertha BSC,Ivan Šunjić,BIH,MF,25,1996,11.0,38,20,16,21,1,16,24,66.7,8,17,5,12,13,51,19,1,defense
GER-Bundesliga,2022,Hertha BSC,Jean-Paul Boëtius,NED,MF,28,1994,11.7,30,16,19,9,2,8,25,32.0,17,25,5,20,14,44,10,0,defense
GER-Bundesliga,2022,Hertha BSC,Jessic Ngankam,GER,"FW,MF",22,2000,9.2,14,9,7,4,3,6,14,42.9,8,6,1,5,1,15,4,0,defense
GER-Bundesliga,2022,Hertha BSC,Jonjoe Kenny,ENG,DF,25,1997,24.9,46,34,27,16,3,24,42,57.1,18,38,9,29,46,92,74,0,defense
GER-Bundesliga,2022,Hertha BSC,Julian Eitschberger,GER,FW,18,2004,0.0,0,0,0,0,0,0,0,,0,0,0,0,0,0,0,0,defense
GER-Bundesliga,2022,Hertha BSC,Kevin-Prince Boateng,GHA,MF,35,1987,5.2,8,6,4,2,2,3,9,33.3,6,11,3,8,3,11,5,0,defense
GER-Bundesliga,2022,Hertha BSC,Lucas Tousart,FRA,MF,25,1997,32.7,73,38,35,28,10,27,60,45.0,33,42,6,36,48,121,75,1,defense
GER-Bundesliga,2022,Hertha BSC,Marc-Oliver Kempf,GER,DF,27,1995,30.1,44,27,29,14,1,16,22,72.7,6,42,32,10,51,95,143,0,defense
GER-Bundesliga,2022,Hertha BSC,Marco Richter,GER,"MF,FW",24,1997,20.4,43,23,18,17,8,19,48,39.6,29,29,2,27,24,67,25,0,defense
GER-Bundesliga,2022,Hertha BSC,Marvin Plattenhardt,GER,DF,30,1992,26.7,43,33,24,15,4,29,47,61.7,18,25,11,14,15,58,82,0,defense
GER-Bundesliga,2022,Hertha BSC,Maximilian Mittelstädt,GER,"DF,MF",25,1997,9.4,39,20,31,6,2,17,39,43.6,22,13,2,11,26,65,27,0,defense
GER-Bundesliga,2022,Hertha BSC,Myziane Maolida,COM,"FW,MF",23,1999,1.1,1,1,1,0,0,1,2,50.0,1,0,0,0,0,1,1,0,defense
GER-Bundesliga,2022,Hertha BSC,Márton Dárdai,HUN,"DF,MF",20,2002,10.5,17,8,9,8,0,9,18,50.0,9,14,9,5,11,28,45,1,defense
GER-Bundesliga,2022,Hertha BSC,Oliver Christensen,DEN,GK,23,1999,33.0,1,0,1,0,0,0,2,0.0,2,0,0,0,0,1,22,2,defense
GER-Bundesliga,2022,Hertha BSC,Pascal Klemens,GER,DF,17,2005,1.0,0,0,0,0,0,0,1,0.0,1,1,0,1,1,1,3,0,defense
GER-Bundesliga,2022,Hertha BSC,Peter Pekarík,SVK,DF,35,1986,2.3,4,3,4,0,0,4,6,66.7,2,6,2,4,4,8,7,0,defense
GER-Bundesliga,2022,Hertha BSC,Stevan Jovetić,MNE,"FW,MF",32,1989,9.9,3,2,2,1,0,1,11,9.1,10,2,1,1,2,5,10,0,defense
GER-Bundesliga,2022,Hertha BSC,Suat Serdar,GER,MF,25,1997,22.5,51,23,14,30,7,20,41,48.8,21,48,12,36,29,80,24,0,defense
GER-Bundesliga,2022,Hertha BSC,Tjark Ernst,GER,GK,19,2003,1.0,0,0,0,0,0,0,0,,0,0,0,0,0,0,1,0,defense
GER-Bundesliga,2022,Hertha BSC,Tolga Ciğerci,TUR,MF,30,1992,7.5,16,13,6,9,1,10,16,62.5,6,6,2,4,8,24,5,0,defense
GER-Bundesliga,2022,Hertha BSC,Tony Rölke,GER,FW,19,2003,0.2,0,0,0,0,0,0,0,,0,1,0,1,0,0,1,0,defense
GER-Bundesliga,2022,Hertha BSC,Veit Stange,GER,MF,18,2004,0.1,1,1,1,0,0,1,1,100.0,0,0,0,0,0,1,0,0,defense
GER-Bundesliga,2022,Hertha BSC,Vladimír Darida,CZE,MF,31,1990,0.3,1,1,0,1,0,0,0,,0,1,0,1,0,1,0,0,defense
GER-Bundesliga,2022,Hertha BSC,Wilfried Kanga,CIV,FW,24,1998,15.7,5,4,2,1,2,2,4,50.0,2,14,3,11,2,7,13,0,defense
GER-Bundesliga,2022,Hoffenheim,Andrej Kramarić,CRO,"MF,FW",31,1991,26.5,5,2,2,1,2,1,11,9.1,10,14,2,12,6,11,13,0,defense
GER-Bundesliga,2022,Hoffenheim,Angeliño,ESP,DF,25,1997,29.1,40,24,19,18,3,23,37,62.2,14,32,6,26,25,65,67,0,defense
GER-Bundesliga,2022,Hoffenheim,Angelo Stiller,GER,MF,21,2001,7.8,26,12,9,13,4,8,12,66.7,4,12,2,10,10,36,14,0,defense
GER-Bundesliga,2022,Hoffenheim,Christoph Baumgartner,AUT,"MF,FW",22,1999,28.5,36,19,12,17,7,9,52,17.3,43,57,5,52,15,51,19,1,defense
GER-Bundesliga,2022,Hoffenheim,Dennis Geiger,GER,MF,24,1998,21.7,45,25,15,28,2,22,35,62.9,13,27,3,24,24,69,18,2,defense
GER-Bundesliga,2022,Hoffenheim,Diadie Samassékou,MLI,"MF,FW",26,1996,0.4,1,0,0,1,0,0,1,0.0,1,0,0,0,0,1,0,0,defense
GER-Bundesliga,2022,Hoffenheim,Eduardo Quaresma,POR,DF,20,2002,1.0,5,3,3,2,0,1,3,33.3,2,3,2,1,0,5,3,0,defense
GER-Bundesliga,2022,Hoffenheim,Ermin Bičakčić,BIH,DF,32,1990,2.9,8,4,6,1,1,2,6,33.3,4,4,3,1,5,13,14,0,defense
GER-Bundesliga,2022,Hoffenheim,Finn Ole Becker,GER,MF,22,2000,5.7,10,2,4,6,0,4,7,57.1,3,4,0,4,5,15,8,0,defense
GER-Bundesliga,2022,Hoffenheim,Fisnik Asllani,KVX,FW,19,2002,1.9,0,0,0,0,0,0,4,0.0,4,2,0,2,3,3,3,0,defense
GER-Bundesliga,2022,Hoffenheim,Georginio Rutter,FRA,FW,20,2002,11.2,7,4,1,4,2,1,3,33.3,2,10,2,8,5,12,6,0,defense
GER-Bundesliga,2022,Hoffenheim,Grischa Prömel,GER,MF,27,1995,16.2,27,19,14,11,2,9,25,36.0,16,22,4,18,8,35,23,0,defense
GER-Bundesliga,2022,Hoffenheim,Ihlas Bebou,TOG,"FW,DF",28,1994,15.7,19,16,8,7,4,11,17,64.7,6,9,2,7,7,26,15,0,defense
GER-Bundesliga,2022,Hoffenheim,Jacob Bruun Larsen,DEN,FW,23,1998,3.6,4,3,0,1,3,3,4,75.0,1,3,1,2,1,5,0,0,defense
GER-Bundesliga,2022,Hoffenheim,John Brooks,USA,DF,29,1993,15.0,18,12,10,8,0,13,18,72.2,5,17,12,5,10,28,105,0,defense
GER-Bundesliga,2022,Hoffenheim,Joshua Quarshie,GER,MF,18,2004,0.0,0,0,0,0,0,0,0,,0,0,0,0,0,0,0,0,defense
GER-Bundesliga,2022,Hoffenheim,Kasper Dolberg,DEN,"FW,MF",24,1997,4.5,7,5,1,4,2,4,6,66.7,2,6,2,4,0,7,5,0,defense
GER-Bundesliga,2022,Hoffenheim,Kevin Akpoguma,NGA,DF,27,1995,21.7,75,44,45,27,3,32,45,71.1,13,45,16,29,24,99,70,1,defense
GER-Bundesliga,2022,Hoffenheim,Kevin Vogt,GER,DF,30,1991,19.7,15,10,10,5,0,9,22,40.9,13,18,11,7,26,41,67,0,defense
GER-Bundesliga,2022,Hoffenheim,Moanes Dabbur,ISR,FW,30,1992,10.4,11,8,4,5,2,3,9,33.3,6,8,0,8,5,16,0,0,defense
GER-Bundesliga,2022,Hoffenheim,Muhammed Damar,GER,MF,18,2004,1.8,6,3,1,2,3,1,2,50.0,1,3,0,3,0,6,0,0,defense
GER-Bundesliga,2022,Hoffenheim,Oliver Baumann,GER,GK,32,1990,34.0,0,0,0,0,0,0,0,,0,0,0,0,0,0,15,1,defense
GER-Bundesliga,2022,Hoffenheim,Ozan Kabak,TUR,DF,22,2000,26.5,51,34,27,21,3,17,30,56.7,13,35,23,12,45,96,83,0,defense
GER-Bundesliga,2022,Hoffenheim,Pavel Kadeřábek,CZE,DF,30,1992,18.5,26,20,10,9,7,15,23,65.2,8,12,2,10,14,40,37,1,defense
GER-Bundesliga,2022,Hoffenheim,Robert Skov,DEN,DF,26,1996,15.0,22,11,14,7,1,10,26,38.5,16,22,8,14,8,30,20,2,defense
GER-Bundesliga,2022,Hoffenheim,Sebastian Rudy,GER,MF,32,1990,8.8,26,12,10,16,0,13,27,48.1,14,27,7,20,11,37,13,0,defense
GER-Bundesliga,2022,Hoffenheim,Stanley N'Soki,FRA,DF,23,1999,14.3,22,13,14,7,1,12,22,54.5,10,22,5,17,24,46,34,0,defense
GER-Bundesliga,2022,Hoffenheim,Stefan Posch,AUT,DF,25,1997,0.2,0,0,0,0,0,0,0,,0,0,0,0,0,0,0,0,defense
GER-Bundesliga,2022,Hoffenheim,Thomas Delaney,DEN,MF,30,1991,3.3,6,3,3,2,1,3,8,37.5,5,5,0,5,1,7,4,0,defense
GER-Bundesliga,2022,Hoffenheim,Tom Bischof,GER,"MF,FW",17,2005,3.5,15,10,8,3,4,7,10,70.0,3,5,1,4,1,16,1,0,defense
GER-Bundesliga,2022,Hoffenheim,Umut Tohumcu,GER,"MF,DF",17,2004,3.0,10,5,4,5,1,3,9,33.3,6,4,0,4,2,12,8,0,defense
GER-Bundesliga,2022,Köln,Benno Schmitz,GER,DF,27,1994,26.9,64,42,31,28,5,42,82,51.2,40,34,4,30,26,90,57,0,defense
GER-Bundesliga,2022,Köln,Davie Selke,GER,FW,27,1995,9.7,0,0,0,0,0,0,4,0.0,4,4,1,3,0,0,11,0,defense
GER-Bundesliga,2022,Köln,Dejan Ljubicic,AUT,"MF,FW",24,1997,19.0,25,14,7,14,4,13,40,32.5,27,20,1,19,8,33,8,1,defense
GER-Bundesliga,2022,Köln,Denis Huseinbasic,BIH,"MF,FW",21,2001,8.8,23,9,8,11,4,10,25,40.0,15,16,2,14,4,27,5,0,defense
GER-Bundesliga,2022,Köln,Dimitris Limnios,GRE,FW,24,1998,0.4,0,0,0,0,0,0,0,,0,0,0,0,1,1,0,0,defense
GER-Bundesliga,2022,Köln,Ellyes Skhiri,TUN,MF,27,1995,31.7,79,44,29,42,8,26,66,39.4,40,52,12,40,56,135,48,0,defense
GER-Bundesliga,2022,Köln,Eric Martel,GER,MF,20,2002,22.4,66,41,29,30,7,30,60,50.0,30,29,9,20,33,99,49,0,defense
GER-Bundesliga,2022,Köln,Florian Dietz,GER,FW,23,1998,4.4,2,1,0,2,0,1,4,25.0,3,4,1,3,0,2,2,0,defense
GER-Bundesliga,2022,Köln,Florian Kainz,AUT,"MF,FW",29,1992,26.0,21,10,7,12,2,8,26,30.8,18,27,6,21,32,53,30,1,defense
GER-Bundesliga,2022,Köln,Jan Thielmann,GER,FW,20,2002,9.7,9,8,3,4,2,2,11,18.2,9,16,3,13,9,18,7,0,defense
GER-Bundesliga,2022,Köln,Jonas Hector,GER,DF,32,1990,31.4,112,66,59,43,10,66,113,58.4,47,61,9,52,39,151,74,1,defense
GER-Bundesliga,2022,Köln,Julian Chabot,GER,DF,24,1998,20.0,36,23,19,14,3,20,35,57.1,15,30,18,12,41,77,105,0,defense
GER-Bundesliga,2022,Köln,Justin Diehl,GER,"MF,FW",17,2004,0.2,0,0,0,0,0,0,0,,0,0,0,0,0,0,0,0,defense
GER-Bundesliga,2022,Köln,Kingsley Ehizibue,NED,DF,27,1995,0.7,0,0,0,0,0,0,0,,0,1,0,1,2,2,1,0,defense
GER-Bundesliga,2022,Köln,Kingsley Schindler,GHA,"DF,MF",29,1993,12.1,23,12,13,8,2,18,28,64.3,10,14,2,12,15,38,24,0,defense
GER-Bundesliga,2022,Köln,Kristian Pedersen,DEN,DF,27,1994,3.1,5,4,4,1,0,0,2,0.0,2,3,0,3,6,11,17,0,defense
GER-Bundesliga,2022,Köln,Linton Maina,GER,"FW,MF",23,1999,24.9,18,12,5,11,2,7,30,23.3,23,19,0,19,5,23,9,0,defense
GER-Bundesliga,2022,Köln,Luca Kilian,GER,DF,22,1999,12.5,22,16,14,7,1,12,21,57.1,9,16,8,8,11,33,48,0,defense
GER-Bundesliga,2022,Köln,Mark Uth,GER,"MF,FW",30,1991,0.5,0,0,0,0,0,0,0,,0,0,0,0,0,0,0,0,defense
GER-Bundesliga,2022,Köln,Marvin Schwäbe,GER,GK,27,1995,34.0,1,0,1,0,0,1,1,100.0,0,0,0,0,2,3,8,2,defense
GER-Bundesliga,2022,Köln,Mathias Olesen,LUX,MF,21,2001,5.3,10,5,4,4,2,5,8,62.5,3,6,1,5,2,12,3,0,defense
GER-Bundesliga,2022,Köln,Nikola Soldo,CRO,DF,21,2001,6.6,15,9,8,7,0,7,11,63.6,4,7,6,1,7,22,28,0,defense
GER-Bundesliga,2022,Köln,Ondrej Duda,SVK,MF,27,1994,7.7,9,8,2,5,2,4,11,36.4,7,7,1,6,2,11,3,0,defense
GER-Bundesliga,2022,Köln,Sargis Adamyan,ARM,"FW,MF",29,1993,7.2,14,7,5,3,6,7,17,41.2,10,12,0,12,4,18,5,0,defense
GER-Bundesliga,2022,Köln,Steffen Tigges,GER,FW,24,1998,17.7,12,7,1,8,3,4,14,28.6,10,13,2,11,8,20,17,0,defense
GER-Bundesliga,2022,Köln,Tim Lemperle,GER,"FW,MF",20,2002,1.5,6,4,3,1,2,3,5,60.0,2,5,0,5,1,7,4,0,defense
GER-Bundesliga,2022,Köln,Timo Hübers,GER,DF,26,1996,28.4,43,28,35,8,0,24,52,46.2,28,27,13,14,58,101,153,0,defense
GER-Bundesliga,2022,Leverkusen,Adam Hložek,CZE,"FW,MF",20,2002,14.3,9,4,4,3,2,3,9,33.3,6,9,2,7,6,15,9,0,defense
GER-Bundesliga,2022,Leverkusen,Amine Adli,MAR,"FW,MF",22,2000,15.9,18,10,4,6,8,5,17,29.4,12,28,2,26,6,24,7,0,defense
GER-Bundesliga,2022,Leverkusen,Andrey Lunyov,RUS,GK,30,1991,1.0,0,0,0,0,0,0,0,,0,0,0,0,0,0,0,0,defense
GER-Bundesliga,2022,Leverkusen,Ayman Azhil,MAR,MF,21,2001,0.0,0,0,0,0,0,0,0,,0,0,0,0,0,0,0,0,defense
GER-Bundesliga,2022,Leverkusen,Callum Hudson-Odoi,ENG,"FW,MF",21,2000,6.7,5,3,4,0,1,1,1,100.0,0,0,0,0,2,7,4,0,defense
GER-Bundesliga,2022,Leverkusen,Charles Aránguiz,CHI,MF,33,1989,5.5,17,7,7,10,0,12,20,60.0,8,4,0,4,7,24,4,0,defense
GER-Bundesliga,2022,Leverkusen,Daley Sinkgraven,NED,"DF,MF",27,1995,3.8,10,7,7,3,0,7,9,77.8,2,8,4,4,5,15,7,0,defense
GER-Bundesliga,2022,Leverkusen,Edmond Tapsoba,BFA,DF,23,1999,31.9,51,30,35,12,4,30,42,71.4,12,40,17,23,36,87,109,1,defense
GER-Bundesliga,2022,Leverkusen,Exequiel Palacios,ARG,MF,23,1998,18.4,59,36,20,33,6,29,48,60.4,19,29,2,27,33,92,28,0,defense
GER-Bundesliga,2022,Leverkusen,Florian Wirtz,GER,"FW,MF",19,2003,12.1,18,10,9,7,2,8,16,50.0,8,15,1,14,1,19,6,0,defense
GER-Bundesliga,2022,Leverkusen,Jeremie Frimpong,NED,"DF,MF",21,2000,30.1,53,27,22,26,5,23,44,52.3,21,24,3,21,16,69,40,0,defense
GER-Bundesliga,2022,Leverkusen,Joel Pohjanpalo,FIN,"FW,MF",27,1994,0.0,0,0,0,0,0,0,0,,0,0,0,0,0,0,0,0,defense
GER-Bundesliga,2022,Leverkusen,Jonathan Tah,GER,DF,26,1996,27.6,25,12,21,4,0,12,18,66.7,6,30,18,12,40,65,118,0,defense
GER-Bundesliga,2022,Leverkusen,Karim Bellarabi,GER,"FW,MF",32,1990,0.9,2,0,1,1,0,2,3,66.7,1,0,0,0,0,2,0,0,defense
GER-Bundesliga,2022,Leverkusen,Kerem Demirbay,GER,MF,29,1993,17.2,36,18,16,17,3,18,34,52.9,16,26,6,20,16,52,11,0,defense
GER-Bundesliga,2022,Leverkusen,Lukáš Hrádecký,FIN,GK,32,1989,33.0,0,0,0,0,0,0,0,,0,0,0,0,0,0,3,3,defense
GER-Bundesliga,2022,Leverkusen,Mitchel Bakker,NED,"DF,MF",22,2000,18.4,16,8,9,7,0,6,15,40.0,9,20,2,18,15,31,20,2,defense
GER-Bundesliga,2022,Leverkusen,Moussa Diaby,FRA,"FW,MF",23,1999,30.0,14,8,4,8,2,7,14,50.0,7,8,0,8,5,19,3,0,defense
GER-Bundesliga,2022,Leverkusen,Nadiem Amiri,GER,"MF,FW",25,1996,10.9,15,6,5,8,2,9,20,45.0,11,12,1,11,6,21,10,2,defense
GER-Bundesliga,2022,Leverkusen,Noah Mbamba,BEL,MF,17,2005,0.0,0,0,0,0,0,0,0,,0,0,0,0,0,0,0,0,defense
GER-Bundesliga,2022,Leverkusen,Odilon Kossounou,CIV,DF,21,2001,16.9,21,14,12,7,2,8,16,50.0,8,26,11,15,24,45,58,1,defense
GER-Bundesliga,2022,Leverkusen,Patrik Schick,CZE,FW,26,1996,10.5,0,0,0,0,0,0,1,0.0,1,4,1,3,1,1,7,0,defense
GER-Bundesliga,2022,Leverkusen,Paulinho,BRA,FW,22,2000,0.9,0,0,0,0,0,0,0,,0,1,0,1,0,0,2,0,defense
GER-Bundesliga,2022,Leverkusen,Piero Hincapié,ECU,"DF,MF",20,2002,27.3,51,34,28,20,3,25,38,65.8,13,41,20,21,31,82,83,1,defense
GER-Bundesliga,2022,Leverkusen,Robert Andrich,GER,MF,27,1994,26.7,61,38,30,27,4,26,45,57.8,19,27,9,18,42,103,55,2,defense
GER-Bundesliga,2022,Leverkusen,Sardar Azmoun,IRN,"FW,MF",27,1995,10.3,6,3,1,4,1,1,7,14.3,6,4,0,4,2,8,14,0,defense
GER-Bundesliga,2022,Leverkusen,Timothy Fosu-Mensah,NED,DF,24,1998,2.1,7,5,3,3,1,4,4,100.0,0,2,0,2,0,7,1,0,defense
GER-Bundesliga,2022,Mainz 05,Aarón Martín,ESP,DF,25,1997,20.5,42,27,25,11,6,21,40,52.5,19,22,1,21,15,57,31,0,defense
GER-Bundesliga,2022,Mainz 05,Alexander Hack,GER,DF,28,1993,12.6,30,18,21,9,0,19,33,57.6,14,18,5,13,24,54,45,1,defense
GER-Bundesliga,2022,Mainz 05,Andreas Hanche-Olsen,NOR,DF,25,1997,16.6,35,23,24,7,4,22,39,56.4,17,16,8,8,33,68,77,2,defense
GER-Bundesliga,2022,Mainz 05,Angelo Fulgini,FRA,MF,25,1996,5.8,6,5,2,3,1,5,12,41.7,7,5,0,5,5,11,7,0,defense
GER-Bundesliga,2022,Mainz 05,Anthony Caci,FRA,DF,25,1997,22.6,58,33,32,20,6,28,42,66.7,14,28,4,24,54,112,40,0,defense
GER-Bundesliga,2022,Mainz 05,Anton Stach,GER,MF,23,1998,23.0,27,21,10,15,2,16,38,42.1,22,28,2,26,41,68,25,0,defense
GER-Bundesliga,2022,Mainz 05,Aymen Barkok,MAR,MF,24,1998,6.5,18,8,10,5,3,5,10,50.0,5,7,0,7,3,21,9,0,defense
GER-Bundesliga,2022,Mainz 05,Brajan Gruda,GER,MF,18,2004,0.0,0,0,0,0,0,0,0,,0,0,0,0,0,0,0,0,defense
GER-Bundesliga,2022,Mainz 05,Danny da Costa,GER,DF,29,1993,13.7,20,16,7,8,5,12,20,60.0,8,22,3,19,9,29,26,0,defense
GER-Bundesliga,2022,Mainz 05,Delano Burgzorg,SUR,"FW,MF",23,1998,2.7,3,3,1,1,1,2,3,66.7,1,2,0,2,0,3,2,0,defense
GER-Bundesliga,2022,Mainz 05,Dominik Kohr,GER,MF,28,1994,25.5,59,33,23,31,5,29,61,47.5,32,46,9,37,34,93,26,1,defense
GER-Bundesliga,2022,Mainz 05,Edimilson Fernandes,SUI,DF,26,1996,27.1,35,25,26,5,4,18,34,52.9,16,37,16,21,54,89,87,2,defense
GER-Bundesliga,2022,Mainz 05,Eniss Shabani,ALB,MF,19,2003,0.1,0,0,0,0,0,0,0,,0,0,0,0,0,0,0,0,defense
GER-Bundesliga,2022,Mainz 05,Finn Dahmen,GER,GK,24,1998,8.0,0,0,0,0,0,0,0,,0,0,0,0,0,0,3,0,defense
GER-Bundesliga,2022,Mainz 05,Jonathan Burkardt,GER,"MF,FW",22,2000,5.9,3,1,0,1,2,1,4,25.0,3,6,1,5,1,4,1,0,defense
GER-Bundesliga,2022,Mainz 05,Karim Onisiwo,AUT,"FW,MF",30,1992,28.2,19,12,3,10,6,4,21,19.0,17,19,0,19,2,21,7,0,defense
GER-Bundesliga,2022,Mainz 05,Leandro Barreiro Martins,LUX,MF,22,2000,23.8,60,38,19,28,13,22,49,44.9,27,38,13,25,41,101,39,1,defense
GER-Bundesliga,2022,Mainz 05,Lee Jae-sung,KOR,MF,29,1992,21.0,38,17,9,21,8,16,36,44.4,20,29,5,24,17,55,21,0,defense
GER-Bundesliga,2022,Mainz 05,Ludovic Ajorque,FRA,"FW,MF",28,1994,13.5,6,5,1,4,1,1,9,11.1,8,8,2,6,1,7,8,0,defense
GER-Bundesliga,2022,Mainz 05,Marcus Ingvartsen,DEN,"FW,MF",26,1996,14.6,4,1,0,2,2,1,10,10.0,9,9,1,8,4,8,10,0,defense
GER-Bundesliga,2022,Mainz 05,Marlon Mustapha,AUT,"FW,MF",21,2001,0.8,2,2,0,2,0,0,0,,0,4,0,4,0,2,0,0,defense
GER-Bundesliga,2022,Mainz 05,Maxim Leitsch,GER,DF,24,1998,7.4,9,7,6,3,0,4,5,80.0,1,7,4,3,18,27,26,1,defense
GER-Bundesliga,2022,Mainz 05,Nelson Weiper,GER,"FW,DF",17,2005,1.1,2,0,0,0,2,1,3,33.3,2,2,0,2,0,2,1,0,defense
GER-Bundesliga,2022,Mainz 05,Niklas Tauer,GER,"DF,MF",21,2001,1.0,2,1,2,0,0,1,3,33.3,2,2,1,1,2,4,4,0,defense
GER-Bundesliga,2022,Mainz 05,Robin Zentner,GER,GK,27,1994,26.0,0,0,0,0,0,0,4,0.0,4,0,0,0,0,0,17,1,defense
GER-Bundesliga,2022,Mainz 05,Silvan Widmer,SUI,DF,29,1993,18.8,26,17,15,10,1,20,39,51.3,19,22,8,14,31,57,28,0,defense
GER-Bundesliga,2022,Mainz 05,Stefan Bell,GER,DF,30,1991,26.6,43,28,32,10,1,22,44,50.0,22,42,15,27,44,87,133,0,defense
GER-Bundesliga,2022,RB Leipzig,Abdou Diallo,SEN,"DF,MF",26,1996,5.3,6,5,5,1,0,1,3,33.3,2,8,5,3,8,14,22,0,defense
GER-Bundesliga,2022,RB Leipzig,Alexander Sørloth,NOR,FW,26,1995,0.1,0,0,0,0,0,0,0,,0,0,0,0,0,0,0,0,defense
GER-Bundesliga,2022,RB Leipzig,Amadou Haidara,MLI,MF,24,1998,15.9,25,11,15,10,0,13,34,38.2,21,26,6,20,26,51,20,0,defense
GER-Bundesliga,2022,RB Leipzig,André Silva,POR,FW,26,1995,19.3,12,6,2,5,5,3,8,37.5,5,11,1,10,3,15,3,0,defense
GER-Bundesliga,2022,RB Leipzig,Benjamin Henrichs,GER,"DF,MF",25,1997,24.3,73,46,41,29,3,43,66,65.2,23,48,4,44,35,108,46,0,defense
GER-Bundesliga,2022,RB Leipzig,Christopher Nkunku,FRA,"FW,MF",24,1997,21.1,6,4,2,1,3,1,6,16.7,5,8,3,5,8,14,11,0,defense
GER-Bundesliga,2022,RB Leipzig,Dani Olmo,ESP,"MF,FW",24,1998,14.2,15,9,1,10,4,6,14,42.9,8,15,0,15,6,21,6,0,defense
GER-Bundesliga,2022,RB Leipzig,David Raum,GER,"DF,MF",24,1998,18.7,39,25,23,12,4,17,29,58.6,12,24,6,18,16,55,26,1,defense
GER-Bundesliga,2022,RB Leipzig,Dominik Szoboszlai,HUN,"MF,FW",21,2000,27.2,45,28,12,20,13,17,42,40.5,25,43,2,41,17,62,27,0,defense
GER-Bundesliga,2022,RB Leipzig,Emil Forsberg,SWE,"MF,FW",30,1991,16.5,16,11,1,8,7,6,20,30.0,14,25,2,23,3,19,7,0,defense
GER-Bundesliga,2022,RB Leipzig,Hugo Novoa,ESP,"DF,FW",19,2003,2.0,8,2,1,3,4,4,7,57.1,3,4,0,4,1,9,0,0,defense
GER-Bundesliga,2022,RB Leipzig,Janis Blaswich,GER,GK,31,1991,26.0,0,0,0,0,0,0,0,,0,0,0,0,0,0,10,0,defense
GER-Bundesliga,2022,RB Leipzig,Joško Gvardiol,CRO,DF,20,2002,24.1,23,17,15,8,0,9,22,40.9,13,34,17,17,34,57,76,1,defense
GER-Bundesliga,2022,RB Leipzig,Kevin Kampl,SVN,MF,31,1990,15.2,21,11,6,14,1,6,27,22.2,21,26,9,17,22,43,11,0,defense
GER-Bundesliga,2022,RB Leipzig,Konrad Laimer,AUT,MF,25,1997,16.3,60,31,23,30,7,30,54,55.6,24,31,4,27,18,78,8,0,defense
GER-Bundesliga,2022,RB Leipzig,Lukas Klostermann,GER,DF,26,1996,10.1,16,8,7,9,0,8,15,53.3,7,6,3,3,13,29,31,0,defense
GER-Bundesliga,2022,RB Leipzig,Marcel Halstenberg,GER,DF,30,1991,17.3,40,21,20,15,5,23,41,56.1,18,22,1,21,21,61,29,0,defense
GER-Bundesliga,2022,RB Leipzig,Mohamed Simakan,FRA,DF,22,2000,16.2,21,14,12,5,4,14,21,66.7,7,21,4,17,16,37,55,0,defense
GER-Bundesliga,2022,RB Leipzig,Péter Gulácsi,HUN,GK,32,1990,6.0,0,0,0,0,0,0,0,,0,0,0,0,0,0,2,0,defense
GER-Bundesliga,2022,RB Leipzig,Sanoussy Ba,GER,DF,18,2004,0.0,0,0,0,0,0,0,0,,0,0,0,0,0,0,0,0,defense
GER-Bundesliga,2022,RB Leipzig,Timo Werner,GER,"FW,MF",26,1996,21.5,10,5,4,3,3,4,12,33.3,8,12,0,12,7,17,5,0,defense
GER-Bundesliga,2022,RB Leipzig,Willi Orban,HUN,DF,29,1992,32.8,51,30,33,18,0,26,43,60.5,17,42,24,18,39,90,129,1,defense
GER-Bundesliga,2022,RB Leipzig,Xaver Schlager,AUT,MF,24,1997,16.7,41,24,13,26,2,20,43,46.5,23,19,2,17,17,58,23,0,defense
GER-Bundesliga,2022,RB Leipzig,Yussuf Poulsen,DEN,FW,28,1994,4.6,6,4,1,4,1,2,5,40.0,3,3,1,2,0,6,5,0,defense
GER-Bundesliga,2022,RB Leipzig,Ørjan Nyland,NOR,GK,31,1990,2.0,0,0,0,0,0,0,0,,0,0,0,0,0,0,0,0,defense
GER-Bundesliga,2022,Schalke 04,Alex Král,CZE,MF,24,1998,26.2,34,24,10,22,2,17,37,45.9,20,31,6,25,17,51,53,0,defense
GER-Bundesliga,2022,Schalke 04,Alexander Schwolow,GER,GK,30,1992,22.6,0,0,0,0,0,0,2,0.0,2,0,0,0,1,1,6,3,defense
GER-Bundesliga,2022,Schalke 04,Andreas Ivan,ROU,MF,27,1995,0.5,0,0,0,0,0,0,1,0.0,1,0,0,0,0,0,1,0,defense
GER-Bundesliga,2022,Schalke 04,Cédric Brunner,SUI,DF,28,1994,25.7,39,27,26,11,2,30,45,66.7,15,24,7,17,43,82,79,0,defense
GER-Bundesliga,2022,Schalke 04,Danny Latza,GER,MF,32,1989,9.5,17,13,8,8,1,5,17,29.4,12,16,1,15,5,22,15,0,defense
GER-Bundesliga,2022,Schalke 04,Dominick Drexler,GER,"MF,FW",32,1990,15.2,25,17,12,10,3,9,22,40.9,13,18,2,16,8,33,12,0,defense
GER-Bundesliga,2022,Schalke 04,Florent Mollet,FRA,MF,30,1991,4.6,4,1,0,4,0,2,7,28.6,5,7,1,6,1,5,1,0,defense
GER-Bundesliga,2022,Schalke 04,Florian Flick,GER,MF,22,2000,5.7,12,3,7,5,0,4,14,28.6,10,9,3,6,4,16,18,0,defense
GER-Bundesliga,2022,Schalke 04,Henning Matriciani,GER,DF,22,2000,20.7,43,23,28,12,3,26,60,43.3,34,28,11,17,23,66,57,1,defense
GER-Bundesliga,2022,Schalke 04,Jere Uronen,FIN,DF,28,1994,7.5,14,10,6,6,2,6,10,60.0,4,5,2,3,8,22,13,0,defense
GER-Bundesliga,2022,Schalke 04,Jordan Larsson,SWE,"FW,MF",25,1997,5.1,8,5,1,7,0,2,9,22.2,7,9,0,9,4,12,3,0,defense
GER-Bundesliga,2022,Schalke 04,Keke Maximilian Topp,GER,FW,18,2004,0.2,0,0,0,0,0,0,0,,0,0,0,0,1,1,0,0,defense
GER-Bundesliga,2022,Schalke 04,Kenan Karaman,TUR,FW,28,1994,10.8,11,8,3,5,3,3,12,25.0,9,9,1,8,3,14,9,0,defense
GER-Bundesliga,2022,Schalke 04,Kerim Calhanoglu,GER,DF,19,2002,0.7,2,1,2,0,0,2,2,100.0,0,1,0,1,0,2,3,0,defense
GER-Bundesliga,2022,Schalke 04,Leo Greiml,AUT,DF,21,2001,4.0,10,5,4,5,1,5,12,41.7,7,7,3,4,3,13,16,0,defense
GER-Bundesliga,2022,Schalke 04,Malick Thiaw,GER,DF,20,2001,3.0,3,1,2,1,0,1,2,50.0,1,4,3,1,9,12,24,1,defense
GER-Bundesliga,2022,Schalke 04,Marcin Kamiński,POL,DF,30,1992,7.0,6,4,4,0,2,2,4,50.0,2,8,7,1,9,15,28,0,defense
GER-Bundesliga,2022,Schalke 04,Marius Bülter,GER,"FW,MF",29,1993,28.9,22,11,8,7,7,12,32,37.5,20,34,1,33,10,32,20,0,defense
GER-Bundesliga,2022,Schalke 04,Maya Yoshida,JPN,DF,33,1988,28.4,34,22,19,13,2,18,29,62.1,11,40,29,11,46,80,132,2,defense
GER-Bundesliga,2022,Schalke 04,Mehmet Aydin,GER,"DF,FW",20,2002,6.3,25,18,14,9,2,11,24,45.8,13,11,0,11,10,35,15,0,defense
GER-Bundesliga,2022,Schalke 04,Michael Frey,SUI,FW,28,1994,9.6,13,5,2,8,3,4,13,30.8,9,6,0,6,2,15,1,0,defense
GER-Bundesliga,2022,Schalke 04,Moritz Jenz,GER,DF,23,1999,10.5,14,11,8,5,1,5,8,62.5,3,16,10,6,8,22,53,1,defense
GER-Bundesliga,2022,Schalke 04,Ralf Fährmann,GER,GK,33,1988,11.4,1,0,1,0,0,1,1,100.0,0,0,0,0,0,1,10,2,defense
GER-Bundesliga,2022,Schalke 04,Rodrigo Zalazar,URU,"MF,FW",22,1999,14.7,16,8,5,9,2,9,24,37.5,15,16,1,15,7,23,13,0,defense
GER-Bundesliga,2022,Schalke 04,Sebastian Polter,GER,FW,31,1991,7.0,4,3,0,4,0,1,4,25.0,3,4,0,4,1,5,6,0,defense
GER-Bundesliga,2022,Schalke 04,Sepp van den Berg,NED,DF,20,2001,7.7,5,4,2,2,1,1,4,25.0,3,8,5,3,13,18,33,2,defense
GER-Bundesliga,2022,Schalke 04,Sidi Sané,GER,FW,19,2003,0.3,1,1,1,0,0,1,1,100.0,0,0,0,0,0,1,0,0,defense
GER-Bundesliga,2022,Schalke 04,Simon Terodde,GER,FW,34,1988,20.3,15,8,4,7,4,3,14,21.4,11,6,2,4,6,21,9,0,defense
GER-Bundesliga,2022,Schalke 04,Soichiro Kozuki,JPN,"FW,MF",21,2000,4.2,6,4,3,3,0,4,6,66.7,2,5,0,5,3,9,3,0,defense
GER-Bundesliga,2022,Schalke 04,Thomas Ouwejan,NED,DF,25,1996,10.0,20,8,13,5,2,6,10,60.0,4,17,4,13,13,33,27,0,defense
GER-Bundesliga,2022,Schalke 04,Tim Skarke,GER,"FW,MF",25,1996,4.9,13,7,3,8,2,8,11,72.7,3,5,0,5,0,13,4,0,defense
GER-Bundesliga,2022,Schalke 04,Timothée Kolodziejczak,FRA,DF,30,1991,0.3,0,0,0,0,0,0,1,0.0,1,0,0,0,1,1,1,0,defense
GER-Bundesliga,2022,Schalke 04,Tobias Mohr,GER,"DF,MF",26,1995,9.3,8,5,3,5,0,2,7,28.6,5,14,5,9,8,16,19,0,defense
GER-Bundesliga,2022,Schalke 04,Tom Krauß,GER,MF,21,2001,27.9,112,68,39,62,11,51,100,51.0,49,39,6,33,36,148,35,0,defense
GER-Bundesliga,2022,Schalke 04,Éder Álvarez Balanta,COL,"MF,FW",29,1993,2.6,5,4,2,3,0,2,6,33.3,4,0,0,0,3,8,4,0,defense
GER-Bundesliga,2022,Stuttgart,Alou Kuol,AUS,FW,21,2000,0.1,0,0,0,0,0,0,0,,0,0,0,0,0,0,0,0,defense
GER-Bundesliga,2022,Stuttgart,Atakan Karazor,,MF,25,1996,21.8,49,30,18,25,6,24,47,51.1,23,39,11,28,31,80,44,0,defense
GER-Bundesliga,2022,Stuttgart,Borna Sosa,CRO,DF,24,1998,21.7,27,21,18,8,1,21,32,65.6,11,20,5,15,19,46,37,0,defense
GER-Bundesliga,2022,Stuttgart,Chris Führich,GER,"FW,MF",24,1998,20.9,36,14,15,14,7,24,44,54.5,20,29,2,27,7,43,13,0,defense
GER-Bundesliga,2022,Stuttgart,Clinton Mola,ENG,DF,21,2001,0.2,3,1,2,1,0,1,1,100.0,0,1,1,0,1,4,2,0,defense
GER-Bundesliga,2022,Stuttgart,Dan-Axel Zagadou,FRA,DF,23,1999,14.1,14,9,10,4,0,5,14,35.7,9,19,16,3,21,35,81,1,defense
GER-Bundesliga,2022,Stuttgart,Darko Churlinov,MKD,FW,22,2000,0.3,3,2,2,1,0,2,3,66.7,1,1,0,1,0,3,0,0,defense
GER-Bundesliga,2022,Stuttgart,Enzo Millot,FRA,MF,20,2002,9.9,23,16,9,10,4,12,19,63.2,7,20,3,17,12,35,7,0,defense
GER-Bundesliga,2022,Stuttgart,Fabian Bredlow,GER,GK,27,1995,15.0,1,1,1,0,0,1,1,100.0,0,0,0,0,0,1,4,2,defense
GER-Bundesliga,2022,Stuttgart,Florian Müller,GER,GK,24,1997,19.0,0,0,0,0,0,0,0,,0,0,0,0,0,0,7,4,defense
GER-Bundesliga,2022,Stuttgart,Genki Haraguchi,JPN,MF,31,1991,8.3,16,7,7,7,2,4,16,25.0,12,13,2,11,8,24,6,0,defense
GER-Bundesliga,2022,Stuttgart,Gil Bastião Dias,POR,FW,25,1996,4.4,8,6,3,4,1,3,12,25.0,9,7,0,7,2,10,3,0,defense
GER-Bundesliga,2022,Stuttgart,Hiroki Ito,JPN,DF,23,1999,28.5,40,29,24,14,2,18,35,51.4,17,38,17,21,40,80,94,0,defense
GER-Bundesliga,2022,Stuttgart,Josha Vagnoman,GER,DF,21,2000,16.4,26,15,12,11,3,15,27,55.6,12,20,2,18,8,34,29,1,defense
GER-Bundesliga,2022,Stuttgart,Juan Perea,COL,FW,22,2000,4.6,5,4,0,2,3,2,4,50.0,2,2,1,1,1,6,3,0,defense
GER-Bundesliga,2022,Stuttgart,Konstantinos Mavropanos,GRE,DF,24,1997,25.4,50,27,32,15,3,28,38,73.7,10,39,18,21,63,113,99,0,defense
GER-Bundesliga,2022,Stuttgart,Lauren Ulrich,GER,MF,17,2005,0.1,1,1,0,0,1,0,0,,0,0,0,0,0,1,0,0,defense
GER-Bundesliga,2022,Stuttgart,Lilian Egloff,GER,"MF,FW",19,2002,2.7,12,10,4,5,3,4,6,66.7,2,2,0,2,1,13,1,0,defense
GER-Bundesliga,2022,Stuttgart,Luca Pfeiffer,GER,FW,25,1996,7.8,1,1,1,0,0,0,1,0.0,1,4,0,4,1,2,5,0,defense
GER-Bundesliga,2022,Stuttgart,Naouirou Ahamada,FRA,MF,20,2002,15.5,17,11,7,7,3,8,20,40.0,12,16,5,11,8,25,7,0,defense
GER-Bundesliga,2022,Stuttgart,Nikolas Nartey,DEN,"DF,MF",22,2000,5.3,11,6,7,3,1,5,9,55.6,4,9,0,9,4,15,12,0,defense
GER-Bundesliga,2022,Stuttgart,Pascal Stenzel,GER,DF,26,1996,3.7,12,8,8,4,0,5,9,55.6,4,9,2,7,5,17,6,0,defense
GER-Bundesliga,2022,Stuttgart,Sasa Kalajdzic,AUT,FW,25,1997,2.6,3,2,0,1,2,1,3,33.3,2,1,0,1,0,3,0,0,defense
GER-Bundesliga,2022,Stuttgart,Serhou Guirassy,GUI,FW,26,1996,18.3,4,1,2,2,0,1,2,50.0,1,7,2,5,0,4,14,0,defense
GER-Bundesliga,2022,Stuttgart,Silas Katompa,COD,"FW,MF",23,1998,22.1,25,17,5,14,6,6,20,30.0,14,17,2,15,8,33,1,0,defense
GER-Bundesliga,2022,Stuttgart,Tanguy Coulibaly,FRA,"FW,DF",21,2001,3.6,12,9,9,1,2,5,12,41.7,7,10,0,10,3,15,0,0,defense
GER-Bundesliga,2022,Stuttgart,Thomas Kastanaras,GRE,"FW,DF",19,2003,0.8,0,0,0,0,0,0,0,,0,1,0,1,0,0,0,0,defense
GER-Bundesliga,2022,Stuttgart,Tiago Tomás,POR,"FW,MF",20,2002,14.3,10,4,2,4,4,8,13,61.5,5,9,2,7,1,11,5,0,defense
GER-Bundesliga,2022,Stuttgart,Waldemar Anton,GER,DF,26,1996,32.6,49,27,27,19,3,27,51,52.9,24,44,16,28,38,87,123,2,defense
GER-Bundesliga,2022,Stuttgart,Wataru Endo,JPN,MF,29,1993,32.5,70,37,30,31,9,38,85,44.7,47,44,6,38,26,96,63,0,defense
GER-Bundesliga,2022,Union Berlin,András Schäfer,HUN,MF,23,1999,9.6,21,9,7,12,2,6,14,42.9,8,12,2,10,4,25,11,0,defense
GER-Bundesliga,2022,Union Berlin,Aïssa Laïdouni,TUN,MF,25,1996,9.7,14,7,6,8,0,5,17,29.4,12,22,4,18,9,23,3,0,defense
GER-Bundesliga,2022,Union Berlin,Christopher Trimmel,AUT,DF,35,1987,20.1,31,16,16,12,3,20,31,64.5,11,14,1,13,25,56,48,0,defense
GER-Bundesliga,2022,Union Berlin,Danilho Doekhi,NED,DF,24,1998,24.6,38,23,21,17,0,14,26,53.8,12,27,12,15,29,67,93,0,defense
GER-Bundesliga,2022,Union Berlin,Diogo Leite,POR,DF,23,1999,25.0,35,20,21,14,0,21,34,61.8,13,23,14,9,26,61,99,1,defense
GER-Bundesliga,2022,Union Berlin,Frederik Rønnow,DEN,GK,29,1992,29.0,0,0,0,0,0,0,5,0.0,5,0,0,0,0,0,9,1,defense
GER-Bundesliga,2022,Union Berlin,Genki Haraguchi,JPN,MF,31,1991,5.5,12,8,1,10,1,3,9,33.3,6,7,1,6,3,15,9,0,defense
GER-Bundesliga,2022,Union Berlin,Jamie Leweling,GER,"FW,MF",21,2001,2.9,5,3,2,2,1,3,5,60.0,2,3,0,3,1,6,0,0,defense
GER-Bundesliga,2022,Union Berlin,Janik Haberer,GER,MF,28,1994,24.3,29,17,8,18,3,17,48,35.4,31,35,2,33,14,43,25,0,defense
GER-Bundesliga,2022,Union Berlin,Jordan Pefok,USA,FW,26,1996,15.1,15,7,3,4,8,2,17,11.8,15,17,5,12,4,19,15,0,defense
GER-Bundesliga,2022,Union Berlin,Josip Juranović,CRO,DF,26,1995,10.4,9,7,5,2,2,7,18,38.9,11,9,3,6,6,15,22,1,defense
GER-Bundesliga,2022,Union Berlin,Julian Ryerson,NOR,DF,24,1997,11.5,28,17,17,10,1,15,25,60.0,10,15,3,12,12,40,19,0,defense
GER-Bundesliga,2022,Union Berlin,Jérôme Roussillon,FRA,DF,29,1993,10.6,16,9,6,8,2,8,12,66.7,4,7,2,5,4,20,22,0,defense
GER-Bundesliga,2022,Union Berlin,Kevin Behrens,GER,FW,31,1991,17.1,11,7,4,4,3,4,18,22.2,14,18,3,15,5,16,25,0,defense
GER-Bundesliga,2022,Union Berlin,Lennart Grill,GER,GK,23,1999,5.0,0,0,0,0,0,0,1,0.0,1,0,0,0,0,0,1,1,defense
GER-Bundesliga,2022,Union Berlin,Levin Öztunalı,GER,MF,26,1996,0.1,0,0,0,0,0,0,1,0.0,1,0,0,0,0,0,0,0,defense
GER-Bundesliga,2022,Union Berlin,Miloš Pantović,SRB,MF,26,1996,2.3,4,2,4,0,0,3,5,60.0,2,3,0,3,0,4,5,0,defense
GER-Bundesliga,2022,Union Berlin,Morten Thorsby,NOR,MF,26,1996,9.3,22,10,9,11,2,13,21,61.9,8,11,5,6,3,25,20,0,defense
GER-Bundesliga,2022,Union Berlin,Niko Gießelmann,GER,DF,30,1991,14.5,21,11,9,9,3,13,31,41.9,18,17,5,12,9,30,28,0,defense
GER-Bundesliga,2022,Union Berlin,Paul Jaeckel,GER,DF,24,1998,13.3,24,18,11,11,2,17,35,48.6,18,11,5,6,19,43,44,1,defense
GER-Bundesliga,2022,Union Berlin,Paul Seguin,GER,MF,27,1995,7.7,17,8,9,4,4,8,18,44.4,10,6,0,6,6,23,7,0,defense
GER-Bundesliga,2022,Union Berlin,Rani Khedira,GER,MF,28,1994,32.0,60,33,21,32,7,25,50,50.0,25,33,10,23,40,100,33,0,defense
GER-Bundesliga,2022,Union Berlin,Robin Knoche,GER,DF,30,1992,31.9,45,29,29,12,4,24,47,51.1,23,35,18,17,38,83,140,0,defense
GER-Bundesliga,2022,Union Berlin,Sheraldo Becker,SUR,FW,27,1995,28.4,15,5,1,7,7,2,11,18.2,9,13,1,12,3,18,7,1,defense
GER-Bundesliga,2022,Union Berlin,Sven Michel,GER,"FW,MF",32,1990,5.5,9,5,1,5,3,4,8,50.0,4,5,1,4,0,9,4,0,defense
GER-Bundesliga,2022,Union Berlin,Tim Skarke,GER,"DF,MF",25,1996,0.6,1,1,0,0,1,0,0,,0,1,0,1,0,1,0,0,defense
GER-Bundesliga,2022,Union Berlin,Timo Baumgartl,GER,DF,26,1996,6.2,11,6,5,4,2,5,18,27.8,13,12,4,8,2,13,14,0,defense
GER-Bundesliga,2022,Union Berlin,Tymoteusz Puchacz,POL,DF,23,1999,0.6,1,0,1,0,0,0,0,,0,0,0,0,0,1,1,0,defense
GER-Bundesliga,2022,Werder Bremen,Amos Pieper,GER,DF,24,1998,21.7,46,28,25,19,2,24,40,60.0,16,23,11,12,30,76,94,1,defense
GER-Bundesliga,2022,Werder Bremen,Anthony Jung,GER,"DF,FW",30,1991,29.1,46,27,19,20,7,31,58,53.4,27,30,6,24,22,68,63,0,defense
GER-Bundesliga,2022,Werder Bremen,Christian Groß,GER,MF,33,1989,21.0,56,25,20,34,2,29,60,48.3,31,20,5,15,23,79,38,1,defense
GER-Bundesliga,2022,Werder Bremen,Dikeni-Rafid Salifou,TOG,MF,19,2003,0.0,0,0,0,0,0,0,0,,0,0,0,0,0,0,0,0,defense
GER-Bundesliga,2022,Werder Bremen,Eren Dinkçi,GER,"FW,MF",20,2001,2.6,5,5,2,1,2,2,6,33.3,4,2,0,2,0,5,2,0,defense
GER-Bundesliga,2022,Werder Bremen,Fabio Chiarodia,ITA,DF,17,2005,0.7,0,0,0,0,0,0,0,,0,1,0,1,2,2,4,0,defense
GER-Bundesliga,2022,Werder Bremen,Felix Agu,GER,"DF,FW",22,1999,0.5,1,0,0,1,0,0,0,,0,1,1,0,0,1,0,0,defense
GER-Bundesliga,2022,Werder Bremen,Ilia Gruev,BUL,MF,22,2000,17.6,44,27,16,25,3,18,31,58.1,13,23,6,17,22,66,21,1,defense
GER-Bundesliga,2022,Werder Bremen,Jean-Manuel Mbom,GER,MF,22,2000,0.1,0,0,0,0,0,0,1,0.0,1,0,0,0,0,0,0,0,defense
GER-Bundesliga,2022,Werder Bremen,Jens Stage,DEN,MF,25,1996,20.6,34,17,15,18,1,10,37,27.0,27,34,11,23,16,50,37,0,defense
GER-Bundesliga,2022,Werder Bremen,Jiří Pavlenka,CZE,GK,30,1992,32.3,1,0,1,0,0,1,5,20.0,4,1,0,1,3,4,21,1,defense
GER-Bundesliga,2022,Werder Bremen,Lee Buchanan,ENG,"DF,FW",21,2001,5.2,14,10,2,11,1,6,12,50.0,6,5,0,5,12,26,21,0,defense
GER-Bundesliga,2022,Werder Bremen,Leonardo Bittencourt,GER,"MF,DF",28,1993,18.1,53,28,20,25,8,25,62,40.3,37,13,0,13,10,63,15,0,defense
GER-Bundesliga,2022,Werder Bremen,Marco Friedl,AUT,DF,24,1998,28.8,62,46,40,22,0,41,68,60.3,27,46,17,29,58,120,127,1,defense
GER-Bundesliga,2022,Werder Bremen,Marvin Ducksch,GER,FW,28,1994,31.7,8,3,2,4,2,3,16,18.8,13,13,2,11,9,17,41,1,defense
GER-Bundesliga,2022,Werder Bremen,Maximilian Philipp,GER,"FW,MF",28,1994,4.9,6,5,3,2,1,1,9,11.1,8,7,1,6,3,9,4,0,defense
GER-Bundesliga,2022,Werder Bremen,Michael Zetterer,GER,GK,27,1995,1.7,0,0,0,0,0,0,0,,0,0,0,0,0,0,1,0,defense
GER-Bundesliga,2022,Werder Bremen,Miloš Veljković,SRB,DF,26,1995,25.2,30,19,17,13,0,18,29,62.1,11,32,16,16,33,63,103,0,defense
GER-Bundesliga,2022,Werder Bremen,Mitchell Weiser,GER,"DF,FW",28,1994,28.0,71,43,38,24,9,38,75,50.7,37,50,7,43,28,99,38,1,defense
GER-Bundesliga,2022,Werder Bremen,Niclas Füllkrug,GER,FW,29,1993,27.5,9,4,0,6,3,3,13,23.1,10,13,4,9,1,10,24,0,defense
GER-Bundesliga,2022,Werder Bremen,Nicolai Rapp,GER,"MF,DF",25,1996,0.8,3,1,3,0,0,0,3,0.0,3,0,0,0,0,3,1,0,defense
GER-Bundesliga,2022,Werder Bremen,Niklas Schmidt,GER,MF,24,1998,12.1,25,10,12,11,2,13,28,46.4,15,10,0,10,5,30,12,0,defense
GER-Bundesliga,2022,Werder Bremen,Niklas Stark,GER,DF,27,1995,23.1,56,36,29,24,3,27,42,64.3,15,24,13,11,37,93,110,0,defense
GER-Bundesliga,2022,Werder Bremen,Oliver Burke,SCO,"FW,MF",25,1997,3.0,1,0,0,0,1,0,0,,0,2,0,2,0,1,0,0,defense
GER-Bundesliga,2022,Werder Bremen,Romano Schmid,AUT,"MF,FW",22,2000,16.9,24,15,5,13,6,10,22,45.5,12,21,3,18,7,31,12,0,defense
GER-Bundesliga,2022,Wolfsburg,Aster Vranckx,BEL,MF,19,2002,0.1,0,0,0,0,0,0,0,,0,0,0,0,0,0,1,0,defense
GER-Bundesliga,2022,Wolfsburg,Bartol Franjić,CRO,MF,22,2000,2.5,4,2,2,2,0,0,2,0.0,2,4,1,3,5,9,4,0,defense
GER-Bundesliga,2022,Wolfsburg,Dženan Pejčinović,GER,FW,17,2005,0.1,0,0,0,0,0,0,0,,0,0,0,0,0,0,0,0,defense
GER-Bundesliga,2022,Wolfsburg,Felix Nmecha,GER,MF,21,2000,20.4,41,24,11,23,7,16,34,47.1,18,26,10,16,25,66,31,0,defense
GER-Bundesliga,2022,Wolfsburg,Jakub Kamiński,POL,"FW,DF",20,2002,22.9,36,25,15,13,8,20,40,50.0,20,37,2,35,8,44,15,0,defense
GER-Bundesliga,2022,Wolfsburg,Jonas Wind,DEN,FW,23,1999,14.3,14,6,2,7,5,5,10,50.0,5,14,4,10,1,15,10,0,defense
GER-Bundesliga,2022,Wolfsburg,Josip Brekalo,CRO,"MF,FW",24,1998,3.0,2,1,2,0,0,0,4,0.0,4,0,0,0,2,4,2,0,defense
GER-Bundesliga,2022,Wolfsburg,Josuha Guilavogui,FRA,"DF,MF",31,1990,13.1,18,11,7,10,1,6,17,35.3,11,19,13,6,23,41,52,0,defense
GER-Bundesliga,2022,Wolfsburg,Jérôme Roussillon,FRA,"MF,DF",29,1993,0.2,0,0,0,0,0,0,0,,0,0,0,0,0,0,0,0,defense
GER-Bundesliga,2022,Wolfsburg,Kevin Paredes,USA,"FW,MF",19,2003,5.9,13,9,6,3,4,9,12,75.0,3,7,0,7,6,19,8,0,defense
GER-Bundesliga,2022,Wolfsburg,Kilian Fischer,GER,"DF,FW",21,2000,5.6,9,6,3,4,2,6,11,54.5,5,6,0,6,5,14,18,0,defense
GER-Bundesliga,2022,Wolfsburg,Koen Casteels,BEL,GK,30,1992,34.0,0,0,0,0,0,0,0,,0,0,0,0,1,1,10,1,defense
GER-Bundesliga,2022,Wolfsburg,Luca Waldschmidt,GER,"FW,MF",26,1996,5.8,5,2,2,1,2,2,10,20.0,8,6,0,6,3,8,5,0,defense
GER-Bundesliga,2022,Wolfsburg,Lukas Nmecha,GER,FW,23,1998,10.0,5,3,0,2,3,3,3,100.0,0,5,1,4,3,8,4,0,defense
GER-Bundesliga,2022,Wolfsburg,Lukáš Ambros,CZE,MF,18,2004,0.2,1,0,1,0,0,1,4,25.0,3,1,0,1,0,1,2,1,defense
GER-Bundesliga,2022,Wolfsburg,Mattias Svanberg,SWE,"MF,FW",23,1999,20.4,25,16,8,16,1,10,30,33.3,20,27,5,22,21,46,25,1,defense
GER-Bundesliga,2022,Wolfsburg,Max Kruse,GER,"MF,FW",34,1988,3.0,1,1,0,1,0,0,1,0.0,1,2,1,1,0,1,1,0,defense
GER-Bundesliga,2022,Wolfsburg,Maxence Lacroix,FRA,DF,22,2000,18.1,22,13,15,7,0,8,16,50.0,8,22,11,11,26,48,85,0,defense
GER-Bundesliga,2022,Wolfsburg,Maximilian Arnold,GER,MF,28,1994,30.7,62,31,25,28,9,28,54,51.9,26,34,11,23,26,88,65,2,defense
GER-Bundesliga,2022,Wolfsburg,Maximilian Philipp,GER,FW,28,1994,1.3,2,1,1,1,0,1,1,100.0,0,1,0,1,0,2,0,0,defense
GER-Bundesliga,2022,Wolfsburg,Micky van de Ven,NED,DF,21,2001,33.0,45,30,26,18,1,28,39,71.8,11,42,24,18,26,71,108,2,defense
GER-Bundesliga,2022,Wolfsburg,Nicolas Cozza,FRA,DF,23,1999,1.1,3,3,1,2,0,2,3,66.7,1,3,1,2,0,3,0,0,defense
GER-Bundesliga,2022,Wolfsburg,Omar Marmoush,EGY,FW,23,1999,16.4,16,10,8,2,6,4,16,25.0,12,21,1,20,7,23,4,0,defense
GER-Bundesliga,2022,Wolfsburg,Patrick Wimmer,AUT,"FW,MF",21,2001,18.3,39,26,18,11,10,12,38,31.6,26,27,2,25,15,54,15,0,defense
GER-Bundesliga,2022,Wolfsburg,Paulo Otávio,BRA,DF,27,1994,22.7,72,46,46,17,9,44,66,66.7,22,42,6,36,30,102,70,1,defense
GER-Bundesliga,2022,Wolfsburg,Ridle Baku,GER,"DF,FW",24,1998,28.7,50,26,29,17,4,32,58,55.2,26,44,6,38,21,71,59,0,defense
GER-Bundesliga,2022,Wolfsburg,Sebastiaan Bornauw,BEL,DF,23,1999,21.4,29,17,17,10,2,16,22,72.7,6,27,12,15,31,60,83,1,defense
GER-Bundesliga,2022,Wolfsburg,Yannick Gerhardt,GER,MF,28,1994,20.7,29,15,10,11,8,12,30,40.0,18,26,5,21,7,36,24,0,defense
