league,season,team,player,nation,pos,age,born,90s,Tackles Tkl,Tackles TklW,Tackles Def 3rd,Tackles Mid 3rd,Tackles Att 3rd,Challenges Tkl,Challenges Att,Challenges Tkl%,Challenges Lost,Blocks Blocks,Blocks Sh,Blocks Pass,Int,Tkl+Int,Clr,Err,stat_type
ENG-Premier League,2023,Arsenal,Ben White,ENG,DF,25,1997,33.2,48,28,20,22,6,26,58,44.8,32,48,22,26,32,80,77,1,defense
ENG-Premier League,2023,Arsenal,Bukayo Saka,ENG,FW,21,2001,32.4,66,35,22,24,20,26,59,44.1,33,43,2,41,15,81,24,1,defense
ENG-Premier League,2023,Arsenal,Cédric Soares,POR,DF,31,1991,0.7,0,0,0,0,0,0,0,,0,0,0,0,0,0,0,0,defense
ENG-Premier League,2023,Arsenal,David Raya,ESP,GK,27,1995,32.0,1,1,1,0,0,1,1,100.0,0,0,0,0,0,1,8,5,defense
ENG-Premier League,2023,Arsenal,Declan Rice,ENG,MF,24,1999,35.8,83,51,37,38,8,32,57,56.1,25,37,11,26,44,127,52,0,defense
ENG-Premier League,2023,Arsenal,Eddie Nketiah,ENG,FW,24,1999,12.0,12,7,2,6,4,2,7,28.6,5,11,0,11,4,16,4,0,defense
ENG-Premier League,2023,Arsenal,Emile Smith Rowe,ENG,MF,23,2000,3.9,4,1,2,2,0,2,4,50.0,2,3,1,2,3,7,1,0,defense
ENG-Premier League,2023,Arsenal,Ethan Nwaneri,ENG,FW,16,2007,0.2,0,0,0,0,0,0,0,,0,1,0,1,0,0,0,0,defense
ENG-Premier League,2023,Arsenal,Fabio Vieira,POR,"MF,FW",23,2000,3.3,3,2,2,0,1,3,3,100.0,0,0,0,0,2,5,2,0,defense
ENG-Premier League,2023,Arsenal,Gabriel Jesus,BRA,FW,26,1997,16.4,24,17,11,5,8,5,18,27.8,13,23,1,22,13,37,12,0,defense
ENG-Premier League,2023,Arsenal,Gabriel Magalhães,BRA,DF,25,1997,33.8,48,28,24,22,2,17,22,77.3,5,44,33,11,31,79,100,1,defense
ENG-Premier League,2023,Arsenal,Gabriel Martinelli,BRA,FW,22,2001,22.4,30,24,9,12,9,13,32,40.6,19,23,1,22,5,35,9,1,defense
ENG-Premier League,2023,Arsenal,Jakub Kiwior,POL,DF,23,2000,10.5,20,12,11,8,1,14,19,73.7,5,11,3,8,8,28,28,1,defense
ENG-Premier League,2023,Arsenal,Jorginho,ITA,MF,31,1991,10.2,24,10,6,10,8,11,23,47.8,12,17,1,16,12,36,7,1,defense
ENG-Premier League,2023,Arsenal,Jurriën Timber,NED,DF,22,2001,0.8,2,2,1,1,0,0,0,,0,1,0,1,0,2,1,0,defense
ENG-Premier League,2023,Arsenal,Kai Havertz,GER,"MF,FW",24,1999,29.3,35,15,7,21,7,14,39,35.9,25,26,1,25,20,55,22,0,defense
ENG-Premier League,2023,Arsenal,Leandro Trossard,BEL,"FW,MF",28,1994,18.3,27,16,8,9,10,9,25,36.0,16,27,1,26,8,35,6,0,defense
ENG-Premier League,2023,Arsenal,Martin Ødegaard,NOR,MF,24,1998,34.3,49,17,18,21,10,17,58,29.3,41,23,1,22,15,64,5,0,defense
ENG-Premier League,2023,Arsenal,Mohamed Elneny,EGY,MF,31,1992,0.3,0,0,0,0,0,0,1,0.0,1,0,0,0,1,1,0,0,defense
ENG-Premier League,2023,Arsenal,Oleksandr Zinchenko,UKR,DF,26,1996,19.1,50,30,19,24,7,35,52,67.3,17,18,3,15,20,70,26,2,defense
ENG-Premier League,2023,Arsenal,Reiss Nelson,ENG,FW,23,1999,3.0,9,6,5,1,3,8,10,80.0,2,5,1,4,1,10,5,0,defense
ENG-Premier League,2023,Arsenal,Takehiro Tomiyasu,JPN,DF,24,1998,12.8,20,9,15,4,1,11,18,61.1,7,10,4,6,18,38,33,0,defense
ENG-Premier League,2023,Arsenal,Thomas Partey,GHA,"MF,DF",30,1993,8.8,14,11,9,4,1,5,10,50.0,5,9,3,6,11,25,9,0,defense
ENG-Premier League,2023,Arsenal,William Saliba,FRA,DF,22,2001,38.0,41,26,28,12,1,20,27,74.1,7,32,17,15,29,70,81,3,defense
ENG-Premier League,2023,Aston Villa,Bertrand Traoré,BFA,"DF,FW",27,1995,0.1,1,1,1,0,0,0,0,,0,0,0,0,0,1,1,0,defense
ENG-Premier League,2023,Aston Villa,Boubacar Kamara,FRA,MF,23,1999,18.4,43,29,16,21,6,24,47,51.1,23,21,7,14,21,64,16,0,defense
ENG-Premier League,2023,Aston Villa,Calum Chambers,ENG,"MF,DF",28,1995,1.7,3,0,3,0,0,0,1,0.0,1,2,1,1,2,5,4,0,defense
ENG-Premier League,2023,Aston Villa,Cameron Archer,ENG,MF,22,2001,0.1,0,0,0,0,0,0,0,,0,0,0,0,0,0,0,0,defense
ENG-Premier League,2023,Aston Villa,Clément Lenglet,FRA,DF,28,1995,12.8,13,9,7,5,1,7,13,53.8,6,19,11,8,7,20,47,1,defense
ENG-Premier League,2023,Aston Villa,Diego Carlos,BRA,DF,30,1993,20.2,27,16,22,4,1,13,21,61.9,8,24,19,5,13,40,78,3,defense
ENG-Premier League,2023,Aston Villa,Douglas Luiz,BRA,MF,25,1998,33.3,58,38,21,27,10,25,53,47.2,28,32,8,24,23,81,18,2,defense
ENG-Premier League,2023,Aston Villa,Emiliano Martínez,ARG,GK,30,1992,33.5,0,0,0,0,0,0,0,,0,0,0,0,0,0,12,3,defense
ENG-Premier League,2023,Aston Villa,Ezri Konsa,ENG,DF,25,1997,34.1,54,32,28,23,3,23,27,85.2,4,36,20,16,28,82,73,3,defense
ENG-Premier League,2023,Aston Villa,Finley Munroe,ENG,MF,18,2005,0.0,0,0,0,0,0,0,0,,0,0,0,0,0,0,0,0,defense
ENG-Premier League,2023,Aston Villa,Jacob Ramsey,ENG,"FW,MF",22,2001,9.5,16,8,7,6,3,5,15,33.3,10,15,2,13,3,19,8,0,defense
ENG-Premier League,2023,Aston Villa,Jaden Philogene Bidace,ENG,FW,21,2002,0.0,0,0,0,0,0,0,0,,0,0,0,0,0,0,0,0,defense
ENG-Premier League,2023,Aston Villa,John McGinn,SCO,"MF,FW",28,1994,33.3,59,35,18,34,7,32,77,41.6,45,33,4,29,21,80,21,0,defense
ENG-Premier League,2023,Aston Villa,Jáder Durán,COL,"FW,MF",19,2003,5.3,6,5,3,1,2,1,6,16.7,5,6,0,6,1,7,10,0,defense
ENG-Premier League,2023,Aston Villa,Kaine Kesler-Hayden,ENG,"MF,DF",20,2002,0.1,0,0,0,0,0,0,0,,0,0,0,0,0,0,0,0,defense
ENG-Premier League,2023,Aston Villa,Leander Dendoncker,BEL,MF,28,1995,1.3,6,4,3,2,1,4,5,80.0,1,5,2,3,2,8,3,1,defense
ENG-Premier League,2023,Aston Villa,Leon Bailey,JAM,"MF,FW",25,1997,23.0,13,7,7,4,2,5,20,25.0,15,18,1,17,9,22,6,0,defense
ENG-Premier League,2023,Aston Villa,Lucas Digne,FRA,DF,30,1993,26.8,47,19,35,9,3,25,44,56.8,19,20,2,18,26,73,67,0,defense
ENG-Premier League,2023,Aston Villa,Matty Cash,POL,DF,25,1997,23.8,54,31,24,24,6,29,59,49.2,30,35,14,21,18,72,59,0,defense
ENG-Premier League,2023,Aston Villa,Morgan Rogers,ENG,"MF,FW",21,2002,7.1,8,1,3,2,3,2,11,18.2,9,11,0,11,3,11,11,0,defense
ENG-Premier League,2023,Aston Villa,Moussa Diaby,FRA,"FW,MF",24,1999,24.2,12,5,5,4,3,4,22,18.2,18,8,1,7,9,21,6,0,defense
ENG-Premier League,2023,Aston Villa,Nicolò Zaniolo,ITA,"FW,MF",24,1999,9.3,19,9,10,7,2,9,17,52.9,8,13,0,13,1,20,11,0,defense
ENG-Premier League,2023,Aston Villa,Ollie Watkins,ENG,FW,27,1995,35.7,12,7,0,5,7,5,11,45.5,6,26,4,22,4,16,20,0,defense
ENG-Premier League,2023,Aston Villa,Omari Kellyman,ENG,FW,17,2005,0.4,1,0,0,1,0,1,2,50.0,1,0,0,0,0,1,0,0,defense
ENG-Premier League,2023,Aston Villa,Pau Torres,ESP,DF,26,1997,27.4,29,18,17,11,1,14,30,46.7,16,28,12,16,14,43,75,0,defense
ENG-Premier League,2023,Aston Villa,Philippe Coutinho,BRA,"MF,FW",31,1992,0.3,0,0,0,0,0,0,1,0.0,1,0,0,0,0,0,0,0,defense
ENG-Premier League,2023,Aston Villa,Robin Olsen,SWE,GK,33,1990,4.5,0,0,0,0,0,0,0,,0,0,0,0,0,0,1,0,defense
ENG-Premier League,2023,Aston Villa,Tim Iroegbunam,ENG,MF,20,2003,1.8,7,5,4,2,1,4,9,44.4,5,3,0,3,2,9,3,0,defense
ENG-Premier League,2023,Aston Villa,Tyrone Mings,ENG,DF,30,1993,0.3,0,0,0,0,0,0,0,,0,0,0,0,1,1,1,0,defense
ENG-Premier League,2023,Aston Villa,Youri Tielemans,BEL,"MF,FW",26,1997,18.0,41,20,17,18,6,16,40,40.0,24,23,3,20,15,56,9,0,defense
ENG-Premier League,2023,Aston Villa,Álex Moreno,ESP,DF,30,1993,11.5,18,12,18,0,0,12,19,63.2,7,11,2,9,13,31,37,0,defense
ENG-Premier League,2023,Bournemouth,Adam Smith,ENG,DF,32,1991,23.9,37,23,18,11,8,19,39,48.7,20,28,11,17,21,58,62,0,defense
ENG-Premier League,2023,Bournemouth,Alex Scott,ENG,MF,19,2003,11.3,24,15,8,10,6,12,28,42.9,16,14,4,10,12,36,18,2,defense
ENG-Premier League,2023,Bournemouth,Antoine Semenyo,GHA,FW,23,2000,23.4,24,17,7,9,8,9,27,33.3,18,39,2,37,6,30,21,0,defense
ENG-Premier League,2023,Bournemouth,Chris Mepham,WAL,DF,25,1997,6.9,12,11,9,3,0,9,14,64.3,5,13,6,7,7,19,30,1,defense
ENG-Premier League,2023,Bournemouth,Dango Ouattara,BFA,"FW,DF",21,2002,13.7,45,27,22,11,12,19,34,55.9,15,18,3,15,22,67,35,0,defense
ENG-Premier League,2023,Bournemouth,David Brooks,WAL,"FW,MF",26,1997,3.1,5,4,2,1,2,2,4,50.0,2,3,0,3,2,7,2,0,defense
ENG-Premier League,2023,Bournemouth,Dominic Sadi,ENG,FW,19,2003,0.0,0,0,0,0,0,0,0,,0,0,0,0,0,0,0,0,defense
ENG-Premier League,2023,Bournemouth,Dominic Solanke,ENG,FW,25,1997,36.9,23,11,3,13,7,10,29,34.5,19,24,5,19,7,30,43,0,defense
ENG-Premier League,2023,Bournemouth,Enes Ünal,TUR,"FW,MF",26,1997,3.6,6,4,2,3,1,2,5,40.0,3,4,2,2,1,7,6,0,defense
ENG-Premier League,2023,Bournemouth,Hamed Junior Traorè,CIV,MF,23,2000,0.5,1,0,1,0,0,1,3,33.3,2,3,0,3,0,1,0,0,defense
ENG-Premier League,2023,Bournemouth,Illia Zabarnyi,UKR,DF,20,2002,37.0,59,32,29,29,1,23,50,46.0,27,53,34,19,33,92,143,4,defense
ENG-Premier League,2023,Bournemouth,Ionuț Radu,ROU,GK,26,1997,2.0,0,0,0,0,0,0,0,,0,0,0,0,0,0,0,0,defense
ENG-Premier League,2023,Bournemouth,Jaidon Anthony,ENG,FW,23,1999,1.7,3,1,1,0,2,1,7,14.3,6,3,0,3,1,4,3,0,defense
ENG-Premier League,2023,Bournemouth,James Hill,ENG,DF,21,2002,0.8,3,2,1,2,0,1,1,100.0,0,3,2,1,3,6,8,0,defense
ENG-Premier League,2023,Bournemouth,Joe Rothwell,ENG,MF,28,1995,4.3,7,2,4,2,1,2,8,25.0,6,4,2,2,3,10,2,0,defense
ENG-Premier League,2023,Bournemouth,Justin Kluivert,NED,"MF,FW",24,1999,21.3,28,14,5,12,11,8,30,26.7,22,16,1,15,8,36,11,0,defense
ENG-Premier League,2023,Bournemouth,Kieffer Moore,WAL,"FW,MF",30,1992,1.2,0,0,0,0,0,0,0,,0,0,0,0,0,0,0,0,defense
ENG-Premier League,2023,Bournemouth,Lewis Cook,ENG,MF,26,1997,31.0,61,41,24,30,7,34,63,54.0,29,32,11,21,65,126,46,1,defense
ENG-Premier League,2023,Bournemouth,Lloyd Kelly,ENG,DF,24,1998,17.3,24,19,10,9,5,14,25,56.0,11,22,12,10,13,37,67,0,defense
ENG-Premier League,2023,Bournemouth,Luis Sinisterra,COL,"FW,MF",24,1999,7.8,23,12,9,10,4,9,16,56.3,7,18,0,18,8,31,4,0,defense
ENG-Premier League,2023,Bournemouth,Marcos Senesi,ARG,DF,26,1997,24.9,55,32,28,23,4,24,56,42.9,32,50,23,27,35,90,109,1,defense
ENG-Premier League,2023,Bournemouth,Marcus Tavernier,ENG,FW,24,1999,23.5,53,34,25,22,6,26,48,54.2,22,31,3,28,5,58,23,0,defense
ENG-Premier League,2023,Bournemouth,Mark Travers,IRL,GK,24,1999,4.0,0,0,0,0,0,0,0,,0,0,0,0,0,0,2,0,defense
ENG-Premier League,2023,Bournemouth,Max Aarons,ENG,DF,23,2000,13.7,29,19,20,7,2,20,34,58.8,14,9,5,4,8,37,27,0,defense
ENG-Premier League,2023,Bournemouth,Milos Kerkez,HUN,DF,19,2003,21.9,47,26,31,13,3,30,42,71.4,12,31,11,20,20,67,60,2,defense
ENG-Premier League,2023,Bournemouth,Neto,BRA,GK,34,1989,32.0,0,0,0,0,0,0,0,,0,1,0,1,1,1,12,3,defense
ENG-Premier League,2023,Bournemouth,Philip Billing,DEN,MF,27,1996,15.5,33,16,7,22,4,9,27,33.3,18,31,5,26,20,53,28,1,defense
ENG-Premier League,2023,Bournemouth,Romain Faivre,FRA,"MF,FW",25,1998,0.5,1,1,0,1,0,0,3,0.0,3,0,0,0,0,1,0,0,defense
ENG-Premier League,2023,Bournemouth,Ryan Christie,SCO,MF,28,1995,32.3,86,44,34,35,17,39,92,42.4,53,52,11,41,52,138,53,1,defense
ENG-Premier League,2023,Bournemouth,Tyler Adams,USA,MF,24,1999,1.3,4,3,1,3,0,2,3,66.7,1,2,0,2,4,8,2,0,defense
ENG-Premier League,2023,Brentford,Aaron Hickey,SCO,DF,21,2002,7.9,16,9,9,3,4,7,7,100.0,0,7,3,4,3,19,10,0,defense
ENG-Premier League,2023,Brentford,Ben Mee,ENG,DF,33,1989,14.1,26,15,12,12,2,17,22,77.3,5,21,13,8,13,39,63,1,defense
ENG-Premier League,2023,Brentford,Bryan Mbeumo,CMR,FW,23,1999,21.8,15,10,6,6,3,5,19,26.3,14,26,2,24,7,22,13,0,defense
ENG-Premier League,2023,Brentford,Christian Nørgaard,DEN,MF,29,1994,27.8,81,50,42,31,8,32,87,36.8,55,48,6,42,54,135,50,0,defense
ENG-Premier League,2023,Brentford,Ethan Pinnock,JAM,DF,30,1993,28.0,35,23,22,13,0,9,20,45.0,11,40,24,16,43,78,170,3,defense
ENG-Premier League,2023,Brentford,Frank Onyeka,NGA,MF,25,1998,12.9,37,24,9,23,5,16,29,55.2,13,15,7,8,23,60,17,0,defense
ENG-Premier League,2023,Brentford,Ivan Toney,ENG,FW,27,1996,16.1,15,5,2,7,6,6,14,42.9,8,5,1,4,10,25,18,0,defense
ENG-Premier League,2023,Brentford,Josh Dasilva,ENG,"DF,FW",24,1998,0.3,2,1,0,1,1,0,0,,0,0,0,0,0,2,0,0,defense
ENG-Premier League,2023,Brentford,Keane Lewis-Potter,ENG,"FW,DF",22,2001,16.0,17,7,5,11,1,7,15,46.7,8,10,2,8,7,24,23,0,defense
ENG-Premier League,2023,Brentford,Kevin Schade,GER,"FW,MF",21,2001,3.7,3,1,1,2,0,0,5,0.0,5,2,0,2,1,4,4,0,defense
ENG-Premier League,2023,Brentford,Kristoffer Ajer,NOR,DF,25,1998,20.4,38,21,25,9,4,23,36,63.9,13,26,11,15,25,63,79,1,defense
ENG-Premier League,2023,Brentford,Mads Roerslev,DEN,DF,24,1999,22.1,48,31,34,9,5,27,54,50.0,27,15,3,12,19,67,71,0,defense
ENG-Premier League,2023,Brentford,Mark Flekken,NED,GK,30,1993,36.5,1,1,1,0,0,1,5,20.0,4,1,0,1,0,1,17,1,defense
ENG-Premier League,2023,Brentford,Mathias Jensen,DEN,MF,27,1996,24.5,54,32,25,22,7,26,95,27.4,69,41,6,35,23,77,25,1,defense
ENG-Premier League,2023,Brentford,Mathias Jørgensen,DEN,DF,33,1990,12.1,17,12,15,1,1,11,19,57.9,8,9,5,4,12,29,40,0,defense
ENG-Premier League,2023,Brentford,Michael Olakigbe,ENG,"DF,FW",19,2004,0.7,3,0,2,1,0,2,4,50.0,2,7,0,7,1,4,0,1,defense
ENG-Premier League,2023,Brentford,Mikkel Damsgaard,DEN,MF,23,2000,9.4,29,17,13,9,7,14,40,35.0,26,23,1,22,11,40,10,1,defense
ENG-Premier League,2023,Brentford,Myles Peart-Harris,ENG,"DF,MF",20,2002,0.1,0,0,0,0,0,0,0,,0,0,0,0,0,0,1,0,defense
ENG-Premier League,2023,Brentford,Nathan Collins,IRL,DF,22,2001,29.5,38,20,24,12,2,19,29,65.5,10,46,30,16,44,82,141,4,defense
ENG-Premier League,2023,Brentford,Neal Maupay,FRA,FW,26,1996,14.7,10,7,4,5,1,3,13,23.1,10,11,0,11,2,12,3,0,defense
ENG-Premier League,2023,Brentford,Rico Henry,ENG,DF,26,1997,4.5,7,5,3,3,1,6,7,85.7,1,8,3,5,5,12,5,1,defense
ENG-Premier League,2023,Brentford,Saman Ghoddos,IRN,DF,29,1993,8.2,28,19,19,7,2,17,31,54.8,14,9,2,7,5,33,12,0,defense
ENG-Premier League,2023,Brentford,Sergio Reguilón,ESP,DF,26,1996,12.4,45,20,26,18,1,24,40,60.0,16,23,6,17,16,61,41,1,defense
ENG-Premier League,2023,Brentford,Shandon Baptiste,GRN,MF,25,1998,2.5,4,4,2,2,0,1,5,20.0,4,5,1,4,3,7,6,0,defense
ENG-Premier League,2023,Brentford,Thomas Strakosha,ALB,GK,28,1995,1.5,0,0,0,0,0,0,0,,0,0,0,0,0,0,0,0,defense
ENG-Premier League,2023,Brentford,Vitaly Janelt,GER,"MF,DF",25,1998,33.9,63,38,29,25,9,32,64,50.0,32,35,9,26,36,99,64,3,defense
ENG-Premier League,2023,Brentford,Yehor Yarmoliuk,UKR,MF,19,2004,7.6,17,11,6,8,3,7,17,41.2,10,17,4,13,6,23,5,0,defense
ENG-Premier League,2023,Brentford,Yoane Wissa,COD,FW,26,1996,27.7,28,16,13,10,5,5,20,25.0,15,24,3,21,9,37,15,0,defense
ENG-Premier League,2023,Brighton,Adam Lallana,ENG,"MF,FW",35,1988,9.4,8,3,4,4,0,0,4,0.0,4,2,1,1,3,11,1,0,defense
ENG-Premier League,2023,Brighton,Adam Webster,ENG,DF,28,1995,12.7,14,12,8,5,1,6,18,33.3,12,16,12,4,16,30,43,1,defense
ENG-Premier League,2023,Brighton,Ansu Fati,ESP,"MF,FW",20,2002,5.8,5,3,1,2,2,1,11,9.1,10,8,0,8,3,8,3,0,defense
ENG-Premier League,2023,Brighton,Bart Verbruggen,NED,GK,20,2002,21.0,1,1,1,0,0,1,2,50.0,1,0,0,0,0,1,11,3,defense
ENG-Premier League,2023,Brighton,Benicio Boaitey,ENG,"FW,DF",19,2004,0.4,0,0,0,0,0,0,1,0.0,1,1,0,1,0,0,2,0,defense
ENG-Premier League,2023,Brighton,Billy Gilmour,SCO,MF,22,2001,23.6,26,16,14,10,2,11,35,31.4,24,23,9,14,11,37,14,1,defense
ENG-Premier League,2023,Brighton,Carlos Baleba,CMR,MF,19,2004,14.7,40,20,17,19,4,23,46,50.0,23,35,7,28,18,58,30,3,defense
ENG-Premier League,2023,Brighton,Danny Welbeck,ENG,"FW,MF",32,1990,18.8,35,17,9,17,9,10,17,58.8,7,12,0,12,9,44,17,1,defense
ENG-Premier League,2023,Brighton,Evan Ferguson,IRL,FW,18,2004,15.2,14,6,4,7,3,5,14,35.7,9,10,3,7,2,16,8,0,defense
ENG-Premier League,2023,Brighton,Facundo Buonanotte,ARG,"FW,MF",18,2004,15.2,42,22,13,22,7,14,44,31.8,30,22,3,19,8,50,5,0,defense
ENG-Premier League,2023,Brighton,Igor,BRA,DF,25,1998,18.2,25,18,7,16,2,17,29,58.6,12,22,9,13,14,39,52,1,defense
ENG-Premier League,2023,Brighton,Jack Hinshelwood,ENG,DF,18,2005,9.7,14,5,7,4,3,5,13,38.5,8,6,2,4,14,28,18,0,defense
ENG-Premier League,2023,Brighton,Jakub Moder,POL,"MF,DF",24,1999,6.9,19,10,9,5,5,9,18,50.0,9,8,2,6,2,21,12,0,defense
ENG-Premier League,2023,Brighton,James Milner,ENG,"DF,MF",37,1986,8.6,20,14,9,10,1,9,14,64.3,5,9,0,9,8,28,16,0,defense
ENG-Premier League,2023,Brighton,Jan Paul van Hecke,NED,DF,23,2000,26.3,47,26,25,19,3,27,45,60.0,18,49,27,22,30,77,76,4,defense
ENG-Premier League,2023,Brighton,Jason Steele,ENG,GK,32,1990,17.0,0,0,0,0,0,0,3,0.0,3,0,0,0,0,0,8,1,defense
ENG-Premier League,2023,Brighton,João Pedro,BRA,"FW,MF",21,2001,22.7,31,14,10,13,8,14,24,58.3,10,15,2,13,11,42,28,0,defense
ENG-Premier League,2023,Brighton,Joël Veltman,NED,DF,31,1992,17.6,54,41,32,17,5,39,58,67.2,19,17,7,10,18,72,57,1,defense
ENG-Premier League,2023,Brighton,Julio Enciso,PAR,"MF,FW",19,2004,5.3,6,2,3,2,1,2,7,28.6,5,11,0,11,0,6,3,0,defense
ENG-Premier League,2023,Brighton,Kaoru Mitoma,JPN,FW,26,1997,16.5,13,6,3,7,3,5,19,26.3,14,15,1,14,5,18,12,0,defense
ENG-Premier League,2023,Brighton,Lewis Dunk,ENG,DF,31,1991,31.9,27,14,17,9,1,13,36,36.1,23,49,37,12,31,58,90,1,defense
ENG-Premier League,2023,Brighton,Mahmoud Dahoud,GER,MF,27,1996,5.0,9,4,2,4,3,3,9,33.3,6,4,1,3,1,10,5,0,defense
ENG-Premier League,2023,Brighton,Mark O'Mahony,IRL,FW,18,2005,0.7,1,0,1,0,0,1,2,50.0,1,2,1,1,0,1,1,0,defense
ENG-Premier League,2023,Brighton,Odeluga Offiah,ENG,DF,20,2002,1.4,1,0,1,0,0,1,1,100.0,0,0,0,0,1,2,0,0,defense
ENG-Premier League,2023,Brighton,Pascal Groß,GER,"MF,DF",32,1991,34.6,70,46,33,21,16,31,72,43.1,41,41,8,33,22,92,32,3,defense
ENG-Premier League,2023,Brighton,Pervis Estupiñán,ECU,DF,25,1998,13.8,26,13,12,11,3,14,30,46.7,16,14,4,10,21,47,20,0,defense
ENG-Premier League,2023,Brighton,Simon Adingra,CIV,FW,21,2002,24.7,45,20,23,11,11,19,42,45.2,23,31,1,30,19,64,22,0,defense
ENG-Premier League,2023,Brighton,Solly March,ENG,"FW,DF",29,1994,6.2,19,14,9,7,3,8,14,57.1,6,5,0,5,11,30,8,0,defense
ENG-Premier League,2023,Brighton,Tariq Lamptey,GHA,"DF,FW",22,2000,10.2,21,14,14,5,2,13,22,59.1,9,7,3,4,6,27,6,0,defense
ENG-Premier League,2023,Brighton,Valentín Barco,ARG,"DF,FW",19,2004,3.4,11,5,4,5,2,6,8,75.0,2,3,0,3,4,15,3,1,defense
ENG-Premier League,2023,Burnley,Aaron Ramsey,ENG,"MF,FW",20,2003,5.9,17,14,7,5,5,8,16,50.0,8,11,2,9,1,18,10,0,defense
ENG-Premier League,2023,Burnley,Ameen Al-Dakhil,BEL,DF,21,2002,11.7,12,5,4,7,1,1,10,10.0,9,13,6,7,12,24,38,2,defense
ENG-Premier League,2023,Burnley,Anass Zaroury,MAR,"FW,MF",22,2000,1.7,1,0,1,0,0,0,4,0.0,4,2,0,2,0,1,1,1,defense
ENG-Premier League,2023,Burnley,Arijanet Muric,KVX,GK,24,1998,10.0,1,1,1,0,0,1,1,100.0,0,0,0,0,0,1,10,4,defense
ENG-Premier League,2023,Burnley,Benson Manuel,ANG,"MF,FW",26,1997,1.3,3,2,2,1,0,0,0,,0,1,0,1,0,3,0,0,defense
ENG-Premier League,2023,Burnley,Charlie Taylor,ENG,DF,29,1993,25.9,35,20,19,14,2,17,35,48.6,18,27,11,16,19,54,78,0,defense
ENG-Premier League,2023,Burnley,Connor Roberts,WAL,DF,27,1995,9.1,12,5,6,4,2,8,17,47.1,9,8,6,2,4,16,25,2,defense
ENG-Premier League,2023,Burnley,Dara O'Shea,IRL,DF,24,1999,32.1,39,20,22,14,3,11,26,42.3,15,41,30,11,35,74,158,2,defense
ENG-Premier League,2023,Burnley,David Datro Fofana,CIV,FW,20,2002,9.8,10,5,3,5,2,3,6,50.0,3,9,3,6,1,11,2,0,defense
ENG-Premier League,2023,Burnley,Han-Noah Massengo,FRA,"MF,DF",22,2001,0.2,1,1,1,0,0,0,0,,0,1,0,1,0,1,0,0,defense
ENG-Premier League,2023,Burnley,Hannes Delcroix,BEL,DF,24,1999,6.5,10,6,6,4,0,3,4,75.0,1,9,3,6,9,19,26,0,defense
ENG-Premier League,2023,Burnley,Hjalmar Ekdal,SWE,DF,24,1998,4.9,4,2,2,2,0,2,4,50.0,2,10,5,5,6,10,21,0,defense
ENG-Premier League,2023,Burnley,Jack Cork,ENG,MF,34,1989,0.3,2,0,0,2,0,1,3,33.3,2,0,0,0,1,3,1,0,defense
ENG-Premier League,2023,Burnley,Jacob Bruun Larsen,DEN,"MF,FW",24,1998,13.9,9,4,4,3,2,7,21,33.3,14,16,2,14,7,16,23,0,defense
ENG-Premier League,2023,Burnley,James Trafford,ENG,GK,20,2002,28.0,2,1,2,0,0,2,2,100.0,0,0,0,0,1,3,18,1,defense
ENG-Premier League,2023,Burnley,Jay Rodriguez,ENG,FW,34,1989,9.1,14,9,7,4,3,7,13,53.8,6,11,1,10,1,15,8,0,defense
ENG-Premier League,2023,Burnley,Jordan Beyer,GER,DF,23,2000,13.7,35,20,22,12,1,14,24,58.3,10,22,15,7,16,51,68,1,defense
ENG-Premier League,2023,Burnley,Josh Brownhill,ENG,MF,27,1995,25.0,61,35,23,28,10,27,37,73.0,10,33,8,25,34,95,40,1,defense
ENG-Premier League,2023,Burnley,Josh Cullen,IRL,MF,27,1996,22.9,42,29,15,22,5,26,46,56.5,20,31,19,12,15,57,26,1,defense
ENG-Premier League,2023,Burnley,Jóhann Berg Guðmundsson,ISL,"MF,FW",32,1990,13.2,13,4,6,5,2,7,16,43.8,9,14,0,14,16,29,16,0,defense
ENG-Premier League,2023,Burnley,Lorenz Assignon,TOG,DF,23,2000,13.7,35,17,18,13,4,14,27,51.9,13,22,7,15,19,54,43,1,defense
ENG-Premier League,2023,Burnley,Luca Koleosho,ITA,"MF,FW",18,2004,10.8,7,4,2,5,0,2,10,20.0,8,13,0,13,2,9,0,0,defense
ENG-Premier League,2023,Burnley,Lyle Foster,RSA,"FW,MF",22,2000,21.1,19,10,5,6,8,6,17,35.3,11,13,3,10,3,22,34,0,defense
ENG-Premier League,2023,Burnley,Maxime Estève,FRA,DF,21,2002,14.5,27,10,15,12,0,18,32,56.3,14,21,10,11,27,54,56,0,defense
ENG-Premier League,2023,Burnley,Michael Obafemi,IRL,"FW,MF",23,2000,0.2,0,0,0,0,0,0,0,,0,1,0,1,0,0,0,0,defense
ENG-Premier League,2023,Burnley,Mike Trésor,BEL,"FW,MF",24,1999,4.7,10,6,9,1,0,8,18,44.4,10,5,0,5,1,11,1,0,defense
ENG-Premier League,2023,Burnley,Nathan Redmond,ENG,"FW,MF",29,1994,1.6,2,1,0,0,2,1,4,25.0,3,1,0,1,0,2,3,0,defense
ENG-Premier League,2023,Burnley,Sander Berge,NOR,MF,25,1998,33.4,76,46,35,36,5,34,58,58.6,24,49,20,29,23,99,60,2,defense
ENG-Premier League,2023,Burnley,Vitinho,BRA,"DF,MF",24,1999,25.7,64,34,36,22,6,43,86,50.0,43,44,6,38,12,76,47,4,defense
ENG-Premier League,2023,Burnley,Wilson Odobert,FRA,"MF,FW",18,2004,23.3,17,13,8,5,4,6,22,27.3,16,26,2,24,6,23,14,0,defense
ENG-Premier League,2023,Burnley,Zeki Amdouni,SUI,FW,22,2000,21.7,27,18,1,15,11,7,25,28.0,18,23,10,13,9,36,10,0,defense
ENG-Premier League,2023,Chelsea,Alex Matos,ENG,MF,18,2004,0.0,0,0,0,0,0,0,0,,0,0,0,0,0,0,0,0,defense
ENG-Premier League,2023,Chelsea,Alfie Gilchrist,ENG,DF,19,2003,2.3,4,0,4,0,0,2,5,40.0,3,6,3,3,3,7,11,0,defense
ENG-Premier League,2023,Chelsea,Armando Broja,ALB,FW,21,2001,5.0,3,0,0,1,2,1,2,50.0,1,5,1,4,0,3,3,0,defense
ENG-Premier League,2023,Chelsea,Axel Disasi,FRA,DF,25,1998,28.7,33,19,20,10,3,23,30,76.7,7,26,19,7,18,51,102,2,defense
ENG-Premier League,2023,Chelsea,Ben Chilwell,ENG,DF,26,1996,8.4,15,10,5,9,1,5,8,62.5,3,11,3,8,4,19,19,1,defense
ENG-Premier League,2023,Chelsea,Benoît Badiashile,FRA,DF,22,2001,14.9,21,15,12,9,0,9,14,64.3,5,21,14,7,18,39,66,2,defense
ENG-Premier League,2023,Chelsea,Carney Chukwuemeka,ENG,"MF,FW",19,2003,2.5,6,4,3,3,0,1,3,33.3,2,1,1,0,0,6,1,0,defense
ENG-Premier League,2023,Chelsea,Cesare Casadei,ITA,"FW,MF",20,2003,0.9,5,3,2,1,2,2,5,40.0,3,1,0,1,0,5,4,0,defense
ENG-Premier League,2023,Chelsea,Christopher Nkunku,FRA,"FW,MF",25,1997,4.9,5,4,0,4,1,1,2,50.0,1,4,1,3,2,7,4,0,defense
ENG-Premier League,2023,Chelsea,Cole Palmer,ENG,"FW,MF",21,2002,29.0,23,12,9,6,8,8,19,42.1,11,20,2,18,20,43,13,2,defense
ENG-Premier League,2023,Chelsea,Conor Gallagher,ENG,MF,23,2000,34.8,85,52,37,31,17,33,77,42.9,44,50,11,39,43,128,34,0,defense
ENG-Premier League,2023,Chelsea,Deivid Washington,BRA,"DF,FW",18,2005,0.1,1,1,1,0,0,0,1,0.0,1,0,0,0,0,1,0,0,defense
ENG-Premier League,2023,Chelsea,Enzo Fernández,ARG,MF,22,2001,24.5,50,22,22,18,10,27,65,41.5,38,36,13,23,17,67,28,0,defense
ENG-Premier League,2023,Chelsea,Ian Maatsen,NED,"FW,MF",21,2002,2.3,3,2,1,1,1,0,4,0.0,4,4,0,4,3,6,10,0,defense
ENG-Premier League,2023,Chelsea,Jimi Tauriainen,ENG,FW,19,2004,0.0,0,0,0,0,0,0,0,,0,0,0,0,0,0,0,0,defense
ENG-Premier League,2023,Chelsea,Joshua Acheampong,ENG,DF,17,2006,0.1,0,0,0,0,0,0,0,,0,3,3,0,0,0,0,0,defense
ENG-Premier League,2023,Chelsea,Lesley Ugochukwu,FRA,MF,19,2004,3.3,14,10,4,8,2,4,10,40.0,6,6,2,4,1,15,5,0,defense
ENG-Premier League,2023,Chelsea,Levi Colwill,ENG,DF,20,2003,20.0,48,30,26,17,5,26,34,76.5,8,28,10,18,26,74,66,0,defense
ENG-Premier League,2023,Chelsea,Malo Gusto,FRA,DF,20,2003,19.5,55,27,34,15,6,35,52,67.3,17,28,4,24,17,72,43,1,defense
ENG-Premier League,2023,Chelsea,Marc Cucurella,ESP,DF,25,1998,19.8,62,38,36,21,5,34,64,53.1,30,36,13,23,22,84,48,0,defense
ENG-Premier League,2023,Chelsea,Mason Burstow,ENG,FW,19,2003,0.1,0,0,0,0,0,0,0,,0,0,0,0,0,0,0,0,defense
ENG-Premier League,2023,Chelsea,Moisés Caicedo,ECU,MF,21,2001,31.8,91,46,38,42,11,36,60,60.0,24,59,25,34,37,128,44,4,defense
ENG-Premier League,2023,Chelsea,Mykhailo Mudryk,UKR,FW,22,2001,17.5,21,12,9,7,5,10,32,31.3,22,14,1,13,9,30,9,0,defense
ENG-Premier League,2023,Chelsea,Nicolas Jackson,SEN,FW,22,2001,31.1,21,13,5,8,8,5,24,20.8,19,20,5,15,4,25,17,0,defense
ENG-Premier League,2023,Chelsea,Noni Madueke,ENG,FW,21,2002,11.7,16,10,8,4,4,11,34,32.4,23,11,0,11,4,20,14,0,defense
ENG-Premier League,2023,Chelsea,Raheem Sterling,ENG,"FW,MF",28,1994,22.0,21,10,7,8,6,12,26,46.2,14,13,0,13,13,34,9,1,defense
ENG-Premier League,2023,Chelsea,Reece James,ENG,DF,23,1999,4.7,14,9,10,3,1,8,10,80.0,2,4,4,0,3,17,7,1,defense
ENG-Premier League,2023,Chelsea,Robert Sánchez,ESP,GK,25,1997,15.9,0,0,0,0,0,0,0,,0,0,0,0,0,0,11,3,defense
ENG-Premier League,2023,Chelsea,Roméo Lavia,BEL,MF,19,2004,0.4,1,0,0,1,0,0,0,,0,0,0,0,0,1,1,0,defense
ENG-Premier League,2023,Chelsea,Thiago Silva,BRA,DF,38,1984,28.1,29,15,22,6,1,20,34,58.8,14,33,24,9,26,55,153,4,defense
ENG-Premier League,2023,Chelsea,Trevoh Chalobah,ENG,DF,24,1999,10.6,16,12,10,2,4,10,15,66.7,5,8,7,1,8,24,51,0,defense
ENG-Premier League,2023,Chelsea,Đorđe Petrović,SRB,GK,23,1999,22.1,0,0,0,0,0,0,0,,0,0,0,0,0,0,12,3,defense
ENG-Premier League,2023,Crystal Palace,Adam Wharton,ENG,MF,19,2004,14.4,48,32,18,22,8,23,46,50.0,23,17,3,14,20,68,24,1,defense
ENG-Premier League,2023,Crystal Palace,Cheick Doucouré,MLI,MF,23,2000,10.2,34,17,15,13,6,18,30,60.0,12,13,2,11,20,54,12,0,defense
ENG-Premier League,2023,Crystal Palace,Chris Richards,USA,"DF,MF",23,2000,23.3,46,28,21,22,3,20,30,66.7,10,32,12,20,27,73,109,0,defense
ENG-Premier League,2023,Crystal Palace,Daniel Muñoz,COL,"DF,MF",27,1996,16.0,55,35,31,14,10,19,38,50.0,19,29,7,22,24,79,47,0,defense
ENG-Premier League,2023,Crystal Palace,David Ozoh,ENG,"MF,DF",18,2005,1.7,10,6,3,6,1,5,6,83.3,1,2,0,2,0,10,2,0,defense
ENG-Premier League,2023,Crystal Palace,Dean Henderson,ENG,GK,26,1997,18.0,1,1,1,0,0,1,2,50.0,1,0,0,0,0,1,8,2,defense
ENG-Premier League,2023,Crystal Palace,Eberechi Eze,ENG,"MF,FW",25,1998,22.8,35,17,4,18,13,15,31,48.4,16,27,2,25,11,46,6,0,defense
ENG-Premier League,2023,Crystal Palace,James Tomkins,ENG,DF,34,1989,0.1,0,0,0,0,0,0,0,,0,0,0,0,1,1,0,0,defense
ENG-Premier League,2023,Crystal Palace,Jaïro Riedewald,NED,"MF,FW",26,1996,2.6,9,3,2,4,3,3,6,50.0,3,0,0,0,2,11,2,0,defense
ENG-Premier League,2023,Crystal Palace,Jean-Philippe Mateta,FRA,FW,26,1997,25.4,22,15,4,11,7,6,10,60.0,4,13,4,9,4,26,14,0,defense
ENG-Premier League,2023,Crystal Palace,Jefferson Lerma,COL,"MF,DF",28,1994,26.7,42,25,15,23,4,19,40,47.5,21,31,12,19,36,78,72,0,defense
ENG-Premier League,2023,Crystal Palace,Jeffrey Schlupp,GHA,"FW,MF",30,1992,15.0,38,24,14,16,8,9,18,50.0,9,13,2,11,8,46,24,0,defense
ENG-Premier League,2023,Crystal Palace,Jesurun Rak Sakyi,ENG,"MF,FW",20,2002,1.5,4,1,3,1,0,2,3,66.7,1,2,0,2,3,7,1,0,defense
ENG-Premier League,2023,Crystal Palace,Joachim Andersen,DEN,DF,27,1996,37.9,56,35,33,21,2,29,39,74.4,10,33,18,15,41,97,207,1,defense
ENG-Premier League,2023,Crystal Palace,Joel Ward,ENG,DF,33,1989,22.0,45,28,26,18,1,30,47,63.8,17,17,10,7,14,59,94,1,defense
ENG-Premier League,2023,Crystal Palace,Jordan Ayew,GHA,"FW,MF",31,1991,28.3,65,36,23,28,14,21,42,50.0,21,43,2,41,16,81,15,0,defense
ENG-Premier League,2023,Crystal Palace,Marc Guéhi,ENG,DF,23,2000,22.5,28,19,21,7,0,14,24,58.3,10,22,17,5,18,46,89,1,defense
ENG-Premier League,2023,Crystal Palace,Matheus França,BRA,"MF,FW",19,2004,2.6,3,3,2,1,0,1,7,14.3,6,4,0,4,1,4,1,0,defense
ENG-Premier League,2023,Crystal Palace,Michael Olise,FRA,"FW,MF",21,2001,14.2,19,10,7,10,2,8,24,33.3,16,21,0,21,11,30,9,0,defense
ENG-Premier League,2023,Crystal Palace,Naouirou Ahamada,FRA,"MF,FW",21,2002,3.9,13,9,5,6,2,8,17,47.1,9,3,0,3,2,15,4,0,defense
ENG-Premier League,2023,Crystal Palace,Nathaniel Clyne,ENG,DF,32,1991,14.9,24,15,11,11,2,14,21,66.7,7,18,6,12,10,34,33,0,defense
ENG-Premier League,2023,Crystal Palace,Odsonne Édouard,FRA,"FW,MF",25,1998,17.3,24,12,8,8,8,4,19,21.1,15,17,1,16,6,30,19,0,defense
ENG-Premier League,2023,Crystal Palace,Remi Matthews,ENG,GK,29,1994,0.0,0,0,0,0,0,0,0,,0,0,0,0,0,0,1,0,defense
ENG-Premier League,2023,Crystal Palace,Sam Johnstone,ENG,GK,30,1993,20.0,1,0,1,0,0,1,1,100.0,0,0,0,0,1,2,5,0,defense
ENG-Premier League,2023,Crystal Palace,Tyrick Mitchell,ENG,"DF,MF",23,1999,35.6,105,60,75,21,9,43,60,71.7,17,63,10,53,26,131,104,0,defense
ENG-Premier League,2023,Crystal Palace,Will Hughes,ENG,MF,28,1995,21.0,61,33,30,20,11,24,48,50.0,24,36,14,22,21,82,25,0,defense
ENG-Premier League,2023,Everton,Abdoulaye Doucouré,MLI,"FW,MF",30,1993,29.2,43,27,20,14,9,18,46,39.1,28,23,3,20,15,58,19,0,defense
ENG-Premier League,2023,Everton,Alex Iwobi,NGA,MF,27,1996,1.6,2,0,1,0,1,2,3,66.7,1,2,0,2,1,3,0,0,defense
ENG-Premier League,2023,Everton,Amadou Onana,BEL,MF,21,2001,23.2,71,38,32,31,8,21,42,50.0,21,25,6,19,21,92,31,0,defense
ENG-Premier League,2023,Everton,André Gomes,POR,"MF,FW",30,1993,5.6,7,4,2,3,2,3,13,23.1,10,10,1,9,3,10,4,1,defense
ENG-Premier League,2023,Everton,Arnaut Danjuma,NED,"MF,FW",26,1997,6.6,6,4,2,3,1,1,4,25.0,3,4,0,4,3,9,0,0,defense
ENG-Premier League,2023,Everton,Ashley Young,ENG,"DF,MF",38,1985,25.3,53,38,28,19,6,30,54,55.6,24,24,6,18,22,75,50,3,defense
ENG-Premier League,2023,Everton,Ben Godfrey,ENG,DF,25,1998,12.4,30,20,17,8,5,15,28,53.6,13,14,8,6,16,46,57,0,defense
ENG-Premier League,2023,Everton,Beto,GNB,FW,25,1998,10.6,14,6,1,6,7,4,12,33.3,8,11,0,11,1,15,14,0,defense
ENG-Premier League,2023,Everton,Dominic Calvert-Lewin,ENG,FW,26,1997,24.1,13,6,2,6,5,2,15,13.3,13,14,4,10,4,17,38,0,defense
ENG-Premier League,2023,Everton,Dwight McNeil,ENG,"MF,FW",23,1999,32.1,44,27,16,14,14,24,55,43.6,31,44,7,37,22,66,37,0,defense
ENG-Premier League,2023,Everton,Idrissa Gana Gueye,SEN,MF,33,1989,20.9,73,44,32,27,14,29,46,63.0,17,24,7,17,28,101,16,0,defense
ENG-Premier League,2023,Everton,Jack Harrison,ENG,"MF,FW",26,1996,24.6,37,22,12,12,13,17,49,34.7,32,25,5,20,12,49,24,0,defense
ENG-Premier League,2023,Everton,James Garner,ENG,MF,22,2001,33.4,83,44,32,38,13,35,82,42.7,47,45,14,31,45,128,47,1,defense
ENG-Premier League,2023,Everton,James Tarkowski,ENG,DF,30,1992,38.0,61,42,46,14,1,27,48,56.3,21,82,56,26,56,117,191,2,defense
ENG-Premier League,2023,Everton,Jarrad Branthwaite,ENG,DF,21,2002,34.6,66,32,42,22,2,45,62,72.6,17,51,36,15,50,116,163,2,defense
ENG-Premier League,2023,Everton,Jordan Pickford,ENG,GK,29,1994,38.0,1,0,1,0,0,1,1,100.0,0,3,0,3,0,1,19,1,defense
ENG-Premier League,2023,Everton,Lewis Dobbin,ENG,MF,20,2003,2.6,9,7,3,5,1,5,9,55.6,4,5,1,4,1,10,0,0,defense
ENG-Premier League,2023,Everton,Lewis Warrington,ENG,FW,20,2002,0.0,0,0,0,0,0,0,0,,0,0,0,0,0,0,0,0,defense
ENG-Premier League,2023,Everton,Michael Keane,ENG,DF,30,1993,4.9,7,3,3,3,1,1,7,14.3,6,5,4,1,5,12,18,1,defense
ENG-Premier League,2023,Everton,Nathan Patterson,SCO,DF,21,2001,11.2,34,24,21,11,2,14,37,37.8,23,14,3,11,9,43,33,0,defense
ENG-Premier League,2023,Everton,Neal Maupay,FRA,FW,26,1996,1.2,0,0,0,0,0,0,1,0.0,1,2,0,2,0,0,1,0,defense
ENG-Premier League,2023,Everton,Séamus Coleman,IRL,DF,34,1988,7.4,17,14,10,3,4,11,16,68.8,5,12,4,8,7,24,26,1,defense
ENG-Premier League,2023,Everton,Thomas Cannon,IRL,FW,20,2002,0.0,0,0,0,0,0,0,0,,0,0,0,0,0,0,0,0,defense
ENG-Premier League,2023,Everton,Tyler Onyango,ENG,MF,20,2003,0.0,0,0,0,0,0,0,0,,0,0,0,0,0,0,0,0,defense
ENG-Premier League,2023,Everton,Vitaliy Mykolenko,UKR,DF,24,1999,27.4,69,38,46,21,2,41,66,62.1,25,36,11,25,36,105,92,0,defense
ENG-Premier League,2023,Everton,Youssef Chermiti,POR,FW,19,2004,2.3,3,2,2,1,0,1,5,20.0,4,4,1,3,1,4,2,0,defense
ENG-Premier League,2023,Fulham,Adama Traoré,ESP,"FW,MF",27,1996,4.2,4,3,1,2,1,3,6,50.0,3,2,0,2,1,5,2,0,defense
ENG-Premier League,2023,Fulham,Aleksandar Mitrović,SRB,FW,28,1994,0.4,0,0,0,0,0,0,0,,0,0,0,0,0,0,0,0,defense
ENG-Premier League,2023,Fulham,Alex Iwobi,NGA,"FW,MF",27,1996,24.4,29,18,12,15,2,12,25,48.0,13,16,0,16,14,43,9,0,defense
ENG-Premier League,2023,Fulham,Andreas Pereira,BRA,MF,27,1996,29.0,25,12,4,12,9,11,41,26.8,30,16,2,14,4,29,12,0,defense
ENG-Premier League,2023,Fulham,Antonee Robinson,USA,DF,25,1997,36.3,93,58,60,26,7,52,110,47.3,58,56,8,48,80,173,117,3,defense
ENG-Premier League,2023,Fulham,Armando Broja,ALB,FW,21,2001,1.0,0,0,0,0,0,0,0,,0,1,0,1,0,0,0,0,defense
ENG-Premier League,2023,Fulham,Bernd Leno,GER,GK,31,1992,38.0,0,0,0,0,0,0,0,,0,0,0,0,0,0,14,1,defense
ENG-Premier League,2023,Fulham,Bobby Reid,JAM,FW,30,1993,15.8,22,14,5,15,2,4,16,25.0,12,24,2,22,5,27,14,0,defense
ENG-Premier League,2023,Fulham,Calvin Bassey,NGA,DF,23,1999,25.6,49,29,33,15,1,21,29,72.4,8,32,11,21,28,77,84,4,defense
ENG-Premier League,2023,Fulham,Carlos Vinícius,BRA,FW,28,1995,3.5,3,2,0,1,2,0,4,0.0,4,4,0,4,0,3,1,0,defense
ENG-Premier League,2023,Fulham,Fodé Ballo-Touré,SEN,"DF,MF",26,1997,0.8,4,2,1,3,0,1,2,50.0,1,1,0,1,3,7,2,0,defense
ENG-Premier League,2023,Fulham,Harrison Reed,ENG,MF,28,1995,14.7,29,18,9,17,3,13,31,41.9,18,19,9,10,11,40,24,0,defense
ENG-Premier League,2023,Fulham,Harry Wilson,WAL,FW,26,1997,18.0,21,14,9,8,4,11,28,39.3,17,27,3,24,10,31,12,0,defense
ENG-Premier League,2023,Fulham,Issa Diop,FRA,DF,26,1997,15.8,30,16,23,5,2,15,20,75.0,5,28,19,9,17,47,80,1,defense
ENG-Premier League,2023,Fulham,João Palhinha,POR,MF,28,1995,30.0,152,75,80,60,12,103,152,67.8,49,57,9,48,46,198,58,0,defense
ENG-Premier League,2023,Fulham,Kenny Tete,NED,DF,27,1995,9.6,27,17,19,6,2,11,19,57.9,8,10,3,7,16,43,35,0,defense
ENG-Premier League,2023,Fulham,Luke Harris,WAL,MF,18,2005,0.8,1,1,1,0,0,0,1,0.0,1,0,0,0,0,1,0,0,defense
ENG-Premier League,2023,Fulham,Raúl Jiménez,MEX,FW,32,1991,15.5,18,12,4,8,6,7,20,35.0,13,11,3,8,4,22,13,0,defense
ENG-Premier League,2023,Fulham,Rodrigo Muniz,BRA,FW,22,2001,17.7,7,3,1,5,1,1,6,16.7,5,9,3,6,6,13,20,0,defense
ENG-Premier League,2023,Fulham,Saša Lukić,SRB,MF,26,1996,12.5,33,19,9,17,7,18,39,46.2,21,18,5,13,16,49,19,1,defense
ENG-Premier League,2023,Fulham,Tim Ream,USA,DF,35,1987,16.7,20,9,13,5,2,9,18,50.0,9,23,15,8,25,45,61,2,defense
ENG-Premier League,2023,Fulham,Timothy Castagne,BEL,DF,27,1995,29.3,49,24,23,16,10,26,44,59.1,18,38,10,28,38,87,69,1,defense
ENG-Premier League,2023,Fulham,Tom Cairney,SCO,MF,32,1991,16.5,24,16,10,12,2,13,25,52.0,12,16,4,12,13,37,6,0,defense
ENG-Premier League,2023,Fulham,Tosin Adarabioyo,ENG,DF,25,1997,18.0,21,11,16,5,0,12,21,57.1,9,16,11,5,25,46,80,0,defense
ENG-Premier League,2023,Fulham,Willian,BRA,FW,34,1988,22.8,18,11,6,7,5,3,21,14.3,18,13,0,13,9,27,12,1,defense
ENG-Premier League,2023,Liverpool,Alexis Mac Allister,ARG,MF,24,1998,28.9,99,55,35,50,14,59,125,47.2,66,65,8,57,35,134,25,1,defense
ENG-Premier League,2023,Liverpool,Alisson,BRA,GK,30,1992,28.0,0,0,0,0,0,0,1,0.0,1,0,0,0,0,0,11,4,defense
ENG-Premier League,2023,Liverpool,Andrew Robertson,SCO,DF,29,1994,18.8,35,24,21,11,3,26,43,60.5,17,20,6,14,13,48,40,0,defense
ENG-Premier League,2023,Liverpool,Ben Doak,SCO,FW,17,2005,0.2,0,0,0,0,0,0,0,,0,0,0,0,0,0,0,0,defense
ENG-Premier League,2023,Liverpool,Bobby Clark,ENG,MF,18,2005,1.0,2,1,1,1,0,1,5,20.0,4,6,2,4,1,3,1,0,defense
ENG-Premier League,2023,Liverpool,Caoimhín Kelleher,IRL,GK,24,1998,10.0,0,0,0,0,0,0,0,,0,0,0,0,0,0,4,1,defense
ENG-Premier League,2023,Liverpool,Cody Gakpo,NED,"FW,MF",24,1999,18.3,27,17,8,14,5,8,25,32.0,17,21,4,17,14,41,7,0,defense
ENG-Premier League,2023,Liverpool,Conor Bradley,NIR,DF,20,2003,8.4,33,25,14,12,7,24,38,63.2,14,17,1,16,10,43,14,0,defense
ENG-Premier League,2023,Liverpool,Curtis Jones,ENG,MF,22,2001,13.0,27,14,12,12,3,10,23,43.5,13,22,0,22,7,34,8,0,defense
ENG-Premier League,2023,Liverpool,Darwin Núñez,URU,FW,24,1999,22.7,22,12,2,10,10,11,23,47.8,12,18,6,12,3,25,9,0,defense
ENG-Premier League,2023,Liverpool,Diogo Jota,POR,FW,26,1996,12.7,23,13,6,13,4,10,23,43.5,13,9,1,8,7,30,4,0,defense
ENG-Premier League,2023,Liverpool,Dominik Szoboszlai,HUN,MF,22,2000,23.4,32,19,12,12,8,16,50,32.0,34,37,2,35,15,47,16,1,defense
ENG-Premier League,2023,Liverpool,Harvey Elliott,ENG,"MF,FW",20,2003,15.0,27,17,8,14,5,10,31,32.3,21,27,0,27,6,33,7,0,defense
ENG-Premier League,2023,Liverpool,Ibrahima Konaté,FRA,DF,24,1999,17.5,36,22,22,13,1,18,24,75.0,6,18,12,6,20,56,51,1,defense
ENG-Premier League,2023,Liverpool,James McConnell,ENG,MF,18,2004,0.0,0,0,0,0,0,0,0,,0,1,0,1,1,1,0,0,defense
ENG-Premier League,2023,Liverpool,Jarell Quansah,ENG,DF,20,2003,13.2,25,22,17,7,1,14,20,70.0,6,16,8,8,17,42,39,1,defense
ENG-Premier League,2023,Liverpool,Jayden Danns,ENG,FW,17,2006,0.1,0,0,0,0,0,0,0,,0,0,0,0,0,0,0,0,defense
ENG-Premier League,2023,Liverpool,Joe Gomez,ENG,DF,26,1997,19.8,47,31,24,16,7,30,63,47.6,33,26,4,22,19,66,50,2,defense
ENG-Premier League,2023,Liverpool,Joël Matip,CMR,DF,31,1991,8.7,12,6,7,4,1,8,12,66.7,4,16,12,4,9,21,43,0,defense
ENG-Premier League,2023,Liverpool,Kaide Gordon,ENG,FW,18,2004,0.0,0,0,0,0,0,0,0,,0,0,0,0,0,0,0,0,defense
ENG-Premier League,2023,Liverpool,Kostas Tsimikas,GRE,DF,27,1996,7.5,19,13,9,6,4,9,15,60.0,6,9,1,8,6,25,10,0,defense
ENG-Premier League,2023,Liverpool,Luis Díaz,COL,FW,26,1997,29.2,35,25,5,17,13,7,30,23.3,23,15,0,15,3,38,8,0,defense
ENG-Premier League,2023,Liverpool,Mohamed Salah,EGY,FW,31,1992,28.2,17,11,1,8,8,6,21,28.6,15,19,1,18,2,19,1,0,defense
ENG-Premier League,2023,Liverpool,Owen Beck,WAL,DF,20,2002,0.1,2,1,1,1,0,0,0,,0,0,0,0,0,2,1,0,defense
ENG-Premier League,2023,Liverpool,Ryan Gravenberch,NED,MF,21,2002,12.5,26,12,5,13,8,12,29,41.4,17,20,2,18,14,40,11,0,defense
ENG-Premier League,2023,Liverpool,Stefan Bajcetic,ESP,MF,18,2004,0.3,4,1,3,1,0,3,5,60.0,2,0,0,0,0,4,0,0,defense
ENG-Premier League,2023,Liverpool,Thiago Alcántara,ESP,MF,32,1991,0.1,0,0,0,0,0,0,0,,0,0,0,0,0,0,0,0,defense
ENG-Premier League,2023,Liverpool,Trent Alexander-Arnold,ENG,DF,24,1998,23.9,39,26,26,11,2,27,87,31.0,60,22,2,20,31,70,48,5,defense
ENG-Premier League,2023,Liverpool,Virgil van Dijk,NED,DF,32,1991,35.3,40,23,24,13,3,12,14,85.7,2,47,34,13,39,79,144,0,defense
ENG-Premier League,2023,Liverpool,Wataru Endo,JPN,MF,30,1993,19.1,48,28,11,31,6,20,61,32.8,41,24,2,22,20,68,31,3,defense
ENG-Premier League,2023,Luton Town,Albert Sambi Lokonga,BEL,MF,23,1999,14.5,29,18,14,12,3,17,24,70.8,7,23,13,10,11,40,14,0,defense
ENG-Premier League,2023,Luton Town,Alfie Doughty,ENG,DF,23,1999,32.5,63,40,29,18,16,37,82,45.1,45,51,9,42,31,94,43,4,defense
ENG-Premier League,2023,Luton Town,Amari'i Bell,JAM,DF,29,1994,19.1,50,33,30,19,1,22,35,62.9,13,33,15,18,25,75,60,1,defense
ENG-Premier League,2023,Luton Town,Andros Townsend,ENG,"MF,FW",32,1991,13.4,21,13,11,2,8,13,27,48.1,14,12,0,12,5,26,10,0,defense
ENG-Premier League,2023,Luton Town,Carlton Morris,ENG,"FW,MF",27,1995,31.8,15,8,4,6,5,9,15,60.0,6,24,5,19,1,16,53,0,defense
ENG-Premier League,2023,Luton Town,Cauley Woodrow,ENG,"FW,MF",28,1994,4.7,16,10,8,4,4,9,16,56.3,7,7,1,6,1,17,14,0,defense
ENG-Premier League,2023,Luton Town,Chiedozie Ogbene,IRL,"MF,DF",26,1997,22.2,17,10,10,7,0,12,22,54.5,10,14,3,11,7,24,34,2,defense
ENG-Premier League,2023,Luton Town,Daiki Hashioka,JPN,DF,24,1999,6.6,11,5,6,4,1,5,11,45.5,6,12,7,5,8,19,20,0,defense
ENG-Premier League,2023,Luton Town,Elijah Adebayo,ENG,FW,25,1998,15.8,4,1,1,0,3,1,12,8.3,11,13,2,11,6,10,25,0,defense
ENG-Premier League,2023,Luton Town,Fred Onyedinma,ENG,"DF,MF",26,1996,4.5,10,6,7,3,0,5,12,41.7,7,3,0,3,1,11,13,0,defense
ENG-Premier League,2023,Luton Town,Gabriel Osho,NGA,DF,24,1998,20.5,41,22,21,19,1,16,27,59.3,11,37,20,17,31,72,92,0,defense
ENG-Premier League,2023,Luton Town,Issa Kaboré,BFA,DF,22,2001,19.2,52,28,23,21,8,24,45,53.3,21,22,11,11,16,68,56,2,defense
ENG-Premier League,2023,Luton Town,Jacob Brown,SCO,"MF,FW",25,1998,11.3,19,12,7,7,5,7,18,38.9,11,20,1,19,8,27,22,0,defense
ENG-Premier League,2023,Luton Town,James Shea,ENG,GK,32,1991,0.2,0,0,0,0,0,0,0,,0,0,0,0,0,0,2,0,defense
ENG-Premier League,2023,Luton Town,Jordan Clark,ENG,MF,29,1993,14.5,30,17,14,11,5,11,39,28.2,28,24,3,21,11,41,15,1,defense
ENG-Premier League,2023,Luton Town,Joseph Johnson,ENG,DF,17,2006,0.9,0,0,0,0,0,0,1,0.0,1,0,0,0,0,0,0,0,defense
ENG-Premier League,2023,Luton Town,Luke Berry,ENG,"MF,DF",31,1992,3.6,7,2,2,4,1,2,3,66.7,1,6,1,5,0,7,3,0,defense
ENG-Premier League,2023,Luton Town,Mads Juel Andersen,DEN,DF,25,1997,4.4,6,5,4,2,0,4,4,100.0,0,9,6,3,8,14,29,0,defense
ENG-Premier League,2023,Luton Town,Marvelous Nakamba,ZIM,MF,29,1994,12.6,40,24,24,14,2,24,42,57.1,18,23,6,17,11,51,11,1,defense
ENG-Premier League,2023,Luton Town,Pelly Ruddock Mpanzu,COD,MF,30,1993,12.2,13,5,6,6,1,5,9,55.6,4,15,7,8,9,22,16,3,defense
ENG-Premier League,2023,Luton Town,Reece Burke,ENG,DF,26,1996,18.4,37,23,17,14,6,12,26,46.2,14,25,18,7,18,55,78,1,defense
ENG-Premier League,2023,Luton Town,Ross Barkley,ENG,MF,29,1993,29.1,47,19,16,21,10,11,48,22.9,37,25,9,16,25,72,51,2,defense
ENG-Premier League,2023,Luton Town,Ryan Giles,ENG,"DF,MF",23,2000,5.6,8,6,4,3,1,2,7,28.6,5,2,0,2,4,12,22,0,defense
ENG-Premier League,2023,Luton Town,Tahith Chong,NED,"MF,FW",23,1999,22.0,36,22,19,13,4,15,33,45.5,18,30,6,24,8,44,11,1,defense
ENG-Premier League,2023,Luton Town,Teden Mengi,ENG,DF,21,2002,27.4,54,22,33,20,1,19,30,63.3,11,39,27,12,57,111,140,1,defense
ENG-Premier League,2023,Luton Town,Thomas Kaminski,BEL,GK,30,1992,37.8,2,1,2,0,0,2,6,33.3,4,1,0,1,0,2,14,2,defense
ENG-Premier League,2023,Luton Town,Tom Lockyer,WAL,DF,28,1994,13.0,25,16,17,6,2,15,22,68.2,7,23,13,10,23,48,68,0,defense
ENG-Premier League,2023,Luton Town,Zack Nelson,ENG,"MF,DF",18,2004,0.1,1,0,1,0,0,0,0,,0,0,0,0,0,1,0,0,defense
ENG-Premier League,2023,Manchester City,Aymeric Laporte,ESP,DF,29,1994,0.1,0,0,0,0,0,0,0,,0,1,1,0,0,0,1,0,defense
ENG-Premier League,2023,Manchester City,Bernardo Silva,POR,"MF,FW",28,1994,28.6,51,23,13,25,13,25,57,43.9,32,32,4,28,17,68,15,1,defense
ENG-Premier League,2023,Manchester City,Cole Palmer,ENG,MF,21,2002,0.1,0,0,0,0,0,0,0,,0,0,0,0,0,0,0,0,defense
ENG-Premier League,2023,Manchester City,Ederson,BRA,GK,29,1993,30.9,0,0,0,0,0,0,1,0.0,1,0,0,0,0,0,10,1,defense
ENG-Premier League,2023,Manchester City,Erling Haaland,NOR,FW,23,2000,28.4,6,3,0,3,3,2,3,66.7,1,11,1,10,2,8,16,0,defense
ENG-Premier League,2023,Manchester City,Jack Grealish,ENG,"FW,MF",27,1995,11.2,13,8,6,7,0,6,12,50.0,6,13,2,11,6,19,5,0,defense
ENG-Premier League,2023,Manchester City,James Mcatee,ENG,MF,20,2002,0.0,0,0,0,0,0,0,0,,0,1,0,1,0,0,0,0,defense
ENG-Premier League,2023,Manchester City,Jeremy Doku,BEL,"FW,MF",21,2002,17.7,39,22,13,12,14,9,20,45.0,11,14,0,14,9,48,5,0,defense
ENG-Premier League,2023,Manchester City,John Stones,ENG,"DF,MF",29,1994,11.8,2,1,1,0,1,0,3,0.0,3,11,7,4,10,12,21,0,defense
ENG-Premier League,2023,Manchester City,Joško Gvardiol,CRO,DF,21,2002,25.9,55,33,21,24,10,21,38,55.3,17,36,12,24,27,82,37,3,defense
ENG-Premier League,2023,Manchester City,Julián Álvarez,ARG,"MF,FW",23,2000,29.4,24,13,5,8,11,8,32,25.0,24,30,0,30,2,26,14,1,defense
ENG-Premier League,2023,Manchester City,Kalvin Phillips,ENG,MF,27,1995,1.0,3,3,1,1,1,0,0,,0,0,0,0,2,5,2,0,defense
ENG-Premier League,2023,Manchester City,Kevin De Bruyne,BEL,MF,32,1991,13.6,14,9,1,5,8,7,20,35.0,13,5,0,5,4,18,4,0,defense
ENG-Premier League,2023,Manchester City,Kyle Walker,ENG,DF,33,1990,30.7,38,24,19,17,2,19,39,48.7,20,19,6,13,27,65,40,1,defense
ENG-Premier League,2023,Manchester City,Manuel Akanji,SUI,"DF,MF",28,1995,27.9,42,28,16,18,8,22,39,56.4,17,28,12,16,23,65,70,3,defense
ENG-Premier League,2023,Manchester City,Mateo Kovačić,CRO,MF,29,1994,17.2,36,25,16,15,5,18,28,64.3,10,23,1,22,10,46,10,0,defense
ENG-Premier League,2023,Manchester City,Matheus Nunes,POR,MF,24,1998,7.3,10,4,1,7,2,5,16,31.3,11,7,1,6,1,11,8,1,defense
ENG-Premier League,2023,Manchester City,Nathan Aké,NED,DF,28,1995,22.7,26,16,15,8,3,13,20,65.0,7,17,2,15,14,40,54,0,defense
ENG-Premier League,2023,Manchester City,Oscar Bobb,NOR,"FW,MF",20,2003,3.4,7,3,1,2,4,2,4,50.0,2,4,0,4,5,12,1,0,defense
ENG-Premier League,2023,Manchester City,Phil Foden,ENG,"FW,MF",23,2000,31.7,31,20,11,10,10,13,31,41.9,18,30,0,30,13,44,18,1,defense
ENG-Premier League,2023,Manchester City,Rico Lewis,ENG,"DF,MF",18,2004,9.0,10,7,4,4,2,3,7,42.9,4,7,1,6,4,14,6,0,defense
ENG-Premier League,2023,Manchester City,Rodri,ESP,MF,27,1996,32.6,70,43,25,33,12,29,60,48.3,31,32,8,24,26,96,41,4,defense
ENG-Premier League,2023,Manchester City,Rúben Dias,POR,DF,26,1997,28.4,39,20,14,21,4,19,26,73.1,7,32,17,15,30,69,77,0,defense
ENG-Premier League,2023,Manchester City,Sergio Gómez,ESP,"FW,MF",22,2000,0.6,1,0,0,1,0,1,2,50.0,1,0,0,0,1,2,0,0,defense
ENG-Premier League,2023,Manchester City,Stefan Ortega,GER,GK,30,1992,7.1,0,0,0,0,0,0,0,,0,0,0,0,0,0,2,1,defense
ENG-Premier League,2023,Manchester Utd,Aaron Wan-Bissaka,ENG,DF,25,1997,19.8,42,25,18,20,4,19,26,73.1,7,29,15,14,41,83,68,1,defense
ENG-Premier League,2023,Manchester Utd,Alejandro Garnacho,ARG,FW,19,2004,28.5,22,15,7,6,9,12,45,26.7,33,26,2,24,18,40,18,0,defense
ENG-Premier League,2023,Manchester Utd,Amad Diallo,CIV,"FW,MF",21,2002,4.3,10,3,1,6,3,3,7,42.9,4,3,1,2,1,11,6,0,defense
ENG-Premier League,2023,Manchester Utd,André Onana,CMR,GK,27,1996,38.0,2,0,2,0,0,2,2,100.0,0,0,0,0,0,2,11,2,defense
ENG-Premier League,2023,Manchester Utd,Anthony Martial,FRA,FW,27,1995,5.0,4,1,1,1,2,1,1,100.0,0,4,0,4,0,4,3,0,defense
ENG-Premier League,2023,Manchester Utd,Antony,BRA,FW,23,2000,14.7,40,21,15,19,6,20,40,50.0,20,29,1,28,12,52,9,0,defense
ENG-Premier League,2023,Manchester Utd,Bruno Fernandes,POR,"MF,FW",28,1994,34.6,68,38,27,25,16,30,88,34.1,58,49,6,43,27,95,50,2,defense
ENG-Premier League,2023,Manchester Utd,Casemiro,BRA,"MF,DF",31,1992,22.0,83,56,43,32,8,51,106,48.1,55,74,33,41,18,101,71,1,defense
ENG-Premier League,2023,Manchester Utd,Christian Eriksen,DEN,MF,31,1992,12.7,18,13,5,10,3,12,33,36.4,21,17,6,11,4,22,13,0,defense
ENG-Premier League,2023,Manchester Utd,Daniel Gore,ENG,MF,18,2004,0.0,1,1,0,1,0,1,1,100.0,0,0,0,0,1,2,0,0,defense
ENG-Premier League,2023,Manchester Utd,Diogo Dalot,POR,DF,24,1999,35.3,81,51,58,12,11,51,74,68.9,23,44,16,28,37,118,111,0,defense
ENG-Premier League,2023,Manchester Utd,Donny van de Beek,NED,DF,26,1997,0.0,0,0,0,0,0,0,0,,0,1,0,1,0,0,0,0,defense
ENG-Premier League,2023,Manchester Utd,Ethan Wheatley,ENG,FW,17,2006,0.2,1,1,0,1,0,1,1,100.0,0,2,0,2,2,3,0,0,defense
ENG-Premier League,2023,Manchester Utd,Facundo Pellistri,URU,"FW,MF",21,2001,1.9,5,3,4,1,0,1,3,33.3,2,7,1,6,1,6,5,0,defense
ENG-Premier League,2023,Manchester Utd,Hannibal Mejbri,TUN,"MF,FW",20,2003,1.5,3,3,1,2,0,1,3,33.3,2,1,1,0,0,3,0,0,defense
ENG-Premier League,2023,Manchester Utd,Harry Maguire,ENG,DF,30,1993,18.4,24,17,14,10,0,12,22,54.5,10,33,24,9,25,49,83,1,defense
ENG-Premier League,2023,Manchester Utd,Jadon Sancho,ENG,"FW,MF",23,2000,0.9,1,0,1,0,0,1,3,33.3,2,1,0,1,1,2,0,0,defense
ENG-Premier League,2023,Manchester Utd,Jonny Evans,NIR,DF,35,1988,15.5,22,14,20,2,0,12,21,57.1,9,25,18,7,23,45,76,0,defense
ENG-Premier League,2023,Manchester Utd,Kobbie Mainoo,ENG,MF,18,2005,21.4,47,27,20,16,11,21,45,46.7,24,20,12,8,22,69,30,1,defense
ENG-Premier League,2023,Manchester Utd,Lisandro Martínez,ARG,DF,25,1998,7.2,12,8,8,4,0,5,12,41.7,7,10,8,2,5,17,26,0,defense
ENG-Premier League,2023,Manchester Utd,Luke Shaw,ENG,DF,28,1995,10.7,11,8,7,3,1,9,15,60.0,6,18,11,7,6,17,39,0,defense
ENG-Premier League,2023,Manchester Utd,Marcus Rashford,ENG,FW,25,1997,25.2,19,12,9,4,6,9,26,34.6,17,15,1,14,4,23,21,0,defense
ENG-Premier League,2023,Manchester Utd,Mason Mount,ENG,"MF,FW",24,1999,5.7,22,14,6,10,6,6,16,37.5,10,6,1,5,6,28,3,0,defense
ENG-Premier League,2023,Manchester Utd,Omari Forson,ENG,FW,19,2004,0.8,2,0,0,2,0,1,1,100.0,0,0,0,0,0,2,0,0,defense
ENG-Premier League,2023,Manchester Utd,Raphaël Varane,FRA,DF,30,1993,15.3,18,11,10,7,1,10,14,71.4,4,23,18,5,15,33,88,0,defense
ENG-Premier League,2023,Manchester Utd,Rasmus Højlund,DEN,FW,20,2003,24.0,11,7,2,3,6,5,13,38.5,8,9,1,8,1,12,19,0,defense
ENG-Premier League,2023,Manchester Utd,Scott McTominay,SCO,"MF,FW",26,1996,21.1,49,25,23,24,2,22,33,66.7,11,34,12,22,14,63,54,0,defense
ENG-Premier League,2023,Manchester Utd,Sergio Reguilón,ESP,DF,26,1996,4.6,13,8,6,2,5,8,17,47.1,9,10,0,10,5,18,7,0,defense
ENG-Premier League,2023,Manchester Utd,Sofyan Amrabat,MAR,"MF,DF",26,1996,10.4,27,16,17,8,2,17,31,54.8,14,20,7,13,8,35,19,2,defense
ENG-Premier League,2023,Manchester Utd,Victor Lindelöf,SWE,DF,29,1994,14.8,15,10,8,7,0,5,13,38.5,8,18,9,9,12,27,40,1,defense
ENG-Premier League,2023,Manchester Utd,Willy Kambwala,FRA,DF,18,2004,3.7,3,1,1,2,0,1,3,33.3,2,6,3,3,4,7,14,1,defense
ENG-Premier League,2023,Newcastle Utd,Alex Murphy,IRL,"DF,FW",19,2004,0.1,1,1,0,1,0,1,2,50.0,1,1,0,1,1,2,0,0,defense
ENG-Premier League,2023,Newcastle Utd,Alexander Isak,SWE,FW,23,1999,25.1,5,0,2,1,2,2,8,25.0,6,16,1,15,6,11,13,0,defense
ENG-Premier League,2023,Newcastle Utd,Amadou Diallo,ENG,MF,20,2003,0.0,0,0,0,0,0,0,0,,0,0,0,0,0,0,0,0,defense
ENG-Premier League,2023,Newcastle Utd,Anthony Gordon,ENG,FW,22,2001,32.1,55,34,16,28,11,22,64,34.4,42,27,0,27,7,62,7,0,defense
ENG-Premier League,2023,Newcastle Utd,Ben Parkinson,ENG,FW,18,2005,0.3,0,0,0,0,0,0,0,,0,1,0,1,0,0,1,0,defense
ENG-Premier League,2023,Newcastle Utd,Bruno Guimarães,BRA,MF,25,1997,36.3,88,53,45,32,11,40,77,51.9,37,52,14,38,35,123,20,0,defense
ENG-Premier League,2023,Newcastle Utd,Callum Wilson,ENG,FW,31,1992,11.0,5,3,0,2,3,0,4,0.0,4,6,0,6,2,7,4,0,defense
ENG-Premier League,2023,Newcastle Utd,Dan Burn,ENG,DF,31,1992,30.3,61,33,37,20,4,26,61,42.6,35,55,25,30,37,98,124,1,defense
ENG-Premier League,2023,Newcastle Utd,Elliot Anderson,ENG,"MF,FW",20,2002,11.4,24,18,12,9,3,15,29,51.7,14,23,4,19,8,32,23,0,defense
ENG-Premier League,2023,Newcastle Utd,Emil Krafth,SWE,DF,28,1994,10.1,21,14,10,7,4,12,25,48.0,13,8,3,5,9,30,21,0,defense
ENG-Premier League,2023,Newcastle Utd,Fabian Schär,SUI,DF,31,1991,33.9,42,24,27,13,2,18,40,45.0,22,50,38,12,36,78,133,1,defense
ENG-Premier League,2023,Newcastle Utd,Harvey Barnes,ENG,"FW,MF",25,1997,8.9,6,1,3,2,1,1,2,50.0,1,1,0,1,5,11,3,0,defense
ENG-Premier League,2023,Newcastle Utd,Jacob Murphy,ENG,"FW,DF",28,1995,13.2,20,10,8,4,8,12,26,46.2,14,17,0,17,6,26,16,0,defense
ENG-Premier League,2023,Newcastle Utd,Jamaal Lascelles,ENG,DF,29,1993,12.0,14,9,7,7,0,6,11,54.5,5,17,12,5,5,19,42,0,defense
ENG-Premier League,2023,Newcastle Utd,Joe White,ENG,MF,20,2002,0.1,1,1,1,0,0,0,0,,0,0,0,0,0,1,0,0,defense
ENG-Premier League,2023,Newcastle Utd,Joe Willock,ENG,MF,23,1999,4.7,13,7,7,6,0,4,11,36.4,7,7,0,7,1,14,1,0,defense
ENG-Premier League,2023,Newcastle Utd,Joelinton,BRA,"MF,FW",26,1996,14.2,39,27,21,15,3,14,38,36.8,24,23,7,16,19,58,11,1,defense
ENG-Premier League,2023,Newcastle Utd,Kieran Trippier,ENG,DF,32,1990,24.8,57,27,30,16,11,37,77,48.1,40,41,8,33,24,81,57,3,defense
ENG-Premier League,2023,Newcastle Utd,Lewis Hall,ENG,DF,18,2004,8.7,28,18,17,10,1,17,28,60.7,11,17,2,15,12,40,22,1,defense
ENG-Premier League,2023,Newcastle Utd,Lewis Miley,ENG,MF,17,2006,13.4,33,21,6,20,7,15,32,46.9,17,20,3,17,8,41,18,2,defense
ENG-Premier League,2023,Newcastle Utd,Loris Karius,GER,GK,30,1993,1.0,0,0,0,0,0,0,0,,0,0,0,0,0,0,1,0,defense
ENG-Premier League,2023,Newcastle Utd,Martin Dúbravka,SVK,GK,34,1989,22.1,0,0,0,0,0,0,4,0.0,4,0,0,0,0,0,8,1,defense
ENG-Premier League,2023,Newcastle Utd,Matt Ritchie,SCO,"FW,MF",33,1989,1.4,5,3,2,2,1,2,4,50.0,2,3,2,1,1,6,5,0,defense
ENG-Premier League,2023,Newcastle Utd,Matt Targett,ENG,DF,27,1995,0.9,2,0,1,1,0,1,1,100.0,0,1,0,1,0,2,2,0,defense
ENG-Premier League,2023,Newcastle Utd,Michael Ndiweni,ENG,FW,19,2003,0.0,0,0,0,0,0,0,0,,0,0,0,0,0,0,0,0,defense
ENG-Premier League,2023,Newcastle Utd,Miguel Almirón,PAR,FW,29,1994,21.5,36,24,13,15,8,11,29,37.9,18,29,2,27,10,46,13,0,defense
ENG-Premier League,2023,Newcastle Utd,Nick Pope,ENG,GK,31,1992,14.9,0,0,0,0,0,0,1,0.0,1,0,0,0,0,0,7,2,defense
ENG-Premier League,2023,Newcastle Utd,Paul Dummett,WAL,DF,31,1991,0.2,1,0,1,0,0,1,1,100.0,0,0,0,0,0,1,1,0,defense
ENG-Premier League,2023,Newcastle Utd,Sandro Tonali,ITA,MF,23,2000,4.9,7,7,4,2,1,3,9,33.3,6,3,0,3,2,9,4,0,defense
ENG-Premier League,2023,Newcastle Utd,Sean Longstaff,ENG,MF,25,1997,30.5,54,30,17,29,8,24,63,38.1,39,43,7,36,17,71,23,0,defense
ENG-Premier League,2023,Newcastle Utd,Sven Botman,NED,DF,23,2000,15.3,20,13,14,6,0,8,13,61.5,5,20,16,4,9,29,61,3,defense
ENG-Premier League,2023,Newcastle Utd,Valentino Livramento,ENG,DF,20,2002,14.6,23,13,15,6,2,10,21,47.6,11,16,7,9,25,48,41,1,defense
ENG-Premier League,2023,Nott'ham Forest,Andrew Omobamidele,IRL,DF,21,2002,8.7,10,3,9,1,0,5,8,62.5,3,12,8,4,13,23,42,1,defense
ENG-Premier League,2023,Nott'ham Forest,Andrey Santos,BRA,MF,19,2004,0.1,0,0,0,0,0,0,0,,0,1,0,1,0,0,0,0,defense
ENG-Premier League,2023,Nott'ham Forest,Anthony Elanga,SWE,"FW,MF",21,2002,27.0,33,19,20,6,7,17,37,45.9,20,22,2,20,8,41,20,1,defense
ENG-Premier League,2023,Nott'ham Forest,Brandon Aguilera,CRC,FW,20,2003,0.1,0,0,0,0,0,0,0,,0,0,0,0,0,0,0,0,defense
ENG-Premier League,2023,Nott'ham Forest,Brennan Johnson,WAL,"FW,MF",22,2001,2.6,4,1,1,1,2,2,4,50.0,2,4,1,3,0,4,0,0,defense
ENG-Premier League,2023,Nott'ham Forest,Callum Hudson-Odoi,ENG,"FW,MF",22,2000,20.6,18,8,4,5,9,7,28,25.0,21,16,1,15,7,25,12,1,defense
ENG-Premier League,2023,Nott'ham Forest,Cheikhou Kouyaté,SEN,MF,33,1989,2.4,8,5,3,3,2,1,4,25.0,3,4,1,3,2,10,10,0,defense
ENG-Premier League,2023,Nott'ham Forest,Chris Wood,NZL,FW,31,1991,20.1,7,4,1,4,2,3,9,33.3,6,11,3,8,1,8,26,0,defense
ENG-Premier League,2023,Nott'ham Forest,Danilo,BRA,MF,22,2001,19.9,36,18,22,12,2,21,46,45.7,25,34,8,26,35,71,42,0,defense
ENG-Premier League,2023,Nott'ham Forest,Divock Origi,BEL,FW,28,1995,6.7,6,4,5,0,1,0,0,,0,6,0,6,2,8,4,0,defense
ENG-Premier League,2023,Nott'ham Forest,Felipe,BRA,DF,34,1989,4.2,12,9,9,3,0,9,12,75.0,3,4,1,3,4,16,12,0,defense
ENG-Premier League,2023,Nott'ham Forest,Gio Reyna,USA,"FW,MF",20,2002,2.6,7,3,4,0,3,3,6,50.0,3,3,0,3,2,9,0,0,defense
ENG-Premier League,2023,Nott'ham Forest,Gonzalo Montiel,ARG,DF,26,1997,8.9,22,19,12,8,2,16,29,55.2,13,8,3,5,9,31,31,1,defense
ENG-Premier League,2023,Nott'ham Forest,Harry Toffolo,ENG,DF,27,1995,16.2,26,14,20,6,0,15,24,62.5,9,34,13,21,14,40,49,0,defense
ENG-Premier League,2023,Nott'ham Forest,Ibrahim Sangaré,CIV,MF,25,1997,11.5,42,23,25,13,4,12,29,41.4,17,24,7,17,16,58,21,0,defense
ENG-Premier League,2023,Nott'ham Forest,Joe Worrall,ENG,DF,26,1997,4.9,7,5,6,1,0,3,6,50.0,3,5,4,1,3,10,32,1,defense
ENG-Premier League,2023,Nott'ham Forest,Matt Turner,USA,GK,29,1994,17.0,0,0,0,0,0,0,0,,0,0,0,0,0,0,8,4,defense
ENG-Premier League,2023,Nott'ham Forest,Matz Sels,BEL,GK,31,1992,16.0,0,0,0,0,0,0,0,,0,0,0,0,0,0,11,1,defense
ENG-Premier League,2023,Nott'ham Forest,Morgan Gibbs-White,ENG,"MF,FW",23,2000,35.1,36,24,6,20,10,14,33,42.4,19,31,8,23,17,53,21,0,defense
ENG-Premier League,2023,Nott'ham Forest,Moussa Niakhate,SEN,DF,27,1996,16.2,42,25,33,9,0,20,25,80.0,5,19,12,7,14,56,51,0,defense
ENG-Premier League,2023,Nott'ham Forest,Murillo,BRA,DF,21,2002,31.0,50,31,36,13,1,19,33,57.6,14,41,24,17,37,87,188,0,defense
ENG-Premier League,2023,Nott'ham Forest,Neco Williams,WAL,DF,22,2001,18.2,69,40,42,18,9,35,56,62.5,21,44,13,31,22,91,53,0,defense
ENG-Premier League,2023,Nott'ham Forest,Nicolás Domínguez,ARG,"MF,FW",25,1998,16.6,63,34,35,27,1,23,48,47.9,25,31,5,26,18,81,24,0,defense
ENG-Premier League,2023,Nott'ham Forest,Nuno Tavares,POR,DF,23,2000,5.1,11,7,9,1,1,8,9,88.9,1,6,0,6,1,12,21,0,defense
ENG-Premier League,2023,Nott'ham Forest,Odisseas Vlachodimos,GRE,GK,29,1994,5.0,0,0,0,0,0,0,1,0.0,1,0,0,0,0,0,1,0,defense
ENG-Premier League,2023,Nott'ham Forest,Ola Aina,NGA,DF,26,1996,18.8,47,31,31,12,4,29,40,72.5,11,19,3,16,18,65,51,1,defense
ENG-Premier League,2023,Nott'ham Forest,Orel Mangala,BEL,MF,25,1998,17.4,27,13,16,10,1,14,29,48.3,15,12,6,6,26,53,32,0,defense
ENG-Premier League,2023,Nott'ham Forest,Rodrigo Ribeiro,POR,"MF,FW",18,2005,0.2,0,0,0,0,0,0,1,0.0,1,1,0,1,1,1,0,0,defense
ENG-Premier League,2023,Nott'ham Forest,Ryan Yates,ENG,MF,25,1997,22.1,66,40,39,21,6,20,36,55.6,16,42,15,27,21,87,44,1,defense
ENG-Premier League,2023,Nott'ham Forest,Scott McKenna,SCO,DF,26,1996,4.6,4,0,3,1,0,2,3,66.7,1,6,4,2,5,9,27,0,defense
ENG-Premier League,2023,Nott'ham Forest,Serge Aurier,CIV,"DF,MF",30,1992,9.3,20,14,9,11,0,5,11,45.5,6,10,3,7,9,29,36,1,defense
ENG-Premier League,2023,Nott'ham Forest,Taiwo Awoniyi,NGA,FW,25,1997,11.6,9,7,1,4,4,1,2,50.0,1,7,2,5,1,10,9,0,defense
ENG-Premier League,2023,Nott'ham Forest,Willy Boly,CIV,DF,32,1991,16.0,46,29,36,9,1,22,40,55.0,18,32,21,11,25,71,90,0,defense
ENG-Premier League,2023,Sheffield Utd,Andre Brooks,ENG,"MF,DF",19,2003,10.4,22,13,7,11,4,9,21,42.9,12,13,1,12,14,36,20,0,defense
ENG-Premier League,2023,Sheffield Utd,Anel Ahmedhodžić,BIH,DF,24,1999,29.4,64,36,48,14,2,30,49,61.2,19,43,26,17,34,98,137,2,defense
ENG-Premier League,2023,Sheffield Utd,Anis Ben Slimane,TUN,MF,22,2001,4.7,11,6,5,2,4,4,10,40.0,6,7,1,6,5,16,7,0,defense
ENG-Premier League,2023,Sheffield Utd,Antwoine Hackford,ENG,FW,19,2004,0.1,0,0,0,0,0,0,0,,0,0,0,0,0,0,0,0,defense
ENG-Premier League,2023,Sheffield Utd,Auston Trusty,USA,DF,24,1998,28.6,47,30,31,13,3,21,43,48.8,22,41,22,19,35,82,153,3,defense
ENG-Premier League,2023,Sheffield Utd,Ben Brereton,CHI,"FW,MF",24,1999,12.3,9,4,4,4,1,4,10,40.0,6,9,3,6,3,12,12,0,defense
ENG-Premier League,2023,Sheffield Utd,Ben Osborn,ENG,"DF,MF",28,1994,15.2,22,9,11,9,2,8,17,47.1,9,18,2,16,8,30,30,0,defense
ENG-Premier League,2023,Sheffield Utd,Bénie Traoré,CIV,"FW,MF",20,2002,4.3,4,2,1,2,1,0,4,0.0,4,4,1,3,1,5,1,0,defense
ENG-Premier League,2023,Sheffield Utd,Cameron Archer,ENG,"FW,MF",22,2001,20.4,18,13,6,6,6,8,18,44.4,10,22,3,19,1,19,11,0,defense
ENG-Premier League,2023,Sheffield Utd,Chris Basham,ENG,"DF,MF",35,1988,3.6,7,2,4,3,0,2,9,22.2,7,9,4,5,5,12,17,0,defense
ENG-Premier League,2023,Sheffield Utd,Daniel Jebbison,ENG,FW,19,2003,0.2,0,0,0,0,0,0,0,,0,1,0,1,0,0,0,0,defense
ENG-Premier League,2023,Sheffield Utd,George Baldock,GRE,DF,30,1993,10.8,18,10,10,7,1,6,15,40.0,9,14,8,6,10,28,33,0,defense
ENG-Premier League,2023,Sheffield Utd,Gustavo Hamer,NED,MF,26,1997,32.3,39,21,17,15,7,16,59,27.1,43,33,9,24,29,68,35,0,defense
ENG-Premier League,2023,Sheffield Utd,Ivo Grbić,CRO,GK,27,1996,8.6,0,0,0,0,0,0,1,0.0,1,1,0,1,0,0,9,1,defense
ENG-Premier League,2023,Sheffield Utd,Jack Robinson,ENG,DF,29,1993,32.1,43,28,29,14,0,25,39,64.1,14,49,33,16,33,76,132,2,defense
ENG-Premier League,2023,Sheffield Utd,James Mcatee,ENG,"MF,FW",20,2002,20.2,32,21,9,13,10,13,33,39.4,20,20,0,20,11,43,18,0,defense
ENG-Premier League,2023,Sheffield Utd,Jayden Bogle,ENG,DF,23,2000,31.0,66,36,43,21,2,35,70,50.0,35,42,11,31,32,98,97,0,defense
ENG-Premier League,2023,Sheffield Utd,John Egan,IRL,DF,30,1992,5.4,6,4,4,2,0,4,11,36.4,7,10,4,6,13,19,39,1,defense
ENG-Premier League,2023,Sheffield Utd,John Fleck,SCO,"MF,DF",31,1991,1.0,1,0,0,1,0,0,1,0.0,1,0,0,0,0,1,1,0,defense
ENG-Premier League,2023,Sheffield Utd,Luke Thomas,ENG,DF,22,2001,10.2,20,9,13,6,1,8,14,57.1,6,23,5,18,10,30,27,0,defense
ENG-Premier League,2023,Sheffield Utd,Mason Holgate,ENG,DF,26,1996,7.9,12,7,5,6,1,5,12,41.7,7,12,5,7,11,23,40,0,defense
ENG-Premier League,2023,Sheffield Utd,Max Lowe,ENG,"DF,MF",26,1997,5.6,21,10,13,5,3,8,15,53.3,7,10,4,6,5,26,15,0,defense
ENG-Premier League,2023,Sheffield Utd,Oliver Arblaster,ENG,MF,19,2004,10.5,23,14,11,8,4,7,15,46.7,8,17,7,10,16,39,9,0,defense
ENG-Premier League,2023,Sheffield Utd,Oliver McBurnie,SCO,FW,27,1996,14.2,17,7,4,7,6,5,12,41.7,7,18,2,16,5,22,28,0,defense
ENG-Premier League,2023,Sheffield Utd,Oliver Norwood,NIR,MF,32,1991,16.0,41,26,18,18,5,20,47,42.6,27,24,9,15,21,62,39,0,defense
ENG-Premier League,2023,Sheffield Utd,Rhian Brewster,ENG,"FW,MF",23,2000,3.8,5,1,1,2,2,0,2,0.0,2,2,0,2,1,6,2,0,defense
ENG-Premier League,2023,Sheffield Utd,Rhys Norrington-Davies,WAL,DF,24,1999,1.2,1,1,1,0,0,0,1,0.0,1,2,0,2,1,2,2,0,defense
ENG-Premier League,2023,Sheffield Utd,Ryan One,SCO,FW,17,2006,0.1,0,0,0,0,0,0,0,,0,0,0,0,0,0,0,0,defense
ENG-Premier League,2023,Sheffield Utd,Sam Curtis,IRL,DF,17,2005,0.3,1,0,1,0,0,1,2,50.0,1,2,0,2,0,1,0,0,defense
ENG-Premier League,2023,Sheffield Utd,Sydie Peck,ENG,MF,18,2004,0.1,0,0,0,0,0,0,0,,0,0,0,0,0,0,0,0,defense
ENG-Premier League,2023,Sheffield Utd,Tom Davies,ENG,MF,25,1998,2.5,10,5,4,3,3,3,9,33.3,6,2,1,1,3,13,6,1,defense
ENG-Premier League,2023,Sheffield Utd,Vinicius Souza,BRA,MF,24,1999,29.6,125,76,59,51,15,41,74,55.4,33,57,17,40,32,157,75,1,defense
ENG-Premier League,2023,Sheffield Utd,Wes Foderingham,ENG,GK,32,1991,29.4,5,3,5,0,0,5,6,83.3,1,0,0,0,0,5,18,6,defense
ENG-Premier League,2023,Sheffield Utd,William Osula,DEN,FW,19,2003,8.7,2,2,1,0,1,1,2,50.0,1,3,1,2,2,4,9,0,defense
ENG-Premier League,2023,Sheffield Utd,Yasser Larouci,ALG,DF,22,2001,5.9,17,9,10,5,2,10,14,71.4,4,6,1,5,7,24,20,1,defense
ENG-Premier League,2023,Tottenham,Alejo Véliz,ARG,FW,19,2003,0.6,1,0,1,0,0,0,0,,0,0,0,0,0,1,0,0,defense
ENG-Premier League,2023,Tottenham,Ben Davies,WAL,DF,30,1993,12.1,24,17,13,8,3,16,21,76.2,5,17,15,2,10,34,35,0,defense
ENG-Premier League,2023,Tottenham,Brennan Johnson,WAL,FW,22,2001,23.2,26,15,14,5,7,12,31,38.7,19,37,1,36,10,36,12,1,defense
ENG-Premier League,2023,Tottenham,Bryan Gil,ESP,"FW,MF",22,2001,2.3,1,0,0,0,1,1,4,25.0,3,3,0,3,3,4,4,0,defense
ENG-Premier League,2023,Tottenham,Cristian Romero,ARG,DF,25,1998,31.0,66,40,35,25,6,32,44,72.7,12,46,22,24,44,110,106,1,defense
ENG-Premier League,2023,Tottenham,Dane Scarlett,ENG,FW,19,2004,0.2,1,1,0,0,1,0,1,0.0,1,0,0,0,0,1,0,0,defense
ENG-Premier League,2023,Tottenham,Davinson Sánchez,COL,DF,27,1996,0.9,0,0,0,0,0,0,0,,0,3,2,1,1,1,2,0,defense
ENG-Premier League,2023,Tottenham,Dejan Kulusevski,SWE,"FW,MF",23,2000,30.7,62,33,19,20,23,25,67,37.3,42,24,1,23,18,80,2,1,defense
ENG-Premier League,2023,Tottenham,Destiny Udogie,ITA,DF,20,2002,26.6,68,33,41,16,11,27,49,55.1,22,27,8,19,37,105,80,5,defense
ENG-Premier League,2023,Tottenham,Emerson,BRA,DF,24,1999,12.9,36,24,23,10,3,21,43,48.8,22,23,10,13,20,56,50,1,defense
ENG-Premier League,2023,Tottenham,Eric Dier,ENG,DF,29,1994,2.2,2,1,2,0,0,2,2,100.0,0,3,3,0,2,4,12,0,defense
ENG-Premier League,2023,Tottenham,Giovani Lo Celso,ARG,MF,27,1996,5.6,22,13,10,8,4,9,14,64.3,5,4,1,3,5,27,2,0,defense
ENG-Premier League,2023,Tottenham,Guglielmo Vicario,ITA,GK,26,1996,38.0,0,0,0,0,0,0,1,0.0,1,0,0,0,1,1,31,2,defense
ENG-Premier League,2023,Tottenham,Ivan Perišić,CRO,FW,34,1989,1.1,3,2,1,1,1,3,5,60.0,2,1,0,1,2,5,1,0,defense
ENG-Premier League,2023,Tottenham,James Maddison,ENG,MF,26,1996,23.7,33,19,5,18,10,15,29,51.7,14,15,3,12,13,46,10,1,defense
ENG-Premier League,2023,Tottenham,Jamie Donley,NIR,FW,18,2005,0.0,0,0,0,0,0,0,0,,0,0,0,0,0,0,3,0,defense
ENG-Premier League,2023,Tottenham,Manor Solomon,ISR,FW,24,1999,2.2,3,3,1,1,1,1,2,50.0,1,4,0,4,3,6,2,0,defense
ENG-Premier League,2023,Tottenham,Micky van de Ven,NED,DF,22,2001,26.0,49,35,34,12,3,24,33,72.7,9,25,15,10,18,67,78,1,defense
ENG-Premier League,2023,Tottenham,Mikey Moore,ENG,MF,15,2007,0.0,0,0,0,0,0,0,0,,0,0,0,0,0,0,1,0,defense
ENG-Premier League,2023,Tottenham,Oliver Skipp,ENG,"MF,DF",22,2000,7.9,18,12,9,6,3,11,18,61.1,7,12,1,11,3,21,9,0,defense
ENG-Premier League,2023,Tottenham,Pape Matar Sarr,SEN,MF,20,2002,23.0,34,24,11,17,6,15,36,41.7,21,21,5,16,31,65,28,1,defense
ENG-Premier League,2023,Tottenham,Pedro Porro,ESP,DF,23,1999,34.3,91,63,43,34,14,62,120,51.7,58,63,18,45,34,125,102,3,defense
ENG-Premier League,2023,Tottenham,Pierre Højbjerg,DEN,MF,27,1995,14.6,32,18,13,17,2,13,34,38.2,21,21,7,14,19,51,30,3,defense
ENG-Premier League,2023,Tottenham,Radu Drăgușin,ROU,DF,21,2002,4.8,5,3,5,0,0,3,3,100.0,0,5,4,1,8,13,19,0,defense
ENG-Premier League,2023,Tottenham,Richarlison,BRA,FW,26,1997,16.6,16,11,4,8,4,2,10,20.0,8,32,6,26,8,24,23,0,defense
ENG-Premier League,2023,Tottenham,Rodrigo Bentancur,URU,MF,26,1997,11.2,23,15,10,11,2,10,24,41.7,14,15,4,11,17,40,16,1,defense
ENG-Premier League,2023,Tottenham,Son Heung-min,KOR,FW,31,1992,32.6,21,13,6,7,8,10,21,47.6,11,4,1,3,8,29,4,0,defense
ENG-Premier League,2023,Tottenham,Timo Werner,GER,FW,27,1996,9.0,7,4,3,4,0,5,18,27.8,13,12,0,12,3,10,2,0,defense
ENG-Premier League,2023,Tottenham,Yves Bissouma,MLI,MF,26,1996,23.0,80,52,32,36,12,41,61,67.2,20,28,5,23,37,117,43,3,defense
ENG-Premier League,2023,West Ham,Aaron Cresswell,ENG,"DF,FW",33,1989,4.8,3,2,1,1,1,2,3,66.7,1,5,3,2,3,6,7,0,defense
ENG-Premier League,2023,West Ham,Alphonse Areola,FRA,GK,30,1993,30.0,1,1,1,0,0,1,3,33.3,2,0,0,0,1,2,16,0,defense
ENG-Premier League,2023,West Ham,Angelo Ogbonna,ITA,DF,35,1988,7.1,11,5,9,2,0,6,7,85.7,1,13,10,3,3,14,29,0,defense
ENG-Premier League,2023,West Ham,Ben Johnson,ENG,"DF,FW",23,2000,6.0,11,7,7,3,1,9,14,64.3,5,2,1,1,5,16,14,0,defense
ENG-Premier League,2023,West Ham,Danny Ings,ENG,FW,31,1992,4.5,6,2,0,6,0,4,13,30.8,9,4,1,3,3,9,7,0,defense
ENG-Premier League,2023,West Ham,Divin Mubama,ENG,FW,18,2004,0.9,0,0,0,0,0,0,0,,0,0,0,0,0,0,0,0,defense
ENG-Premier League,2023,West Ham,Edson Álvarez,MEX,MF,25,1997,26.4,80,39,47,26,7,31,66,47.0,35,59,20,39,42,122,81,0,defense
ENG-Premier League,2023,West Ham,Emerson Palmieri,ITA,DF,28,1994,34.9,106,68,48,42,16,57,90,63.3,33,47,15,32,43,149,96,0,defense
ENG-Premier League,2023,West Ham,George Earthy,ENG,FW,18,2004,0.4,0,0,0,0,0,0,1,0.0,1,0,0,0,1,1,0,0,defense
ENG-Premier League,2023,West Ham,James Ward-Prowse,ENG,MF,28,1994,33.3,45,29,14,23,8,18,44,40.9,26,31,9,22,38,83,49,0,defense
ENG-Premier League,2023,West Ham,Jarrod Bowen,ENG,FW,26,1996,33.5,42,28,14,14,14,13,35,37.1,22,37,5,32,19,61,14,0,defense
ENG-Premier League,2023,West Ham,Kaelan Casey,ENG,DF,18,2004,0.0,0,0,0,0,0,0,0,,0,0,0,0,0,0,1,0,defense
ENG-Premier League,2023,West Ham,Kalvin Phillips,ENG,MF,27,1995,3.4,11,6,2,8,1,5,9,55.6,4,4,1,3,4,15,2,1,defense
ENG-Premier League,2023,West Ham,Konstantinos Mavropanos,GRE,DF,25,1997,16.7,28,16,17,9,2,17,21,81.0,4,21,13,8,23,51,79,3,defense
ENG-Premier League,2023,West Ham,Kurt Zouma,FRA,DF,28,1994,31.5,23,17,14,9,0,10,16,62.5,6,38,28,10,29,52,160,0,defense
ENG-Premier League,2023,West Ham,Lucas Paquetá,BRA,"FW,MF",25,1997,29.1,71,48,38,26,7,25,52,48.1,27,28,1,27,21,92,28,2,defense
ENG-Premier League,2023,West Ham,Maxwel Cornet,CIV,"MF,FW",26,1996,1.2,3,2,3,0,0,1,5,20.0,4,2,0,2,2,5,1,0,defense
ENG-Premier League,2023,West Ham,Michail Antonio,JAM,FW,33,1990,18.8,15,8,5,6,4,3,11,27.3,8,16,3,13,4,19,4,0,defense
ENG-Premier League,2023,West Ham,Mohammed Kudus,GHA,"FW,MF",22,2000,27.6,65,47,27,27,11,20,40,50.0,20,25,0,25,11,76,9,1,defense
ENG-Premier League,2023,West Ham,Nayef Aguerd,MAR,DF,27,1996,20.6,26,14,19,7,0,16,22,72.7,6,33,24,9,17,43,85,2,defense
ENG-Premier League,2023,West Ham,Pablo Fornals,ESP,"MF,FW",27,1996,4.7,10,6,4,3,3,5,16,31.3,11,8,1,7,6,16,7,0,defense
ENG-Premier League,2023,West Ham,Saïd Benrahma,ALG,"FW,MF",27,1995,6.9,8,4,5,3,0,4,15,26.7,11,8,0,8,5,13,7,0,defense
ENG-Premier League,2023,West Ham,Thilo Kehrer,GER,"DF,MF",26,1996,0.2,1,1,0,1,0,0,0,,0,2,2,0,0,1,0,0,defense
ENG-Premier League,2023,West Ham,Tomáš Souček,CZE,MF,28,1995,31.9,53,35,24,26,3,21,47,44.7,26,55,28,27,37,90,109,0,defense
ENG-Premier League,2023,West Ham,Vladimír Coufal,CZE,DF,30,1992,34.8,64,41,50,12,2,38,75,50.7,37,49,15,34,43,107,97,0,defense
ENG-Premier League,2023,West Ham,Łukasz Fabiański,POL,GK,38,1985,8.0,1,0,1,0,0,1,2,50.0,1,0,0,0,1,2,4,0,defense
ENG-Premier League,2023,Wolves,Boubacar Traoré,MLI,MF,21,2001,9.1,35,23,16,17,2,9,21,42.9,12,12,2,10,5,40,7,0,defense
ENG-Premier League,2023,Wolves,Craig Dawson,ENG,DF,33,1990,24.5,30,20,23,6,1,22,34,64.7,12,51,39,12,16,46,120,1,defense
ENG-Premier League,2023,Wolves,Daniel Bentley,ENG,GK,30,1993,4.3,0,0,0,0,0,0,1,0.0,1,0,0,0,0,0,1,0,defense
ENG-Premier League,2023,Wolves,Enso Gonzalez,PAR,"MF,DF",18,2005,0.0,0,0,0,0,0,0,1,0.0,1,0,0,0,0,0,0,0,defense
ENG-Premier League,2023,Wolves,Fábio Silva,POR,FW,21,2002,2.9,7,4,3,4,0,2,3,66.7,1,1,0,1,2,9,0,0,defense
ENG-Premier League,2023,Wolves,Hugo Bueno,ESP,"DF,MF",20,2002,8.2,21,14,12,7,2,12,19,63.2,7,17,4,13,6,27,24,0,defense
ENG-Premier League,2023,Wolves,Hwang Hee-chan,KOR,"FW,MF",27,1996,23.5,20,10,11,8,1,9,24,37.5,15,19,1,18,10,30,9,0,defense
ENG-Premier League,2023,Wolves,Jean-Ricner Bellegarde,FRA,"MF,FW",25,1998,10.6,17,10,9,6,2,7,15,46.7,8,18,2,16,8,25,14,0,defense
ENG-Premier League,2023,Wolves,Jonny Castro,ESP,MF,29,1994,0.1,0,0,0,0,0,0,1,0.0,1,1,1,0,0,0,0,0,defense
ENG-Premier League,2023,Wolves,José Sá,POR,GK,30,1993,33.7,0,0,0,0,0,0,1,0.0,1,3,0,3,0,0,21,5,defense
ENG-Premier League,2023,Wolves,João Gomes,BRA,MF,22,2001,29.4,128,74,67,49,12,44,99,44.4,55,51,8,43,18,146,29,2,defense
ENG-Premier League,2023,Wolves,Leon Chiwome,ENG,FW,17,2006,1.9,2,1,0,1,1,1,2,50.0,1,3,1,2,0,2,2,0,defense
ENG-Premier League,2023,Wolves,Mario Lemina,GAB,MF,29,1993,33.0,90,58,46,33,11,25,47,53.2,22,36,9,27,41,131,64,0,defense
ENG-Premier League,2023,Wolves,Matheus Cunha,BRA,"FW,MF",24,1999,27.1,30,16,8,17,5,13,35,37.1,22,28,7,21,13,43,21,1,defense
ENG-Premier League,2023,Wolves,Matheus Nunes,POR,MF,24,1998,2.0,3,1,3,0,0,2,6,33.3,4,0,0,0,6,9,1,0,defense
ENG-Premier League,2023,Wolves,Matt Doherty,IRL,"DF,MF",31,1992,12.8,31,18,17,10,4,12,23,52.2,11,15,5,10,7,38,47,0,defense
ENG-Premier League,2023,Wolves,Max Kilman,ENG,DF,26,1997,38.0,47,21,40,6,1,24,32,75.0,8,64,37,27,39,86,182,4,defense
ENG-Premier League,2023,Wolves,Nathan Fraser,IRL,FW,18,2005,2.1,5,2,2,1,2,1,3,33.3,2,2,1,1,1,6,2,0,defense
ENG-Premier League,2023,Wolves,Nélson Semedo,POR,"DF,MF",29,1993,34.3,79,48,52,19,8,38,64,59.4,26,44,8,36,36,115,85,1,defense
ENG-Premier League,2023,Wolves,Pablo Sarabia,ESP,"MF,FW",31,1992,19.4,20,13,8,8,4,12,36,33.3,24,17,1,16,10,30,9,0,defense
ENG-Premier League,2023,Wolves,Pedro Neto,POR,"FW,MF",23,2000,16.8,7,3,3,2,2,5,15,33.3,10,5,1,4,5,12,2,0,defense
ENG-Premier League,2023,Wolves,Rayan Aït-Nouri,ALG,"DF,MF",22,2001,25.9,71,44,41,23,7,28,49,57.1,21,32,6,26,15,86,38,0,defense
ENG-Premier League,2023,Wolves,Santiago Bueno,URU,DF,24,1998,9.1,13,7,5,7,1,5,11,45.5,6,22,12,10,6,19,33,0,defense
ENG-Premier League,2023,Wolves,Sasa Kalajdzic,AUT,FW,26,1997,1.8,6,2,3,2,1,1,2,50.0,1,3,0,3,1,7,6,0,defense
ENG-Premier League,2023,Wolves,Tawanda Chirewa,ZIM,"MF,FW",19,2003,1.6,7,3,3,3,1,2,3,66.7,1,0,0,0,1,8,0,0,defense
ENG-Premier League,2023,Wolves,Tommy Doyle,ENG,MF,21,2001,13.6,26,13,11,10,5,14,23,60.9,9,22,9,13,12,38,18,0,defense
ENG-Premier League,2023,Wolves,Toti Gomes,POR,DF,24,1999,30.8,44,25,32,8,4,24,37,64.9,13,40,19,21,26,70,93,2,defense
